player_id,firstName,lastName,birthDate,primaryPosition,shootsCatches,season,gamesPlayed,goals,assists,points,pointsPerGame,plusMinus,shots,shootingPercentage,penaltyMinutes,timeOnIce,avgTimeOnIce,faceOffWins,faceOffLosses,faceOffTaken,faceOffPercentage,hits,blocks,takeaways,giveaways,turnoverDifferential,powerPlayGoals,powerPlayAssists,powerPlayPoints,powerPlayTimeOnIce,avgPowerPlayTimeOnIce,shortHandedGoals,shortHandedAssists,shortHandedPoints,shortHandedTimeOnIce,avgShortHandedTimeOnIce,salary
8449645,Mike,Modano,1970-06-07,C,L,2010-11,40,4,11,15,0.38,-4,79,5.06,8,29876.0,12:26,133,141,274,48.54,7,10,14,13,1,1,5,6,6083.0,2:32,0,0,0,23.0,0:0,1250000
8450725,Mark,Recchi,1968-02-01,RW,L,2010-11,81,14,34,48,0.59,13,132,10.61,35,78269.0,16:6,52,45,97,53.61,81,25,16,32,-16,6,11,17,13042.0,2:41,0,1,1,3508.0,0:43,1000000
8455919,Craig,Conroy,1971-09-04,C,R,2010-11,18,2,0,2,0.11,-1,11,18.18,8,10046.0,9:18,101,88,189,53.44,21,10,4,10,-6,0,0,0,65.0,0:3,0,0,0,2521.0,2:20,500000
8456283,Adam,Foote,1971-07-10,D,R,2010-11,47,0,8,8,0.17,-9,23,0.0,33,50549.0,17:55,0,0,0,0.0,55,67,4,15,-11,0,0,0,403.0,0:8,0,0,0,8023.0,2:50,1000000
8457063,Nicklas,Lidstrom,1970-04-28,D,L,2010-11,82,16,46,62,0.76,-2,175,9.14,20,115465.0,23:28,0,0,0,0.0,49,92,33,33,0,7,32,39,19932.0,4:3,0,1,1,13142.0,2:40,6200000
8457981,Teemu,Selanne,1970-07-03,RW,R,2010-11,73,31,49,80,1.1,6,213,14.55,49,78572.0,17:56,97,121,218,44.5,15,20,37,45,-8,16,18,34,15177.0,3:27,0,0,0,98.0,0:1,3250000
8458361,Doug,Weight,1971-01-21,C,L,2010-11,18,2,7,9,0.5,-3,26,7.69,10,18927.0,17:31,57,53,110,51.82,9,4,9,20,-11,1,4,5,5364.0,4:58,0,0,0,22.0,0:1,850000
8458520,Peter,Forsberg,1973-07-20,C,L,2010-11,2,0,0,0,0.0,-4,3,0.0,4,2110.0,17:35,0,0,0,0.0,3,0,1,0,1,0,0,0,217.0,1:48,0,0,0,0.0,0:0,1000000
8458525,Brian,Rolston,1973-02-21,RW,L,2010-11,65,14,20,34,0.52,-6,168,8.33,34,68664.0,17:36,52,83,135,38.52,67,20,27,23,4,6,5,11,9719.0,2:29,0,1,1,6053.0,1:33,5062500
8458537,Ray,Whitney,1972-05-08,LW,R,2010-11,75,17,40,57,0.76,0,156,10.9,24,76296.0,16:57,45,55,100,45.0,29,15,27,32,-5,3,23,26,15647.0,3:28,0,0,0,64.0,0:0,3000000
8458543,Jassen,Cullimore,1972-12-04,D,L,2010-11,36,0,8,8,0.22,4,22,0.0,8,27280.0,12:37,0,0,0,0.0,38,34,7,15,-8,0,0,0,122.0,0:3,0,0,0,1482.0,0:41,500000
8458943,Cory,Stillman,1973-12-20,LW,L,2010-11,65,12,27,39,0.6,5,116,10.34,24,65950.0,16:54,17,20,37,45.95,64,30,31,28,3,3,9,12,12568.0,3:13,0,0,0,84.0,0:1,3533333
8458951,Sergei,Gonchar,1974-04-13,D,L,2010-11,67,7,20,27,0.4,-15,107,6.54,20,93232.0,23:11,0,0,0,0.0,54,94,22,48,-26,5,15,20,15955.0,3:58,0,0,0,6407.0,1:35,5500000
8459004,Craig,Rivet,1974-09-13,D,R,2010-11,37,2,2,4,0.11,-12,33,6.06,35,32581.0,14:40,0,0,0,0.0,31,36,5,18,-13,0,0,0,2134.0,0:57,0,0,0,2784.0,1:15,3500000
8459424,Chris,Pronger,1974-10-10,D,L,2010-11,50,4,21,25,0.5,7,112,3.57,44,67495.0,22:29,0,0,0,0.0,41,114,19,26,-7,3,11,14,11110.0,3:42,0,1,1,9257.0,3:5,4935714
8459427,Rob,Niedermayer,1974-12-28,C,L,2010-11,71,5,14,19,0.27,-8,80,6.25,22,54353.0,12:45,129,147,276,46.74,37,21,14,23,-9,0,0,0,548.0,0:7,0,0,0,3408.0,0:48,1150000
8459429,Jason,Arnott,1974-10-11,C,R,2010-11,73,17,14,31,0.42,-6,169,10.06,40,67990.0,15:31,449,445,894,50.22,42,11,30,21,9,4,4,8,9308.0,2:7,0,0,0,461.0,0:6,4500000
8459444,Todd,Bertuzzi,1975-02-02,RW,L,2010-11,81,16,29,45,0.56,-7,138,11.59,71,77551.0,15:57,18,22,40,45.0,110,21,30,46,-16,2,5,7,7719.0,1:35,0,0,0,51.0,0:0,1937500
8459457,Jamie,Langenbrunner,1975-07-24,RW,R,2010-11,70,9,23,32,0.46,-18,153,5.88,45,73253.0,17:26,11,17,28,39.29,96,25,28,36,-8,1,6,7,10194.0,2:25,0,0,0,6476.0,1:32,2800000
8459462,Bryan,McCabe,1975-06-08,D,L,2010-11,67,7,21,28,0.42,2,122,5.74,34,78660.0,19:34,0,0,0,0.0,86,72,8,31,-23,4,9,13,14558.0,3:37,0,0,0,3849.0,0:57,5750000
8459514,Jamal,Mayers,1974-10-24,RW,R,2010-11,78,3,11,14,0.18,3,62,4.84,124,41566.0,8:52,53,45,98,54.08,105,19,24,18,6,0,0,0,107.0,0:1,0,0,0,5174.0,1:6,600000
8459628,Hal,Gill,1975-04-06,D,L,2010-11,75,2,7,9,0.12,-9,62,3.23,43,89189.0,19:49,0,0,0,0.0,75,151,21,62,-41,0,0,0,284.0,0:3,0,1,1,17034.0,3:47,2250000
8459670,Kimmo,Timonen,1975-03-18,D,L,2010-11,82,6,31,37,0.45,11,147,4.08,36,110576.0,22:28,0,1,1,0.0,96,175,43,39,4,1,15,16,16370.0,3:19,2,0,2,16886.0,3:25,6333333
8460492,Ed,Jovanovski,1976-06-26,D,L,2010-11,50,5,9,14,0.28,4,73,6.85,39,61435.0,20:28,0,0,0,0.0,87,91,9,37,-28,1,1,2,3613.0,1:12,0,1,1,8418.0,2:48,6500000
8460496,Ryan,Smyth,1976-02-21,LW,L,2010-11,82,23,24,47,0.57,-1,195,11.79,35,88749.0,18:2,57,75,132,43.18,25,18,33,46,-13,9,5,14,14515.0,2:57,0,0,0,1581.0,0:19,6250000
8460502,Wade,Belak,1976-07-03,RW,R,2010-11,15,0,0,0,0.0,-1,4,0.0,18,3399.0,3:46,0,0,0,0.0,20,2,0,5,-5,0,0,0,0.0,0:0,0,0,0,0.0,0:0,575000
8460503,Mattias,Ohlund,1976-09-09,D,L,2010-11,72,0,5,5,0.07,-7,39,0.0,70,80890.0,18:43,0,0,0,0.0,135,136,17,34,-17,0,1,1,857.0,0:11,0,0,0,12061.0,2:47,3607142
8460533,Dave,Scatchard,1976-02-20,C,R,2010-11,8,0,1,1,0.12,1,6,0.0,6,2283.0,4:45,12,14,26,46.15,7,0,0,1,-1,0,0,0,9.0,0:1,0,0,0,1.0,0:0,550000
8460542,Patrik,Elias,1976-04-13,C,L,2010-11,81,21,41,62,0.77,-4,204,10.29,16,90583.0,18:38,224,274,498,44.98,62,25,45,55,-10,7,13,20,13375.0,2:45,1,0,1,10301.0,2:7,6000000
8460556,Freddy,Modin,1974-10-08,LW,L,2010-11,40,7,3,10,0.25,-14,54,12.96,14,27848.0,11:36,8,12,20,40.0,19,22,14,11,3,0,0,0,1095.0,0:27,1,0,1,2417.0,1:0,800000
8460562,Chris,Drury,1976-08-20,C,R,2010-11,24,1,4,5,0.21,2,26,3.85,8,17303.0,12:0,127,98,225,56.44,19,12,9,3,6,0,0,0,874.0,0:36,0,0,0,2431.0,1:41,7050000
8460580,Brad,Lukowich,1976-08-12,D,L,2010-11,5,0,0,0,0.0,2,3,0.0,0,3079.0,10:15,0,0,0,0.0,5,6,1,0,1,0,0,0,4.0,0:0,0,0,0,0.0,0:0,1000000
8460621,Daniel,Alfredsson,1972-12-11,RW,R,2010-11,54,14,17,31,0.57,-19,96,14.58,18,62454.0,19:16,2,10,12,16.67,41,21,45,46,-1,7,5,12,10288.0,3:10,0,0,0,6234.0,1:55,4875000
8460661,Shane,Hnidy,1975-11-08,D,R,2010-11,3,0,0,0,0.0,-2,3,0.0,2,2660.0,14:46,0,0,0,0.0,2,1,0,1,-1,0,0,0,0.0,0:0,0,0,0,62.0,0:20,500000
8460719,Steve,Sullivan,1974-07-06,LW,R,2010-11,44,10,12,22,0.5,4,79,12.66,28,42324.0,16:1,5,8,13,38.46,18,10,16,24,-8,3,4,7,7173.0,2:43,0,0,0,1587.0,0:36,3750000
8460720,Eric,Boulton,1976-08-17,LW,L,2010-11,69,6,4,10,0.14,1,51,11.76,87,37087.0,8:57,0,3,3,0.0,93,20,11,14,-3,0,0,0,338.0,0:4,0,0,0,57.0,0:0,650000
8462038,Shane,Doan,1976-10-10,RW,R,2010-11,72,20,40,60,0.83,5,221,9.05,67,83336.0,19:17,73,86,159,45.91,172,28,41,36,5,11,10,21,16268.0,3:45,0,0,0,2251.0,0:31,4550000
8462042,Jarome,Iginla,1977-07-01,RW,R,2010-11,82,43,43,86,1.05,0,289,14.88,40,103004.0,20:56,227,193,420,54.05,103,28,40,70,-30,14,16,30,19771.0,4:1,0,0,0,435.0,0:5,7000000
8462093,Peter,Schaefer,1977-07-12,LW,L,2010-11,16,1,1,2,0.12,-3,10,10.0,2,9289.0,9:40,13,20,33,39.39,18,7,8,1,7,0,0,0,45.0,0:2,0,0,0,1739.0,1:48,600000
8462118,Marc,Savard,1977-07-17,C,L,2010-11,25,2,8,10,0.4,-7,50,4.0,29,23705.0,15:48,167,161,328,50.91,5,4,3,18,-15,0,4,4,4468.0,2:58,0,0,0,131.0,0:5,4021428
8462129,Michal,Handzus,1977-03-11,C,L,2010-11,82,12,18,30,0.37,-5,94,12.77,20,85340.0,17:20,678,634,1312,51.68,86,48,24,39,-15,4,6,10,13321.0,2:42,0,1,1,11873.0,2:24,4000000
8462176,Brent,Sopel,1977-01-07,D,R,2010-11,71,2,5,7,0.1,6,44,4.55,16,69624.0,16:20,0,0,0,0.0,36,152,25,39,-14,0,1,1,941.0,0:13,0,0,0,13902.0,3:15,2333333
8462196,Stephane,Robidas,1977-03-03,D,R,2010-11,81,5,25,30,0.37,-7,106,4.72,67,119229.0,24:31,0,0,0,0.0,216,135,28,35,-7,1,14,15,13797.0,2:50,0,2,2,15966.0,3:17,3300000
8462225,Filip,Kuba,1976-12-29,D,L,2010-11,64,2,14,16,0.25,-26,76,2.63,16,79602.0,20:43,0,0,0,0.0,23,104,22,41,-19,0,7,7,8157.0,2:7,0,1,1,9584.0,2:29,3700000
8462535,Jody,Shelley,1976-02-07,LW,L,2010-11,58,2,2,4,0.07,0,31,6.45,127,21511.0,6:10,2,2,4,50.0,96,15,5,10,-5,0,0,0,183.0,0:3,0,0,0,4.0,0:0,1100000
8464956,Chris,Phillips,1978-03-09,D,L,2010-11,82,1,8,9,0.11,-35,81,1.23,32,105889.0,21:31,0,0,0,0.0,116,152,26,54,-28,0,1,1,891.0,0:10,0,0,0,17426.0,3:32,3500000
8464962,Ruslan,Salei,1974-11-02,D,L,2010-11,75,2,8,10,0.13,0,75,2.67,48,80847.0,17:57,0,0,0,0.0,117,109,19,35,-16,0,0,0,330.0,0:4,0,0,0,9772.0,2:10,750000
8464966,Derek,Morris,1978-08-24,D,R,2010-11,77,5,11,16,0.21,-2,83,6.02,58,97290.0,21:3,2,1,3,66.67,117,136,14,31,-17,1,0,1,3676.0,0:47,0,1,1,11671.0,2:31,2750000
8464967,Marty,Reasoner,1977-02-26,C,L,2010-11,82,14,18,32,0.39,2,124,11.29,22,84435.0,17:9,700,584,1284,54.52,71,57,52,17,35,0,1,1,2705.0,0:32,0,0,0,13598.0,2:45,1150000
8464975,Daniel,Briere,1977-10-06,C,R,2010-11,77,34,34,68,0.88,20,246,13.82,87,84593.0,18:18,395,425,820,48.17,36,17,33,16,17,6,9,15,14164.0,3:3,0,0,0,336.0,0:4,6500000
8464977,Dainius,Zubrus,1978-06-16,C,L,2010-11,79,13,17,30,0.38,-11,115,11.3,53,81299.0,17:9,253,196,449,56.35,107,32,33,30,3,1,2,3,11390.0,2:24,0,1,1,3073.0,0:38,3400000
8464989,Matt,Cullen,1976-11-02,C,L,2010-11,78,12,27,39,0.5,-14,150,8.0,34,84368.0,18:1,473,370,843,56.11,39,36,43,34,9,5,16,21,14610.0,3:7,4,0,4,9409.0,2:0,3500000
8464994,Steve,Begin,1978-06-14,LW,L,2010-11,2,0,0,0,0.0,-2,2,0.0,4,1177.0,9:48,0,0,0,0.0,5,0,1,0,1,0,0,0,0.0,0:0,0,0,0,0.0,0:0,550000
8465005,Colin,White,1977-12-12,D,L,2010-11,69,0,6,6,0.09,-2,50,0.0,48,78060.0,18:51,0,0,0,0.0,109,100,21,38,-17,0,0,0,200.0,0:2,0,1,1,11517.0,2:46,3000000
8465009,Zdeno,Chara,1977-03-18,D,L,2010-11,81,14,30,44,0.54,33,264,5.3,88,123613.0,25:26,0,0,0,0.0,153,111,32,62,-30,8,7,15,15265.0,3:8,1,1,2,13672.0,2:48,7500000
8465042,Toni,Lydman,1977-09-25,D,L,2010-11,78,3,22,25,0.32,32,99,3.03,42,103760.0,22:10,0,0,0,0.0,141,178,11,38,-27,0,2,2,2819.0,0:36,0,0,0,17447.0,3:43,3000000
8465050,Eric,Belanger,1977-12-16,C,L,2010-11,82,13,27,40,0.49,11,127,10.24,36,85324.0,17:20,717,580,1297,55.28,71,45,45,29,16,1,4,5,7419.0,1:30,1,0,1,8841.0,1:47,750000
8465058,Michal,Rozsival,1978-09-03,D,R,2010-11,65,6,15,21,0.32,6,55,10.91,42,81909.0,21:0,0,0,0,0.0,100,108,24,24,0,2,6,8,7819.0,2:0,0,0,0,7395.0,1:53,5000000
8465059,Matt,Bradley,1978-06-13,RW,R,2010-11,61,4,7,11,0.18,-3,58,6.9,68,38378.0,10:29,4,7,11,36.36,161,15,12,5,7,0,0,0,309.0,0:5,0,0,0,204.0,0:3,1000000
8465166,Craig,Adams,1977-04-26,RW,R,2010-11,80,4,11,15,0.19,-5,90,4.44,76,58496.0,12:11,194,271,465,41.72,171,64,24,15,9,0,0,0,124.0,0:1,2,2,4,14831.0,3:5,550000
8465185,Willie,Mitchell,1977-04-23,D,L,2010-11,57,5,5,10,0.18,4,59,8.47,21,74607.0,21:48,0,0,0,0.0,35,85,12,47,-35,0,0,0,365.0,0:6,1,0,1,11636.0,3:24,3500000
8465192,Samuel,Pahlsson,1977-12-17,C,L,2010-11,82,7,13,20,0.24,-13,108,6.48,30,75463.0,15:20,675,623,1298,52.0,162,49,28,8,20,0,0,0,371.0,0:4,1,0,1,13989.0,2:50,2650000
8465200,Tomas,Kaberle,1978-03-02,D,L,2010-11,82,4,43,47,0.57,4,130,3.08,18,108786.0,22:6,0,0,0,0.0,37,140,29,70,-41,0,25,25,19986.0,4:3,0,0,0,1433.0,0:17,4250000
8465202,Sami,Salo,1974-09-02,D,R,2010-11,27,3,4,7,0.26,-3,39,7.69,14,32955.0,20:20,0,0,0,0.0,6,28,3,18,-15,1,2,3,3078.0,1:54,0,0,0,4617.0,2:51,3500000
8465210,Pavel,Kubina,1977-04-15,D,R,2010-11,79,4,19,23,0.29,2,78,5.13,62,91129.0,19:13,0,0,0,0.0,90,115,19,35,-16,1,4,5,11213.0,2:21,0,0,0,4595.0,0:58,3850000
8465914,Francis,Bouillon,1975-10-17,D,L,2010-11,44,1,9,10,0.23,-3,47,2.13,27,53411.0,20:13,0,0,0,0.0,133,51,13,24,-11,0,2,2,3363.0,1:16,0,0,0,3695.0,1:23,1350000
8465951,Matt,Cooke,1978-09-07,LW,L,2010-11,67,12,18,30,0.45,14,95,12.63,129,62855.0,15:38,8,21,29,27.59,192,39,23,19,4,0,0,0,3218.0,0:48,3,3,6,11057.0,2:45,1800000
8465978,Shawn,Thornton,1977-07-23,LW,R,2010-11,79,10,10,20,0.25,8,151,6.62,122,47783.0,10:4,17,14,31,54.84,141,18,23,6,17,0,0,0,645.0,0:8,0,0,0,113.0,0:1,812500
8466138,Joe,Thornton,1979-07-02,C,L,2010-11,80,21,49,70,0.88,4,149,14.09,47,95377.0,19:52,675,565,1240,54.44,56,35,114,98,16,9,24,33,16259.0,3:23,2,0,2,5712.0,1:11,7200000
8466139,Patrick,Marleau,1979-09-15,C,L,2010-11,82,37,36,73,0.89,-3,279,13.26,16,102286.0,20:47,288,261,549,52.46,86,31,35,66,-31,11,15,26,16429.0,3:20,2,1,3,9791.0,1:59,6900000
8466140,Olli,Jokinen,1978-12-05,C,L,2010-11,79,17,37,54,0.68,-17,208,8.17,44,84263.0,17:46,552,613,1165,47.38,56,35,54,45,9,5,14,19,14803.0,3:7,0,0,0,792.0,0:10,3000000
8466142,Eric,Brewer,1979-04-17,D,L,2010-11,76,9,7,16,0.21,6,110,8.18,81,100524.0,22:2,0,0,0,0.0,145,120,23,40,-17,0,0,0,2731.0,0:35,0,0,0,14283.0,3:7,4250000
8466144,Paul,Mara,1979-09-07,D,L,2010-11,53,1,5,6,0.11,1,50,2.0,88,58130.0,18:16,0,0,0,0.0,88,85,4,12,-8,0,0,0,2826.0,0:53,0,0,0,7530.0,2:22,750000
8466145,Nick,Boynton,1979-01-14,D,R,2010-11,51,1,7,8,0.16,-1,43,2.33,40,44819.0,14:38,0,0,0,0.0,61,87,15,25,-10,0,0,0,446.0,0:8,0,0,0,2920.0,0:57,500000
8466148,Marian,Hossa,1979-01-12,RW,L,2010-11,65,25,32,57,0.88,9,205,12.2,32,76856.0,19:42,3,1,4,75.0,48,23,53,32,21,8,11,19,10531.0,2:42,2,1,3,6843.0,1:45,5275000
8466149,Daniel,Cleary,1978-12-18,RW,L,2010-11,68,26,20,46,0.68,-1,192,13.54,20,67875.0,16:38,35,56,91,38.46,112,25,18,16,2,5,3,8,6282.0,1:32,0,0,0,4805.0,1:10,2800000
8466158,Scott,Hannan,1979-01-23,D,L,2010-11,78,1,10,11,0.14,4,56,1.79,34,92601.0,19:47,0,0,0,0.0,84,122,19,41,-22,0,0,0,555.0,0:7,0,1,1,12499.0,2:40,4500000
8466160,Brenden,Morrow,1979-01-16,LW,L,2010-11,82,33,23,56,0.68,-3,209,15.79,76,94639.0,19:14,1,10,11,9.09,225,43,41,60,-19,9,4,13,18486.0,3:45,1,0,1,3665.0,0:44,4100000
8466215,Joe,Corvo,1977-06-20,D,R,2010-11,82,11,29,40,0.49,-14,191,5.76,18,121910.0,24:46,0,1,1,0.0,55,119,60,64,-4,5,18,23,19805.0,4:1,1,0,1,13286.0,2:42,2250000
8466251,Jason,Chimera,1979-05-02,LW,L,2010-11,81,10,16,26,0.32,-10,162,6.17,64,64422.0,13:15,20,19,39,51.28,98,16,26,27,-1,2,1,3,2929.0,0:36,0,0,0,4176.0,0:51,1875000
8466285,Brian,Campbell,1979-05-23,D,L,2010-11,65,5,22,27,0.42,28,84,5.95,6,89632.0,22:58,0,0,0,0.0,28,101,21,42,-21,2,4,6,7940.0,2:2,0,0,0,6774.0,1:44,7142875
8466333,Andrew,Ference,1979-03-17,D,L,2010-11,70,3,12,15,0.21,22,78,3.85,60,75513.0,17:58,0,0,0,0.0,74,82,4,28,-24,0,1,1,1483.0,0:21,0,1,1,7714.0,1:50,2250000
8466371,John,Madden,1973-05-04,C,L,2010-11,76,12,13,25,0.33,-9,107,11.21,10,69947.0,15:20,504,484,988,51.01,43,59,44,21,23,1,1,2,1476.0,0:19,1,0,1,11233.0,2:27,1000000
8466378,Martin,St. Louis,1975-06-18,RW,L,2010-11,82,31,68,99,1.21,0,254,12.2,12,103221.0,20:58,50,81,131,38.17,37,64,55,71,-16,4,37,41,22223.0,4:31,0,0,0,2282.0,0:27,5250000
8466393,Pascal,Dupuis,1979-04-07,RW,L,2010-11,81,17,20,37,0.46,16,171,9.94,59,81939.0,16:51,6,22,28,21.43,117,55,33,14,19,0,0,0,2141.0,0:26,4,1,5,11719.0,2:24,1400000
8466398,Tom,Kostopoulos,1979-01-24,RW,R,2010-11,76,8,10,18,0.24,-4,79,10.13,74,56268.0,12:20,18,49,67,26.87,122,41,28,18,10,2,1,3,1130.0,0:14,0,0,0,7858.0,1:43,916667
8467096,Dan,Boyle,1976-07-12,D,R,2010-11,76,9,41,50,0.66,2,199,4.52,67,119641.0,26:14,0,2,2,0.0,55,139,34,51,-17,4,23,27,19560.0,4:17,0,0,0,10298.0,2:15,6666666
8467304,Andy,Sutton,1975-03-10,D,L,2010-11,39,0,4,4,0.1,1,31,0.0,87,34523.0,14:45,0,0,0,0.0,62,87,5,14,-9,0,1,1,199.0,0:5,0,2,2,5610.0,2:23,2062500
8467329,Vincent,Lecavalier,1980-04-21,C,L,2010-11,65,25,29,54,0.83,-5,210,11.9,43,71971.0,18:27,591,570,1161,50.9,93,25,35,26,9,12,16,28,15556.0,3:59,0,0,0,903.0,0:13,7727272
8467330,David,Legwand,1980-08-17,C,L,2010-11,64,17,24,41,0.64,13,130,13.08,24,72220.0,18:48,395,442,837,47.19,36,20,55,44,11,0,4,4,6160.0,1:36,2,0,2,7791.0,2:1,4500000
8467331,Brad,Stuart,1979-11-06,D,L,2010-11,67,3,17,20,0.3,4,81,3.7,40,86548.0,21:31,0,0,0,0.0,131,114,13,52,-39,1,1,2,2304.0,0:34,0,1,1,14256.0,3:32,3750000
8467332,Bryan,Allen,1980-08-21,D,L,2010-11,72,4,13,17,0.24,-1,58,6.9,82,79152.0,18:19,0,0,0,0.0,118,103,24,27,-3,0,0,0,456.0,0:6,0,0,0,9673.0,2:14,2900000
8467334,Manny,Malhotra,1980-05-18,C,L,2010-11,72,11,19,30,0.42,9,111,9.91,22,69839.0,16:9,778,483,1261,61.7,57,74,40,18,22,3,3,6,3239.0,0:44,1,1,2,11934.0,2:45,2500000
8467336,Mike,Rupp,1980-01-13,LW,L,2010-11,81,9,8,17,0.21,-4,81,11.11,124,48869.0,10:3,82,80,162,50.62,181,17,9,12,-3,0,1,1,3846.0,0:47,0,0,0,1059.0,0:13,825000
8467338,Alex,Tanguay,1979-11-21,LW,L,2010-11,79,22,47,69,0.87,0,120,18.33,24,93674.0,19:45,42,65,107,39.25,31,38,49,57,-8,3,17,20,17335.0,3:39,0,0,0,6054.0,1:16,1700000
8467344,Robyn,Regehr,1980-04-19,D,L,2010-11,79,2,15,17,0.22,2,72,2.78,58,101835.0,21:29,0,0,0,0.0,180,142,12,41,-29,1,1,2,1145.0,0:14,0,1,1,15226.0,3:12,4020000
8467346,Simon,Gagne,1980-02-29,LW,L,2010-11,63,17,23,40,0.63,-12,154,11.04,20,63839.0,16:53,6,10,16,37.5,49,20,23,21,2,7,8,15,11761.0,3:6,0,0,0,826.0,0:13,5250000
8467351,Scott,Gomez,1979-12-23,C,L,2010-11,80,7,31,38,0.48,-15,157,4.46,48,89105.0,18:33,575,622,1197,48.04,32,24,56,28,28,3,14,17,13003.0,2:42,0,1,1,4599.0,0:57,7357143
8467365,John,Erskine,1980-06-26,D,L,2010-11,73,4,7,11,0.15,1,58,6.9,94,64950.0,14:49,0,0,0,0.0,166,120,11,37,-26,0,0,0,232.0,0:3,0,0,0,5742.0,1:18,1250000
8467370,Mike,Fisher,1980-06-05,C,R,2010-11,82,19,17,36,0.44,-17,192,9.9,43,90370.0,18:22,602,644,1246,48.31,135,89,36,43,-7,4,10,14,11770.0,2:23,0,0,0,6707.0,1:21,4200000
8467371,Mike,Ribeiro,1980-02-10,C,L,2010-11,82,19,52,71,0.87,-4,161,11.8,28,98196.0,19:57,565,648,1213,46.58,95,33,72,71,1,7,16,23,18963.0,3:51,0,0,0,4311.0,0:52,5000000
8467389,Brad,Richards,1980-05-02,C,L,2010-11,72,28,49,77,1.07,1,272,10.29,24,93850.0,21:43,501,489,990,50.61,20,22,47,73,-26,7,22,29,23058.0,5:20,0,0,0,1478.0,0:20,7800000
8467393,Jarkko,Ruutu,1975-08-23,LW,L,2010-11,73,3,9,12,0.16,-2,66,4.55,97,49807.0,11:22,8,12,20,40.0,131,29,17,23,-6,0,0,0,245.0,0:3,0,1,1,8113.0,1:51,1300000
8467396,Erik,Cole,1978-11-06,LW,L,2010-11,82,26,26,52,0.63,-1,201,12.94,49,90813.0,18:27,7,27,34,20.59,225,34,65,36,29,3,5,8,13296.0,2:42,1,1,2,6767.0,1:22,2900000
8467400,Francois,Beauchemin,1980-06-04,D,L,2010-11,81,5,12,17,0.21,-8,106,4.72,32,112134.0,23:4,0,1,1,0.0,122,182,34,90,-56,1,2,3,8071.0,1:39,0,0,0,13670.0,2:48,3800000
8467407,Brian,Gionta,1979-01-18,RW,R,2010-11,82,29,17,46,0.56,3,298,9.73,24,96525.0,19:37,19,40,59,32.2,87,31,45,27,18,7,4,11,14254.0,2:53,2,0,2,9517.0,1:56,5000000
8467408,Matt,Walker,1980-04-07,D,R,2010-11,4,0,0,0,0.0,0,3,0.0,4,2792.0,11:38,0,0,0,0.0,5,5,0,1,-1,0,0,0,0.0,0:0,0,0,0,23.0,0:5,1700000
8467412,Alexei,Ponikarovsky,1980-04-09,LW,L,2010-11,61,5,10,15,0.25,1,94,5.32,36,46114.0,12:35,1,4,5,20.0,139,28,12,27,-15,1,2,3,3399.0,0:55,0,0,0,3553.0,0:58,3200000
8467423,Shawn,Horcoff,1978-09-17,C,L,2010-11,47,9,18,27,0.57,-1,78,11.54,46,52693.0,18:41,393,420,813,48.34,32,20,29,24,5,5,5,10,7683.0,2:43,0,1,1,4402.0,1:33,5500000
8467428,Krys,Barch,1980-03-26,RW,L,2010-11,44,2,1,3,0.07,-7,16,12.5,80,13792.0,5:13,2,2,4,50.0,53,2,3,12,-9,0,0,0,296.0,0:6,0,0,0,11.0,0:0,837500
8467439,Jaroslav,Spacek,1974-02-11,D,L,2010-11,59,1,15,16,0.27,9,65,1.54,45,68121.0,19:14,0,0,0,0.0,61,90,30,55,-25,0,3,3,4740.0,1:20,0,1,1,8048.0,2:16,3833333
8467452,Rob,Scuderi,1978-12-30,D,L,2010-11,82,2,13,15,0.18,1,46,4.35,16,99826.0,20:17,0,0,0,0.0,64,122,22,59,-37,0,0,0,323.0,0:3,0,0,0,13636.0,2:46,3400000
8467463,Mikael,Samuelsson,1976-12-23,RW,R,2010-11,75,18,32,50,0.67,8,215,8.37,36,74844.0,16:37,9,19,28,32.14,76,21,25,36,-11,5,14,19,11187.0,2:29,0,0,0,152.0,0:2,2500000
8467466,Trent,Hunter,1980-07-05,RW,R,2010-11,17,1,3,4,0.24,-3,30,3.33,23,12914.0,12:39,0,2,2,0.0,36,5,3,2,1,0,0,0,1252.0,1:13,0,0,0,123.0,0:7,2000000
8467478,Kent,Huskins,1979-05-04,D,L,2010-11,50,2,8,10,0.2,8,38,5.26,12,49847.0,16:36,0,0,0,0.0,18,58,10,21,-11,0,0,0,294.0,0:5,0,0,0,4350.0,1:27,1700000
8467493,Chris,Neil,1979-06-18,RW,R,2010-11,80,6,10,16,0.2,-14,105,5.71,210,61260.0,12:45,3,3,6,50.0,258,21,35,20,15,0,0,0,2383.0,0:29,0,0,0,1.0,0:0,2000000
8467496,Andrei,Markov,1978-12-20,D,L,2010-11,7,1,2,3,0.43,2,20,5.0,4,9624.0,22:54,0,0,0,0.0,2,5,3,9,-6,0,1,1,1501.0,3:34,0,0,0,857.0,2:2,5750000
8467502,Ales,Kotalik,1978-12-23,RW,R,2010-11,26,4,2,6,0.23,-7,62,6.45,8,19302.0,12:22,6,5,11,54.55,38,4,7,10,-3,1,1,2,2242.0,1:26,0,0,0,30.0,0:1,3000000
8467514,Pavel,Datsyuk,1978-07-20,C,L,2010-11,56,23,36,59,1.05,11,137,16.79,15,64924.0,19:19,429,356,785,54.65,54,20,71,38,33,6,12,18,10665.0,3:10,1,0,1,2239.0,0:39,6700000
8467519,Karlis,Skrastins,1974-07-09,D,L,2010-11,74,3,5,8,0.11,-1,30,10.0,38,79699.0,17:57,0,1,1,0.0,55,139,23,19,4,0,0,0,188.0,0:2,0,1,1,14393.0,3:14,1375000
8467545,Michael,Ryder,1980-03-31,RW,R,2010-11,79,18,23,41,0.52,-1,165,10.91,26,68663.0,14:29,5,3,8,62.5,70,19,35,28,7,8,6,14,9933.0,2:5,0,0,0,151.0,0:1,4000000
8467831,Jeff,Halpern,1976-05-03,C,R,2010-11,72,11,15,26,0.36,6,62,17.74,29,55003.0,12:43,338,256,594,56.9,42,53,15,18,-3,0,0,0,533.0,0:7,1,0,1,10101.0,2:20,600000
8467844,Jason,Blake,1973-09-02,LW,L,2010-11,76,16,16,32,0.42,-5,187,8.56,41,67305.0,14:45,1,4,5,20.0,76,27,34,36,-2,3,4,7,6836.0,1:29,0,0,0,104.0,0:1,4000000
8467856,Brian,Rafalski,1973-09-28,D,R,2010-11,63,4,44,48,0.76,11,106,3.77,22,77198.0,20:25,0,0,0,0.0,49,54,12,57,-45,0,17,17,13413.0,3:32,0,0,0,879.0,0:13,6000000
8467875,Daniel,Sedin,1980-09-26,LW,L,2010-11,82,41,63,104,1.27,30,266,15.41,32,91281.0,18:33,4,13,17,23.53,13,12,36,48,-12,18,24,42,17761.0,3:36,0,0,0,515.0,0:6,6100000
8467876,Henrik,Sedin,1980-09-26,C,L,2010-11,82,19,75,94,1.15,26,157,12.1,40,94757.0,19:15,721,666,1387,51.98,15,21,43,38,5,8,27,35,17690.0,3:35,0,0,0,753.0,0:9,6100000
8467878,Tim,Connolly,1981-05-07,C,R,2010-11,68,13,29,42,0.62,-10,151,8.61,20,69017.0,16:54,445,524,969,45.92,24,53,22,34,-12,6,13,19,11546.0,2:49,0,0,0,7040.0,1:43,4500000
8467890,Barret,Jackman,1981-03-05,D,L,2010-11,60,0,13,13,0.22,3,65,0.0,57,74906.0,20:48,0,0,0,0.0,78,114,28,24,4,0,0,0,162.0,0:2,0,3,3,10167.0,2:49,3625000
8467899,Martin,Havlat,1981-04-19,RW,L,2010-11,78,22,40,62,0.79,-10,229,9.61,52,85879.0,18:21,3,7,10,30.0,34,24,43,47,-4,3,11,14,13432.0,2:52,0,0,0,611.0,0:7,4250000
8467915,Mike,Commodore,1979-11-07,D,R,2010-11,20,2,4,6,0.3,-8,32,6.25,44,22272.0,18:33,0,1,1,0.0,38,25,5,7,-2,0,2,2,2067.0,1:43,0,1,1,3046.0,2:32,3750000
8467917,Jordan,Leopold,1980-08-03,D,L,2010-11,71,13,22,35,0.49,-11,134,9.7,36,99380.0,23:19,0,0,0,0.0,49,123,15,50,-35,5,6,11,11707.0,2:44,0,0,0,10973.0,2:34,3000000
8467925,Adam,Hall,1980-08-14,RW,R,2010-11,82,7,11,18,0.22,-12,167,4.19,32,73059.0,14:50,360,295,655,54.96,152,59,22,18,4,0,0,0,850.0,0:10,0,0,0,13845.0,2:48,600000
8467928,Doug,Janik,1980-03-26,D,L,2010-11,7,0,0,0,0.0,-2,8,0.0,7,5551.0,13:13,0,0,0,0.0,2,7,0,5,-5,0,0,0,9.0,0:1,0,0,0,328.0,0:46,512500
8467931,Matt,Carkner,1980-11-03,D,R,2010-11,50,1,6,7,0.14,0,40,2.5,136,44652.0,14:53,0,0,0,0.0,71,59,9,22,-13,0,0,0,64.0,0:1,0,1,1,5952.0,1:59,700000
8467943,Niklas,Hagman,1979-12-05,LW,L,2010-11,71,11,16,27,0.38,-2,140,7.86,24,58104.0,13:38,3,22,25,12.0,35,12,12,25,-13,4,3,7,7341.0,1:43,0,0,0,65.0,0:0,3000000
8467964,Mike,Comrie,1980-09-11,C,L,2010-11,21,1,5,6,0.29,-4,25,4.0,18,14896.0,11:49,15,25,40,37.5,10,5,2,3,-1,0,2,2,3398.0,2:41,0,0,0,0.0,0:0,500000
8467967,Chris,Kelly,1980-11-11,C,L,2010-11,81,14,14,28,0.35,-13,113,12.39,33,74919.0,15:24,466,450,916,50.87,81,54,40,25,15,0,0,0,988.0,0:12,1,2,3,12231.0,2:31,2125000
8467988,Ryan,Malone,1979-12-01,LW,L,2010-11,54,14,24,38,0.7,-3,149,9.4,51,51940.0,16:1,56,87,143,39.16,125,19,28,16,12,9,9,18,10514.0,3:14,0,0,0,2530.0,0:46,4500000
8468001,Derek,MacKenzie,1981-06-11,C,L,2010-11,63,9,14,23,0.37,14,76,11.84,22,41001.0,10:50,246,227,473,52.01,159,26,33,13,20,0,1,1,1413.0,0:22,1,1,2,6316.0,1:40,600000
8468064,Martin,Erat,1981-08-29,RW,L,2010-11,64,17,33,50,0.78,14,135,12.59,22,69474.0,18:5,19,25,44,43.18,57,21,35,35,0,7,8,15,9845.0,2:33,0,0,0,4259.0,1:6,4500000
8468083,Henrik,Zetterberg,1980-10-09,C,L,2010-11,80,24,56,80,1.0,-1,306,7.84,40,94002.0,19:35,516,468,984,52.44,38,19,54,60,-6,10,20,30,15605.0,3:15,0,1,1,2965.0,0:37,6083333
8468085,Radim,Vrbata,1981-06-13,RW,R,2010-11,79,19,29,48,0.61,5,240,7.92,20,77582.0,16:22,2,5,7,28.57,42,22,32,28,4,10,7,17,15310.0,3:13,0,0,0,503.0,0:6,3000000
8468095,George,Parros,1979-12-29,RW,R,2010-11,78,3,1,4,0.05,-4,33,9.09,171,30014.0,6:24,1,3,4,25.0,97,26,7,13,-6,0,0,0,68.0,0:0,0,0,0,0.0,0:0,875000
8468101,Radek,Martinek,1976-08-31,D,R,2010-11,64,3,13,16,0.25,-5,97,3.09,35,80047.0,20:50,0,0,0,0.0,69,128,34,39,-5,1,0,1,2157.0,0:33,0,0,0,9999.0,2:36,1500000
8468114,Douglas,Murray,1980-03-12,D,L,2010-11,73,1,13,14,0.19,5,102,0.98,44,85900.0,19:36,0,0,0,0.0,203,140,21,27,-6,0,1,1,1717.0,0:23,0,0,0,9067.0,2:4,2500000
8468162,Jerred,Smithson,1979-02-04,C,R,2010-11,82,5,8,13,0.16,-6,73,6.85,34,73061.0,14:50,578,428,1006,57.46,162,64,41,21,20,0,0,0,767.0,0:9,0,0,0,13477.0,2:44,762500
8468208,Joel,Ward,1980-12-02,RW,R,2010-11,80,10,19,29,0.36,-1,157,6.37,42,81948.0,17:4,82,86,168,48.81,67,57,51,29,22,5,0,5,7218.0,1:30,0,1,1,9033.0,1:52,1500000
8468213,Jim,Vandermeer,1980-02-21,D,L,2010-11,62,2,12,14,0.23,-15,57,3.51,74,67707.0,18:12,0,0,0,0.0,122,78,27,47,-20,0,2,2,1730.0,0:27,0,1,1,7736.0,2:4,2300000
8468224,Sean,Avery,1980-04-10,LW,L,2010-11,76,3,21,24,0.32,-4,137,2.19,174,51227.0,11:14,15,9,24,62.5,115,24,19,19,0,0,1,1,1686.0,0:22,0,0,0,8.0,0:0,3875000
8468252,Eric,Godard,1980-03-07,RW,R,2010-11,19,0,3,3,0.16,4,1,0.0,105,5898.0,5:10,0,0,0,0.0,19,2,0,1,-1,0,0,0,27.0,0:1,0,0,0,10.0,0:0,750000
8468434,Andy,McDonald,1977-08-25,LW,L,2010-11,58,20,30,50,0.86,18,180,11.11,26,69721.0,20:2,207,142,349,59.31,40,27,23,15,8,5,12,17,11657.0,3:20,1,0,1,3174.0,0:54,4700000
8468478,Mike,Weaver,1978-05-02,D,R,2010-11,82,2,11,13,0.16,1,53,3.77,34,102370.0,20:48,0,0,0,0.0,98,132,47,29,18,0,1,1,1097.0,0:13,0,0,0,16001.0,3:15,900000
8468482,Dany,Heatley,1981-01-21,LW,L,2010-11,80,26,38,64,0.8,8,217,11.98,56,94327.0,19:39,9,11,20,45.0,104,29,29,68,-39,11,19,30,15491.0,3:13,1,1,2,4949.0,1:1,7500000
8468483,Marian,Gaborik,1982-02-14,RW,L,2010-11,62,22,26,48,0.77,8,192,11.46,18,67274.0,18:5,0,0,0,0.0,46,22,34,26,8,7,9,16,11772.0,3:9,0,0,0,867.0,0:13,7500000
8468484,Rostislav,Klesla,1982-03-21,D,L,2010-11,61,4,7,11,0.18,4,67,5.97,38,69810.0,19:4,1,0,1,100.0,61,131,18,9,9,0,0,0,230.0,0:3,0,0,0,11472.0,3:8,2975000
8468485,Raffi,Torres,1981-10-08,LW,L,2010-11,80,14,15,29,0.36,4,115,12.17,78,59944.0,12:29,10,22,32,31.25,134,19,31,24,7,3,1,4,4366.0,0:54,0,0,0,19.0,0:0,1000000
8468486,Scott,Hartnell,1982-04-18,LW,L,2010-11,82,24,25,49,0.6,14,177,13.56,142,81696.0,16:36,5,5,10,50.0,168,38,31,33,-2,4,6,10,13611.0,2:45,0,0,0,294.0,0:3,4200000
8468493,Ron,Hainsey,1981-03-24,D,L,2010-11,82,3,16,19,0.23,3,83,3.61,24,88978.0,18:5,0,0,0,0.0,51,173,30,47,-17,0,1,1,2302.0,0:28,0,1,1,8948.0,1:49,4500000
8468498,Brooks,Orpik,1980-09-26,D,L,2010-11,63,1,12,13,0.21,12,56,1.79,66,78936.0,20:52,1,0,1,100.0,194,94,17,20,-3,0,0,0,378.0,0:6,0,3,3,14134.0,3:44,3750000
8468500,Alex,Frolov,1982-06-19,LW,R,2010-11,43,7,9,16,0.37,4,78,8.97,8,37220.0,14:25,1,6,7,14.29,39,15,12,10,2,0,1,1,5859.0,2:16,0,0,0,115.0,0:2,3000000
8468501,Anton,Volchenkov,1982-02-25,D,L,2010-11,57,0,8,8,0.14,3,65,0.0,36,61920.0,18:6,0,0,0,0.0,125,106,7,19,-12,0,0,0,69.0,0:1,0,0,0,7298.0,2:8,4250000
8468502,David,Hale,1981-06-18,D,L,2010-11,25,1,4,5,0.2,7,20,5.0,6,24469.0,16:18,0,0,0,0.0,29,22,8,10,-2,0,0,0,21.0,0:0,0,0,0,1996.0,1:19,675000
8468504,Brad,Boyes,1982-04-17,RW,R,2010-11,83,17,38,55,0.66,13,178,9.55,36,84627.0,16:59,136,184,320,42.5,67,33,30,29,1,6,7,13,12245.0,2:27,0,0,0,268.0,0:3,4000000
8468505,Steve,Ott,1982-08-19,C,L,2010-11,82,12,20,32,0.39,-9,120,10.0,183,84391.0,17:9,644,494,1138,56.59,252,44,25,43,-18,3,7,10,11126.0,2:15,2,2,4,10082.0,2:2,2950000
8468506,Brian,Sutherby,1982-03-01,C,L,2010-11,51,2,2,4,0.08,-10,32,6.25,58,22681.0,7:24,19,13,32,59.38,70,9,9,8,1,0,0,0,341.0,0:6,0,0,0,1892.0,0:37,812500
8468508,Justin,Williams,1981-10-04,RW,R,2010-11,73,22,35,57,0.78,14,213,10.33,59,75561.0,17:15,7,7,14,50.0,51,29,26,64,-38,5,8,13,11550.0,2:38,0,0,0,518.0,0:7,3500000
8468509,Niklas,Kronwall,1981-01-12,D,L,2010-11,77,11,26,37,0.48,5,131,8.4,36,105653.0,22:52,0,0,0,0.0,113,129,26,49,-23,5,8,13,11954.0,2:35,0,0,0,13505.0,2:55,3000000
8468513,Nick,Schultz,1982-08-25,D,L,2010-11,74,3,14,17,0.23,-4,46,6.52,38,89779.0,20:13,1,0,1,100.0,78,132,9,25,-16,0,1,1,1285.0,0:17,0,1,1,12080.0,2:43,3500000
8468515,Brad,Winchester,1981-03-01,LW,L,2010-11,76,10,6,16,0.21,-18,90,11.11,114,47804.0,10:29,2,6,8,25.0,171,18,19,8,11,3,1,4,5364.0,1:10,0,0,0,156.0,0:2,700000
8468518,Tomas,Kopecky,1982-02-05,RW,L,2010-11,81,15,27,42,0.52,-13,178,8.43,60,74475.0,15:19,120,164,284,42.25,77,24,50,25,25,3,10,13,12386.0,2:32,0,0,0,1974.0,0:24,1200000
8468520,Kurtis,Foster,1981-11-24,D,R,2010-11,74,8,14,22,0.3,-12,182,4.4,45,78407.0,17:39,0,0,0,0.0,89,76,18,37,-19,5,9,14,17067.0,3:50,0,0,0,698.0,0:9,1800000
8468526,Jarret,Stoll,1982-06-24,C,R,2010-11,82,20,23,43,0.52,-6,187,10.7,42,84447.0,17:9,753,557,1310,57.48,164,41,31,26,5,4,8,12,12410.0,2:31,1,2,3,7320.0,1:29,3600000
8468534,Andreas,Lilja,1975-07-13,D,L,2010-11,52,1,6,7,0.13,-15,31,3.23,28,54391.0,17:25,0,0,0,0.0,92,113,6,20,-14,0,0,0,103.0,0:1,0,0,0,10943.0,3:30,600000
8468535,Antoine,Vermette,1982-07-20,C,L,2010-11,82,19,28,47,0.57,0,183,10.38,60,92566.0,18:48,856,684,1540,55.58,123,47,35,23,12,3,7,10,14326.0,2:54,1,0,1,7071.0,1:26,3750000
8468542,Paul,Martin,1981-03-05,D,L,2010-11,77,3,21,24,0.31,9,104,2.88,16,107948.0,23:21,0,0,0,0.0,45,129,36,27,9,2,8,10,14038.0,3:2,0,1,1,12683.0,2:44,5000000
8468575,Dominic,Moore,1980-08-03,C,L,2010-11,77,18,14,32,0.42,-12,175,10.29,52,72055.0,15:35,475,417,892,53.25,80,42,32,25,7,6,1,7,4196.0,0:54,0,0,0,9779.0,2:7,1100000
8468577,Niclas,Wallin,1975-02-20,D,L,2010-11,74,3,5,8,0.11,0,86,3.49,46,70313.0,15:50,0,0,0,0.0,99,84,21,40,-19,0,0,0,519.0,0:7,0,0,0,6650.0,1:29,2650000
8468598,Lubomir,Visnovsky,1976-08-11,D,L,2010-11,81,18,50,68,0.84,18,152,11.84,24,118063.0,24:17,0,0,0,0.0,52,116,30,45,-15,5,26,31,20160.0,4:8,0,0,0,2119.0,0:26,5600000
8468611,Matt,Hendricks,1981-06-17,C,L,2010-11,77,9,16,25,0.32,-2,113,7.96,110,52945.0,11:27,52,46,98,53.06,169,38,18,10,8,1,1,2,1418.0,0:18,0,0,0,5749.0,1:14,575000
8468635,Travis,Moen,1982-04-06,LW,L,2010-11,79,6,10,16,0.2,-4,99,6.06,96,62516.0,13:11,8,14,22,36.36,129,42,15,7,8,0,0,0,283.0,0:3,1,0,1,11013.0,2:19,1500000
8468636,Greg,Zanon,1980-06-05,D,L,2010-11,82,0,7,7,0.09,-5,55,0.0,48,105993.0,21:32,0,0,0,0.0,169,212,21,28,-7,0,1,1,612.0,0:7,0,1,1,14928.0,3:2,1933333
8468639,John-Michael,Liles,1980-11-25,D,L,2010-11,76,6,40,46,0.61,-9,163,3.68,35,100360.0,22:0,0,0,0,0.0,59,153,32,36,-4,3,15,18,14706.0,3:13,0,0,0,4843.0,1:3,4200000
8468660,Darcy,Hordichuk,1980-08-10,LW,L,2010-11,64,1,4,5,0.08,-1,32,3.12,76,19464.0,5:4,0,0,0,0.0,116,4,5,6,-1,0,0,0,28.0,0:0,0,0,0,0.0,0:0,775000
8468674,Deryk,Engelland,1982-04-03,D,R,2010-11,63,3,7,10,0.16,-5,49,6.12,123,50426.0,13:20,0,0,0,0.0,122,54,15,14,1,0,0,0,50.0,0:0,0,0,0,1873.0,0:29,500000
8468695,Matthew,Lombardi,1982-03-18,C,L,2010-11,2,0,0,0,0.0,-1,6,0.0,0,1779.0,14:49,16,13,29,55.17,0,0,2,1,1,0,0,0,290.0,2:25,0,0,0,1.0,0:0,3500000
8468700,Paul,Gaustad,1982-02-03,C,L,2010-11,81,12,19,31,0.38,7,117,10.26,101,73551.0,15:8,692,466,1158,59.76,128,44,22,24,-2,1,1,2,3931.0,0:48,0,1,1,9836.0,2:1,2300000
8468704,Antti,Miettinen,1980-07-03,RW,R,2010-11,73,16,19,35,0.48,-3,168,9.52,38,74572.0,17:1,36,64,100,36.0,109,14,23,20,3,8,6,14,12245.0,2:47,0,0,0,5489.0,1:15,2333333
8468778,Colton,Orr,1982-03-03,RW,R,2010-11,46,2,0,2,0.04,-1,14,14.29,128,13999.0,5:4,0,1,1,0.0,46,9,1,5,-4,0,0,0,124.0,0:2,0,0,0,55.0,0:1,1000000
8468789,Jason,Williams,1980-08-11,C,R,2010-11,27,2,3,5,0.19,-2,18,11.11,6,13137.0,8:6,18,26,44,40.91,14,5,10,5,5,0,1,1,737.0,0:27,0,0,0,0.0,0:0,500000
8468846,Tyler,Sloan,1981-03-15,D,L,2010-11,33,1,5,6,0.18,-6,12,8.33,14,24750.0,12:30,0,0,0,0.0,30,32,8,21,-13,0,0,0,10.0,0:0,0,0,0,668.0,0:20,700000
8468927,Steve,Montador,1979-12-21,D,R,2010-11,73,5,21,26,0.36,16,118,4.24,83,86385.0,19:43,0,1,1,0.0,86,138,21,61,-40,0,1,1,1637.0,0:22,0,0,0,9098.0,2:4,1550000
8469454,Ilya,Kovalchuk,1983-04-15,RW,R,2010-11,81,31,29,60,0.74,-26,245,12.65,28,109655.0,22:33,9,22,31,29.03,28,12,43,104,-61,9,12,21,20250.0,4:10,0,0,0,756.0,0:9,6666666
8469455,Jason,Spezza,1983-06-13,C,R,2010-11,62,21,36,57,0.92,-7,188,11.17,28,75140.0,20:11,681,529,1210,56.28,14,24,52,62,-10,7,10,17,13418.0,3:36,0,1,1,6817.0,1:49,7000000
8469457,Stephen,Weiss,1983-04-03,C,L,2010-11,76,21,28,49,0.64,-9,172,12.21,49,91651.0,20:5,689,590,1279,53.87,52,44,44,28,16,3,16,19,16015.0,3:30,2,0,2,7633.0,1:40,3100000
8469459,Mikko,Koivu,1983-03-12,C,L,2010-11,71,17,45,62,0.87,4,191,8.9,50,83033.0,19:29,683,610,1293,52.82,63,29,64,51,13,7,15,22,13741.0,3:13,1,0,1,7804.0,1:49,3250000
8469460,Mike,Komisarek,1982-01-19,D,R,2010-11,75,1,9,10,0.13,-8,48,2.08,86,61340.0,13:37,0,0,0,0.0,146,117,14,51,-37,0,0,0,175.0,0:2,0,0,0,7027.0,1:33,4300000
8469462,Tuomo,Ruutu,1983-02-16,LW,L,2010-11,82,19,38,57,0.7,1,148,12.84,54,82788.0,16:49,265,378,643,41.21,309,38,42,38,4,7,9,16,15317.0,3:6,0,0,0,385.0,0:4,3800000
8469464,Fredrik,Sjostrom,1983-05-06,LW,L,2010-11,66,2,3,5,0.08,-5,62,3.23,14,44392.0,11:12,5,10,15,33.33,108,33,15,15,0,0,0,0,277.0,0:4,0,0,0,6529.0,1:38,750000
8469465,Dan,Hamhuis,1982-12-13,D,L,2010-11,64,6,17,23,0.36,29,109,5.5,34,87089.0,22:40,0,0,0,0.0,76,89,43,33,10,2,5,7,6034.0,1:34,0,0,0,12106.0,3:9,4500000
8469466,Ales,Hemsky,1983-08-13,RW,R,2010-11,47,14,28,42,0.89,3,100,14.0,18,51556.0,18:16,1,6,7,14.29,29,18,17,32,-15,1,8,9,9080.0,3:13,1,1,2,2237.0,0:47,4100000
8469467,Chuck,Kobasew,1982-04-17,RW,R,2010-11,63,9,7,16,0.25,-6,74,12.16,19,44750.0,11:50,6,7,13,46.15,31,20,17,13,4,0,0,0,1436.0,0:22,0,0,0,1319.0,0:20,2333333
8469469,R.J.,Umberger,1982-05-03,C,L,2010-11,82,25,32,57,0.7,3,220,11.36,38,94530.0,19:12,111,109,220,50.45,114,70,44,20,24,8,5,13,16200.0,3:17,3,0,3,9687.0,1:58,3750000
8469470,Carlo,Colaiacovo,1983-01-27,D,L,2010-11,65,6,20,26,0.4,-4,81,7.41,23,70728.0,18:8,0,0,0,0.0,75,79,16,21,-5,1,10,11,10732.0,2:45,0,0,0,1180.0,0:18,2125000
8469472,Shaone,Morrisonn,1982-12-23,D,L,2010-11,62,1,4,5,0.08,-2,44,2.27,32,60166.0,16:10,0,0,0,0.0,110,86,14,15,-1,0,0,0,366.0,0:5,0,0,0,6986.0,1:52,2075000
8469473,Marcel,Goc,1983-08-24,C,L,2010-11,51,9,15,24,0.47,10,111,8.11,6,49079.0,16:2,346,347,693,49.93,51,13,17,17,0,0,0,0,3144.0,1:1,1,0,1,2403.0,0:47,775000
8469474,Colby,Armstrong,1982-11-23,RW,R,2010-11,50,8,15,23,0.46,-1,69,11.59,38,48374.0,16:7,3,5,8,37.5,88,28,34,19,15,0,0,0,1827.0,0:36,0,0,0,5565.0,1:51,3000000
8469476,Tim,Gleason,1983-01-29,D,L,2010-11,82,2,14,16,0.2,-11,84,2.38,85,103149.0,20:57,0,0,0,0.0,215,141,16,43,-27,0,1,1,4977.0,1:0,0,1,1,13425.0,2:43,2750000
8469480,Jeff,Woywitka,1983-09-01,D,L,2010-11,63,2,9,11,0.17,5,72,2.78,24,67834.0,17:56,0,0,0,0.0,43,97,19,27,-8,1,1,2,2272.0,0:36,0,0,0,703.0,0:11,650000
8469483,David,Steckel,1982-03-15,C,L,2010-11,75,6,6,12,0.16,-6,79,7.59,26,53439.0,11:52,511,309,820,62.32,104,50,24,16,8,0,0,0,724.0,0:9,1,0,1,7362.0,1:38,1100000
8469485,Derek,Roy,1983-05-04,C,L,2010-11,35,10,25,35,1.0,-1,89,11.24,16,41026.0,19:32,245,283,528,46.4,16,16,37,25,12,2,12,14,7838.0,3:43,0,0,0,3058.0,1:27,4000000
8469490,Tim,Jackman,1981-11-14,RW,R,2010-11,82,10,13,23,0.28,4,131,7.63,86,48334.0,9:49,6,10,16,37.5,133,21,23,12,11,1,2,3,3765.0,0:45,0,0,0,610.0,0:7,550000
8469492,Fedor,Tyutin,1983-07-19,D,L,2010-11,80,7,20,27,0.34,-12,128,5.47,32,108934.0,22:41,1,1,2,50.0,120,93,29,29,0,1,11,12,14041.0,2:55,0,0,0,13050.0,2:43,2843750
8469500,Michael,Cammalleri,1982-06-08,LW,L,2010-11,67,19,28,47,0.7,2,193,9.84,33,74288.0,18:28,33,41,74,44.59,17,19,23,31,-8,7,14,21,12476.0,3:6,0,0,0,3049.0,0:45,6000000
8469501,Chris,Thorburn,1983-06-03,RW,R,2010-11,82,9,10,19,0.23,-4,114,7.89,77,67876.0,13:47,125,126,251,49.8,129,71,43,10,33,2,1,3,1880.0,0:22,0,0,0,9194.0,1:52,660000
8469505,Noah,Welch,1982-08-26,D,L,2010-11,2,0,0,0,0.0,-1,1,0.0,0,2106.0,17:33,0,0,0,0.0,10,3,0,0,0,0,0,0,0.0,0:0,0,0,0,0.0,0:0,525000
8469506,Jason,Pominville,1982-11-30,RW,R,2010-11,73,22,30,52,0.71,1,215,10.23,15,79509.0,18:9,67,88,155,43.23,35,50,43,27,16,5,9,14,12792.0,2:55,1,0,1,8577.0,1:57,5300000
8469508,Jay,McClement,1983-03-02,C,L,2010-11,80,7,13,20,0.25,-21,127,5.51,30,80120.0,16:41,595,557,1152,51.65,75,63,37,21,16,1,0,1,487.0,0:6,0,1,1,14428.0,3:0,1450000
8469521,Tomas,Plekanec,1982-10-31,C,L,2010-11,77,22,35,57,0.74,8,227,9.69,60,93549.0,20:14,788,789,1577,49.97,53,45,43,37,6,3,15,18,13539.0,2:55,1,1,2,13049.0,2:49,5000000
8469531,Jay,Harrison,1982-11-03,D,L,2010-11,72,3,7,10,0.14,5,49,6.12,72,65970.0,15:16,0,0,0,0.0,111,100,16,32,-16,0,0,0,560.0,0:7,0,0,0,9064.0,2:5,500000
8469544,Patrick,Sharp,1981-12-27,LW,R,2010-11,74,34,37,71,0.96,-1,268,12.69,38,86193.0,19:24,244,264,508,48.03,76,26,64,23,41,12,14,26,14964.0,3:22,2,1,3,5597.0,1:15,3900000
8469547,Jordin,Tootoo,1983-02-02,RW,R,2010-11,54,8,10,18,0.33,8,85,9.41,61,38482.0,11:52,2,1,3,66.67,95,17,25,35,-10,0,0,0,683.0,0:12,0,0,0,0.0,0:0,1250000
8469555,Christian,Ehrhoff,1982-07-06,D,L,2010-11,79,14,36,50,0.63,19,209,6.7,52,113720.0,23:59,0,0,0,0.0,54,108,19,47,-28,6,22,28,16888.0,3:33,0,1,1,10114.0,2:8,3100000
8469581,Kyle,Wellwood,1983-05-16,C,R,2010-11,35,5,8,13,0.37,10,50,10.0,0,28731.0,13:40,65,67,132,49.24,8,7,26,20,6,0,1,1,859.0,0:24,0,0,0,21.0,0:0,650000
8469582,Colin,Stuart,1982-07-08,LW,L,2010-11,3,0,0,0,0.0,1,5,0.0,2,2368.0,13:9,1,1,2,50.0,3,4,2,0,2,0,0,0,2.0,0:0,0,0,0,104.0,0:34,550000
8469584,Joel,Perrault,1983-04-06,C,R,2010-11,7,0,0,0,0.0,-1,3,0.0,0,3021.0,7:11,13,18,31,41.94,11,2,1,2,-1,0,0,0,138.0,0:19,0,0,0,0.0,0:0,510000
8469591,Cody,McCormick,1983-04-18,C,R,2010-11,81,8,12,20,0.25,2,104,7.69,142,53237.0,10:57,132,184,316,41.77,108,60,20,19,1,0,1,1,538.0,0:6,0,0,0,765.0,0:9,500000
8469598,Kevin,Bieksa,1981-06-16,D,R,2010-11,66,6,16,22,0.33,32,105,5.71,73,88976.0,22:28,0,0,0,0.0,104,93,50,41,9,1,2,3,6807.0,1:43,0,0,0,10607.0,2:40,3750000
8469619,Dennis,Seidenberg,1981-07-18,D,L,2010-11,81,7,25,32,0.4,3,166,4.22,41,114427.0,23:32,0,0,0,0.0,161,174,12,27,-15,1,10,11,10655.0,2:11,0,0,0,10903.0,2:14,3250000
8469622,Ryane,Clowe,1982-09-30,LW,L,2010-11,75,24,38,62,0.83,13,185,12.97,100,80825.0,17:57,17,24,41,41.46,153,22,43,54,-11,5,8,13,10135.0,2:15,0,0,0,244.0,0:3,3625000
8469623,Marek,Zidlicky,1977-02-03,D,R,2010-11,46,7,17,24,0.52,-6,53,13.21,30,60092.0,21:46,0,0,0,0.0,66,63,14,33,-19,3,6,9,9076.0,3:17,0,0,0,6046.0,2:11,4000000
8469626,Andrew,Alberts,1981-06-30,D,L,2010-11,42,1,6,7,0.17,0,21,4.76,41,38200.0,15:9,0,0,0,0.0,113,49,7,19,-12,0,0,0,257.0,0:6,0,0,0,3936.0,1:33,1050000
8469638,Jussi,Jokinen,1983-04-01,LW,L,2010-11,70,19,33,52,0.74,3,136,13.97,24,72343.0,17:13,169,151,320,52.81,45,38,39,38,1,8,10,18,14629.0,3:28,0,0,0,3545.0,0:50,1700000
8469639,Brooks,Laich,1983-06-23,C,L,2010-11,82,16,32,48,0.59,14,207,7.73,46,90633.0,18:25,269,255,524,51.34,113,54,38,32,6,4,9,13,14739.0,2:59,1,2,3,11320.0,2:18,2066667
8469647,Derek,Boogaard,1982-06-23,LW,L,2010-11,22,1,1,2,0.09,0,4,25.0,45,6005.0,4:32,0,0,0,0.0,27,3,0,1,-1,0,0,0,20.0,0:0,0,0,0,0.0,0:0,1625000
8469664,David,Moss,1981-12-28,RW,R,2010-11,58,17,13,30,0.52,9,127,13.39,18,47628.0,13:41,157,207,364,43.13,92,32,32,27,5,5,2,7,5128.0,1:28,0,0,0,5578.0,1:36,1300000
8469665,Johnny,Oduya,1981-10-01,D,L,2010-11,82,2,15,17,0.21,-15,90,2.22,22,101957.0,20:43,0,0,0,0.0,64,149,45,46,-1,0,4,4,4118.0,0:50,0,0,0,15086.0,3:3,3500000
8469670,Marek,Svatos,1982-06-17,RW,R,2010-11,28,4,4,8,0.29,0,50,8.0,10,19695.0,11:43,0,0,0,0.0,12,10,9,5,4,0,0,0,1709.0,1:1,0,0,0,24.0,0:0,800000
8469684,Milan,Jurcina,1983-06-07,D,R,2010-11,46,4,13,17,0.37,-4,76,5.26,30,49867.0,18:4,0,1,1,0.0,125,93,25,22,3,1,4,5,3250.0,1:10,1,1,2,6423.0,2:19,1000000
8469685,Andrew,Murray,1981-11-06,C,L,2010-11,29,4,4,8,0.28,2,48,8.33,4,19803.0,11:22,19,22,41,46.34,77,14,10,1,9,0,0,0,93.0,0:3,0,1,1,2295.0,1:19,625000
8469707,PA,Parenteau,1983-03-24,RW,R,2010-11,81,20,33,53,0.65,-8,161,12.42,46,88560.0,18:13,11,19,30,36.67,118,28,45,54,-9,9,11,20,16986.0,3:29,0,0,0,217.0,0:2,600000
8469759,Vernon,Fiddler,1980-05-09,C,L,2010-11,71,6,16,22,0.31,3,97,6.19,46,66218.0,15:32,660,564,1224,53.92,85,60,27,21,6,0,1,1,684.0,0:9,1,1,2,12336.0,2:53,1100000
8469760,Zbynek,Michalek,1982-12-23,D,R,2010-11,73,5,14,19,0.26,0,104,4.81,30,95653.0,21:50,0,0,0,0.0,56,149,13,38,-25,1,3,4,5228.0,1:11,0,0,0,16500.0,3:46,4000000
8469765,Marc-Andre,Bergeron,1980-10-13,D,L,2010-11,23,2,6,8,0.35,-10,37,5.41,8,19765.0,14:19,0,0,0,0.0,6,18,5,15,-10,0,3,3,4730.0,3:25,0,0,0,63.0,0:2,1000000
8469770,Dennis,Wideman,1983-03-20,D,R,2010-11,75,10,30,40,0.53,-19,160,6.25,39,107919.0,23:58,1,0,1,100.0,95,126,38,53,-15,9,13,22,18325.0,4:4,0,0,0,10902.0,2:25,3937500
8469812,Chad,LaRose,1982-03-27,RW,R,2010-11,82,16,15,31,0.38,-21,176,9.09,59,78765.0,16:0,11,22,33,33.33,196,23,39,18,21,2,1,3,2430.0,0:29,1,1,2,6992.0,1:25,1700000
8470018,Matt,Ellis,1981-08-31,LW,L,2010-11,14,0,0,0,0.0,-4,20,0.0,0,8437.0,10:2,28,30,58,48.28,8,7,4,1,3,0,0,0,122.0,0:8,0,0,0,140.0,0:10,625000
8470039,Tomas,Fleischmann,1984-05-16,LW,L,2010-11,45,12,19,31,0.69,2,98,12.24,18,44171.0,16:21,99,137,236,41.95,15,14,26,21,5,3,3,6,6714.0,2:29,0,0,0,611.0,0:13,2600000
8470041,Rick,Nash,1984-06-16,LW,L,2010-11,75,32,34,66,0.88,2,305,10.49,34,85170.0,18:55,7,17,24,29.17,91,19,47,24,23,6,8,14,16438.0,3:39,0,0,0,1281.0,0:17,7800000
8470047,Valtteri,Filppula,1984-03-20,C,L,2010-11,71,16,23,39,0.55,-1,115,13.91,22,71220.0,16:43,478,450,928,51.51,30,25,50,42,8,4,4,8,8643.0,2:1,0,0,0,2833.0,0:39,3000000
8470054,Keith,Ballard,1982-11-26,D,L,2010-11,65,2,5,7,0.11,10,53,3.77,53,62035.0,15:54,0,0,0,0.0,99,111,9,28,-19,0,0,0,834.0,0:12,0,0,0,6417.0,1:38,3300000
8470063,Adam,Burish,1983-01-06,RW,R,2010-11,63,8,6,14,0.22,2,89,8.99,91,54242.0,14:20,255,222,477,53.46,77,70,14,13,1,0,0,0,619.0,0:9,0,0,0,7439.0,1:58,1150000
8470065,Ryan,Craig,1982-01-06,C,L,2010-11,6,0,0,0,0.0,-3,7,0.0,22,3536.0,9:49,3,2,5,60.0,6,1,0,0,0,0,0,0,255.0,0:42,0,0,0,248.0,0:41,500000
8470072,Petr,Prucha,1982-09-14,RW,R,2010-11,11,0,1,1,0.09,0,10,0.0,4,7563.0,11:27,3,2,5,60.0,13,3,4,1,3,0,0,0,70.0,0:6,0,0,0,281.0,0:25,1200000
8470104,Tom,Gilbert,1983-01-10,D,R,2010-11,79,6,20,26,0.33,-14,106,5.66,32,116150.0,24:30,0,0,0,0.0,69,172,43,87,-44,3,7,10,14209.0,2:59,0,2,2,15900.0,3:21,4000000
8470105,Scottie,Upshall,1983-10-07,RW,L,2010-11,82,22,12,34,0.41,-7,191,11.52,52,69074.0,14:2,8,17,25,32.0,108,26,33,22,11,2,1,3,5593.0,1:8,0,0,0,1034.0,0:12,2250000
8470110,Trevor,Daley,1983-10-09,D,L,2010-11,82,8,19,27,0.33,7,131,6.11,34,110629.0,22:29,0,0,0,0.0,32,124,34,42,-8,2,3,5,9501.0,1:55,0,0,0,9136.0,1:51,2300000
8470120,Alexander,Semin,1984-03-03,RW,R,2010-11,65,28,26,54,0.83,22,196,14.29,71,70486.0,18:4,4,9,13,30.77,27,6,62,42,20,6,12,18,12525.0,3:12,1,0,1,3683.0,0:56,6000000
8470121,Matt,Greene,1983-05-13,D,R,2010-11,71,2,9,11,0.15,3,50,4.0,70,72319.0,16:58,0,0,0,0.0,243,105,8,38,-30,0,0,0,404.0,0:5,0,0,0,11051.0,2:35,2950000
8470123,Cam,Janssen,1984-04-15,RW,R,2010-11,54,1,3,4,0.07,-6,16,6.25,131,15807.0,4:52,0,0,0,0.0,95,7,3,2,1,0,0,0,66.0,0:1,0,0,0,0.0,0:0,600000
8470136,Nathan,Oystrick,1982-12-17,D,L,2010-11,9,1,2,3,0.33,1,11,9.09,9,6573.0,12:10,0,0,0,0.0,6,5,0,1,-1,1,0,1,692.0,1:16,0,0,0,0.0,0:0,563750
8470137,Joni,Pitkanen,1983-09-19,D,L,2010-11,72,5,30,35,0.49,-2,144,3.47,60,108104.0,25:1,0,0,0,0.0,66,130,32,32,0,1,11,12,17834.0,4:7,0,0,0,5010.0,1:9,4000000
8470144,Frans,Nielsen,1984-04-24,C,L,2010-11,71,13,31,44,0.62,13,156,8.33,38,75672.0,17:45,446,519,965,46.22,23,63,66,33,33,0,8,8,10719.0,2:30,7,1,8,12767.0,2:59,525000
8470151,Jay,Bouwmeester,1983-09-27,D,L,2010-11,82,4,20,24,0.29,-2,121,3.31,44,127856.0,25:59,0,0,0,0.0,72,134,23,57,-34,1,7,8,13658.0,2:46,0,0,0,16492.0,3:21,6680000
8470153,Pierre-Marc,Bouchard,1984-04-27,C,L,2010-11,59,12,26,38,0.64,-3,98,12.24,14,55626.0,15:42,17,26,43,39.53,15,10,26,20,6,0,10,10,9733.0,2:44,0,0,0,73.0,0:1,4080000
8470156,Joey,Crabb,1983-04-03,RW,R,2010-11,48,3,12,15,0.31,-1,51,5.88,24,37381.0,12:58,5,17,22,22.73,99,20,21,13,8,0,0,0,2405.0,0:50,1,0,1,2349.0,0:48,525000
8470159,Boyd,Gordon,1983-10-19,C,R,2010-11,60,3,6,9,0.15,-5,77,3.9,16,46970.0,13:2,417,302,719,58.0,33,50,14,10,4,0,0,0,266.0,0:4,1,0,1,8055.0,2:14,800000
8470162,Matt,Stajan,1983-12-19,C,L,2010-11,76,6,25,31,0.41,1,81,7.41,32,64877.0,14:13,436,409,845,51.6,66,24,52,39,13,0,1,1,4807.0,1:3,1,1,2,3283.0,0:43,3500000
8470169,Gregory,Campbell,1983-12-17,C,L,2010-11,80,13,16,29,0.36,11,98,13.27,93,64504.0,13:26,430,402,832,51.68,119,52,11,18,-7,1,1,2,1055.0,0:13,1,3,4,8299.0,1:43,1100000
8470171,Max,Talbot,1984-02-11,C,L,2010-11,82,8,13,21,0.26,-3,117,6.84,66,74134.0,15:4,425,449,874,48.63,154,40,26,17,9,0,0,0,562.0,0:6,2,1,3,14390.0,2:55,1050000
8470176,Sean,Bergenheim,1984-02-08,LW,L,2010-11,80,14,15,29,0.36,0,182,7.69,56,67097.0,13:58,25,26,51,49.02,109,37,45,24,21,2,2,4,5073.0,1:3,0,0,0,6755.0,1:24,700000
8470180,Eric,Nystrom,1983-02-14,LW,L,2010-11,82,4,8,12,0.15,-16,83,4.82,30,65478.0,13:18,45,86,131,34.35,169,31,19,17,2,1,0,1,1316.0,0:16,0,0,0,7474.0,1:31,1400000
8470187,Johnny,Boychuk,1984-01-19,D,R,2010-11,69,3,13,16,0.23,15,154,1.95,45,84884.0,20:30,0,0,0,0.0,117,115,14,21,-7,1,1,2,4220.0,1:1,0,0,0,9074.0,2:11,1875000
8470189,David,Van Der Gulik,1983-04-20,LW,L,2010-11,6,1,2,3,0.5,4,12,8.33,2,2431.0,6:45,0,1,1,0.0,10,3,2,2,0,0,0,0,37.0,0:6,0,0,0,230.0,0:38,500000
8470192,Steve,Eminger,1983-10-31,D,R,2010-11,65,2,4,6,0.09,-5,23,8.7,22,61821.0,15:51,0,0,0,0.0,143,103,18,16,2,0,1,1,1170.0,0:18,0,0,0,5218.0,1:20,1125000
8470201,Jiri,Hudler,1984-01-04,RW,L,2010-11,73,10,27,37,0.51,-7,105,9.52,28,59834.0,13:39,31,39,70,44.29,35,11,30,32,-2,3,9,12,9838.0,2:14,0,0,0,0.0,0:0,2875000
8470207,Joffrey,Lupul,1983-09-23,LW,R,2010-11,54,14,17,31,0.57,-11,129,10.85,33,50618.0,15:37,12,20,32,37.5,63,29,18,17,1,4,9,13,9305.0,2:52,0,0,0,10.0,0:0,4250000
8470222,James,Wisniewski,1984-02-21,D,R,2010-11,75,10,41,51,0.68,-14,158,6.33,38,103237.0,22:56,0,0,0,0.0,108,119,35,67,-32,7,22,29,20073.0,4:27,0,0,0,4525.0,1:0,3250000
8470230,Daniel,Paille,1984-04-15,LW,L,2010-11,43,6,7,13,0.3,3,48,12.5,28,29169.0,11:18,0,0,0,0.0,24,17,10,4,6,0,0,0,57.0,0:1,1,0,1,3254.0,1:15,1075000
8470257,Alexander,Steen,1984-03-01,LW,L,2010-11,72,20,31,51,0.71,-3,218,9.17,26,84462.0,19:33,41,65,106,38.68,39,28,29,25,4,1,9,10,13507.0,3:7,2,0,2,4124.0,0:57,3362500
8470265,Anton,Babchuk,1984-05-06,D,R,2010-11,82,11,24,35,0.43,14,132,8.33,32,80427.0,16:20,0,0,0,0.0,19,156,19,42,-23,6,7,13,12618.0,2:33,1,1,2,2526.0,0:30,1400000
8470273,Ian,White,1984-06-04,D,R,2010-11,78,4,22,26,0.33,3,138,2.9,26,93564.0,19:59,0,0,0,0.0,59,144,30,26,4,1,5,6,10151.0,2:10,0,0,0,5156.0,1:6,2999995
8470274,Chris,Higgins,1983-06-02,LW,L,2010-11,62,13,15,28,0.45,5,160,8.12,16,60632.0,16:17,41,44,85,48.24,80,36,40,12,28,1,0,1,5420.0,1:27,0,1,1,6540.0,1:45,1600000
8470280,Ben,Eager,1984-01-22,LW,L,2010-11,68,7,10,17,0.25,4,84,8.33,120,43409.0,10:38,0,2,2,0.0,87,28,21,26,-5,0,0,0,468.0,0:6,0,0,0,224.0,0:3,965000
8470281,Duncan,Keith,1983-07-16,D,L,2010-11,82,7,38,45,0.55,-1,173,4.05,22,132273.0,26:53,0,0,0,0.0,45,149,56,83,-27,3,19,22,14691.0,2:59,1,0,1,12965.0,2:38,5538462
8470283,Tim,Brent,1984-03-10,C,R,2010-11,79,8,12,20,0.25,-4,60,13.33,33,55227.0,11:39,410,378,788,52.03,104,58,23,20,3,0,4,4,3589.0,0:45,1,1,2,9331.0,1:58,575000
8470289,Jim,Slater,1982-12-09,C,L,2010-11,36,5,7,12,0.33,4,53,9.43,19,22859.0,10:34,185,116,301,61.46,59,16,16,5,11,0,0,0,294.0,0:8,0,0,0,1947.0,0:54,1000000
8470299,Erik,Christensen,1983-12-17,C,L,2010-11,63,11,16,27,0.43,3,86,12.79,18,48230.0,12:45,316,323,639,49.45,34,11,28,17,11,4,3,7,8031.0,2:7,0,0,0,32.0,0:0,925000
8470302,Patrick,Dwyer,1983-06-22,RW,R,2010-11,80,8,10,18,0.22,-6,104,7.69,12,60374.0,12:34,80,158,238,33.61,166,63,36,7,29,0,1,1,734.0,0:9,1,0,1,9841.0,2:3,500000
8470309,Ryan,Whitney,1983-02-19,D,L,2010-11,35,2,25,27,0.77,13,43,4.65,33,53210.0,25:20,0,0,0,0.0,29,67,20,41,-21,0,7,7,9069.0,4:19,0,2,2,5676.0,2:42,4000000
8470310,Aaron,Rome,1983-09-27,D,L,2010-11,56,1,4,5,0.09,1,50,2.0,53,58502.0,17:24,0,0,0,0.0,78,59,13,21,-8,0,2,2,1373.0,0:24,0,0,0,5996.0,1:47,750000
8470317,Nate,Guenin,1982-12-10,D,R,2010-11,3,0,0,0,0.0,-3,2,0.0,2,2663.0,14:47,0,0,0,0.0,11,7,1,0,1,0,0,0,83.0,0:27,0,0,0,122.0,0:40,575000
8470318,Jonathan,Ericsson,1984-03-02,D,L,2010-11,74,3,12,15,0.2,8,89,3.37,87,83653.0,18:50,0,0,0,0.0,107,37,16,56,-40,1,0,1,534.0,0:7,0,0,0,6330.0,1:25,900000
8470321,Patrick,Rissmiller,1978-10-26,LW,L,2010-11,10,0,1,1,0.1,-1,14,0.0,0,6219.0,10:21,2,2,4,50.0,17,2,2,0,2,0,0,0,85.0,0:8,0,0,0,75.0,0:7,1000000
8470324,Josh,Gorges,1984-08-14,D,L,2010-11,36,1,6,7,0.19,-3,20,5.0,18,45734.0,21:10,0,0,0,0.0,55,79,8,24,-16,1,0,1,1468.0,0:40,0,0,0,8140.0,3:46,1100000
8470329,Chris,Campoli,1984-07-09,D,L,2010-11,77,4,17,21,0.27,0,84,4.76,36,88412.0,19:8,0,0,0,0.0,99,91,19,32,-13,1,1,2,5834.0,1:15,0,0,0,7594.0,1:38,1400000
8470358,Alexandre,Burrows,1981-04-11,RW,L,2010-11,72,26,22,48,0.67,26,152,17.11,77,73577.0,17:1,6,8,14,42.86,84,24,39,15,24,1,0,1,4391.0,1:0,1,1,2,9767.0,2:15,2000000
8470378,Andre,Benoit,1984-01-06,D,L,2010-11,8,0,1,1,0.12,-1,17,0.0,6,8081.0,16:50,0,0,0,0.0,5,12,3,3,0,0,1,1,853.0,1:46,0,0,0,80.0,0:10,550000
8470543,Chris,Kunitz,1979-09-26,LW,L,2010-11,66,23,25,48,0.73,18,133,17.29,47,72388.0,18:16,4,4,8,50.0,155,14,18,22,-4,7,4,11,16561.0,4:10,1,1,2,2077.0,0:31,3725000
8470595,Eric,Staal,1984-10-29,C,L,2010-11,81,33,43,76,0.94,-10,296,11.15,72,106626.0,21:56,840,911,1751,47.97,81,31,64,44,20,12,17,29,21679.0,4:27,3,0,3,6817.0,1:24,8250000
8470596,Nathan,Horton,1985-05-29,RW,R,2010-11,80,26,27,53,0.66,29,188,13.83,85,78175.0,16:17,8,11,19,42.11,74,14,26,25,1,6,2,8,11542.0,2:24,0,0,0,157.0,0:1,4000000
8470597,Nikolay,Zherdev,1984-11-05,RW,R,2010-11,56,16,6,22,0.39,5,135,11.85,22,43201.0,12:51,2,5,7,28.57,39,6,19,25,-6,1,2,3,3533.0,1:3,0,0,0,49.0,0:0,2000000
8470598,Thomas,Vanek,1984-01-19,LW,R,2010-11,80,32,41,73,0.91,2,238,13.45,24,83297.0,17:21,8,18,26,30.77,30,12,43,45,-2,11,17,28,15662.0,3:15,0,0,0,305.0,0:3,7142857
8470599,Milan,Michalek,1984-12-07,LW,L,2010-11,66,18,15,33,0.5,-12,167,10.78,49,71520.0,18:3,4,9,13,30.77,49,41,40,22,18,1,3,4,9516.0,2:24,4,0,4,7386.0,1:51,4333333
8470600,Ryan,Suter,1985-01-21,D,L,2010-11,70,4,35,39,0.56,20,115,3.48,54,105846.0,25:12,0,1,1,0.0,64,84,33,37,-4,1,16,17,14419.0,3:25,0,1,1,8495.0,2:1,3500000
8470601,Braydon,Coburn,1985-02-27,D,L,2010-11,82,2,14,16,0.2,15,114,1.75,53,103660.0,21:4,0,0,0,0.0,177,133,32,51,-19,0,0,0,1930.0,0:23,0,1,1,12014.0,2:26,3200000
8470602,Dion,Phaneuf,1985-04-10,D,L,2010-11,66,8,22,30,0.45,-2,190,4.21,88,100201.0,25:18,0,0,0,0.0,186,121,31,53,-22,3,9,12,15544.0,3:55,0,1,1,7759.0,1:57,6500000
8470603,Andrei,Kostitsyn,1985-02-03,LW,L,2010-11,81,20,25,45,0.56,3,196,10.2,36,77218.0,15:53,0,2,2,0.0,140,26,23,38,-15,5,6,11,11056.0,2:16,0,0,0,51.0,0:0,3250000
8470604,Jeff,Carter,1985-01-01,C,R,2010-11,80,36,30,66,0.82,27,335,10.75,39,87584.0,18:14,331,274,605,54.71,65,41,40,29,11,8,9,17,14089.0,2:56,0,0,0,3158.0,0:39,5000000
8470605,Hugh,Jessiman,1984-03-28,RW,R,2010-11,2,0,0,0,0.0,-1,2,0.0,5,882.0,7:21,0,0,0,0.0,4,0,0,0,0,0,0,0,0.0,0:0,0,0,0,0.0,0:0,500000
8470606,Dustin,Brown,1984-11-04,RW,R,2010-11,82,28,29,57,0.7,17,228,12.28,67,95287.0,19:22,18,19,37,48.65,300,29,35,67,-32,7,8,15,14588.0,2:57,0,0,0,6725.0,1:22,3175000
8470607,Brent,Seabrook,1985-04-20,D,R,2010-11,82,9,39,48,0.59,0,135,6.67,47,119986.0,24:23,0,0,0,0.0,227,154,27,69,-42,5,15,20,13102.0,2:39,0,2,2,13457.0,2:44,3500000
8470609,Steve,Bernier,1985-03-31,RW,R,2010-11,68,5,10,15,0.22,-14,97,5.15,21,53167.0,13:1,4,13,17,23.53,112,35,22,14,8,3,0,3,5349.0,1:18,0,0,0,3753.0,0:55,2000000
8470610,Zach,Parise,1984-07-28,LW,L,2010-11,13,3,3,6,0.46,-1,49,6.12,6,15489.0,19:51,4,7,11,36.36,13,6,6,4,2,0,1,1,2713.0,3:28,0,0,0,700.0,0:53,3125000
8470611,Eric,Fehr,1985-09-07,C,R,2010-11,52,10,10,20,0.38,0,120,8.33,16,39279.0,12:35,0,1,1,0.0,34,20,23,7,16,3,4,7,6096.0,1:57,0,0,0,0.0,0:0,2200000
8470612,Ryan,Getzlaf,1985-05-10,C,R,2010-11,67,19,57,76,1.13,14,117,16.24,35,87849.0,21:51,542,641,1183,45.82,189,57,35,81,-46,7,20,27,14408.0,3:35,0,0,0,1880.0,0:28,5325000
8470613,Brent,Burns,1985-03-09,D,R,2010-11,80,17,29,46,0.57,-10,170,10.0,98,120227.0,25:2,1,1,2,50.0,133,106,47,80,-33,8,6,14,14730.0,3:4,0,1,1,13025.0,2:42,3550000
8470614,Mark,Stuart,1984-04-27,D,L,2010-11,54,2,4,6,0.11,0,41,4.88,47,50726.0,15:39,1,0,1,100.0,107,96,12,23,-11,0,0,0,386.0,0:7,0,0,0,6561.0,2:1,1675000
8470616,Ryan,Kesler,1984-08-31,C,R,2010-11,82,41,32,73,0.89,24,260,15.77,66,100833.0,20:29,859,637,1496,57.42,124,80,65,21,44,15,15,30,17849.0,3:37,3,1,4,12600.0,2:33,5000000
8470617,Mike,Richards,1985-02-11,C,L,2010-11,81,23,43,66,0.81,11,184,12.5,62,91764.0,18:52,606,610,1216,49.84,104,73,62,46,16,5,16,21,14316.0,2:56,3,3,6,10411.0,2:8,5750000
8470618,Anthony,Stewart,1985-01-05,RW,R,2010-11,80,14,25,39,0.49,-10,141,9.93,55,71870.0,14:58,7,11,18,38.89,98,35,34,28,6,5,5,10,6233.0,1:17,0,0,0,2220.0,0:27,632500
8470619,Brian,Boyle,1984-12-18,C,L,2010-11,82,21,14,35,0.43,2,218,9.63,74,77436.0,15:44,534,567,1101,48.5,240,86,33,20,13,4,0,4,3031.0,0:36,1,3,4,9554.0,1:56,525000
8470620,Jeff,Tambellini,1984-04-13,LW,L,2010-11,62,9,8,17,0.27,10,114,7.89,18,43834.0,11:47,19,16,35,54.29,113,21,11,10,1,1,3,4,4434.0,1:11,0,0,0,316.0,0:5,500000
8470621,Corey,Perry,1985-05-16,RW,R,2010-11,82,50,48,98,1.2,9,290,17.24,104,109780.0,22:18,9,13,22,40.91,64,41,55,54,1,14,17,31,17260.0,3:30,4,1,5,8095.0,1:38,5325000
8470622,Patrick,Eaves,1984-05-01,RW,R,2010-11,63,13,7,20,0.32,-2,108,12.04,14,47995.0,12:41,3,7,10,30.0,106,27,20,14,6,2,0,2,878.0,0:13,1,0,1,10176.0,2:41,1400000
8470623,Shawn,Belle,1985-01-03,D,L,2010-11,9,0,0,0,0.0,-1,8,0.0,2,9259.0,17:8,0,0,0,0.0,9,4,2,8,-6,0,0,0,95.0,0:10,0,0,0,804.0,1:29,600000
8470626,Loui,Eriksson,1985-07-17,LW,L,2010-11,79,27,46,73,0.92,10,179,15.08,8,97497.0,20:34,1,3,4,25.0,26,46,72,34,38,10,15,25,16059.0,3:23,1,2,3,6443.0,1:21,4250000
8470630,Kevin,Klein,1984-12-13,D,R,2010-11,81,2,16,18,0.22,9,99,2.02,24,101048.0,20:47,0,0,0,0.0,128,173,31,61,-30,0,0,0,1129.0,0:13,0,1,1,15396.0,3:10,1350000
8470634,Matt,Smaby,1984-10-14,D,L,2010-11,32,0,0,0,0.0,2,9,0.0,17,13421.0,6:59,0,0,0,0.0,45,18,0,6,-6,0,0,0,58.0,0:1,0,0,0,731.0,0:22,525000
8470638,Patrice,Bergeron,1985-07-24,C,R,2010-11,80,22,35,57,0.71,20,211,10.43,26,85865.0,17:53,815,624,1439,56.64,45,56,49,24,25,3,8,11,13065.0,2:43,2,1,3,9915.0,2:3,4750000
8470640,Matt,Carle,1984-09-25,D,L,2010-11,82,1,39,40,0.49,30,117,0.85,23,108198.0,21:59,0,0,0,0.0,51,157,33,59,-26,0,2,2,11321.0,2:18,0,0,0,6019.0,1:13,3437500
8470642,Shea,Weber,1985-08-14,D,R,2010-11,82,16,32,48,0.59,7,254,6.3,56,124569.0,25:19,0,0,0,0.0,211,113,62,51,11,6,11,17,17957.0,3:38,1,0,1,10375.0,2:6,4500000
8470647,B.J.,Crombeen,1985-07-10,RW,R,2010-11,80,7,7,14,0.18,-18,113,6.19,154,61428.0,12:47,19,45,64,29.69,93,15,16,12,4,0,0,0,260.0,0:3,1,0,1,8100.0,1:41,872500
8470648,Stefan,Meyer,1985-07-20,LW,L,2010-11,16,0,2,2,0.12,0,12,0.0,17,7441.0,7:45,7,10,17,41.18,24,10,2,0,2,0,0,0,36.0,0:2,0,0,0,503.0,0:31,512500
8470649,Patrick,O'Sullivan,1985-02-01,C,L,2010-11,31,2,6,8,0.26,-2,50,4.0,4,22668.0,12:11,20,31,51,39.22,15,4,15,7,8,0,3,3,3202.0,1:43,0,0,0,0.0,0:0,2925000
8470651,Jeremy,Colliton,1985-01-13,C,R,2010-11,15,2,1,3,0.2,-7,7,28.57,10,10699.0,11:53,52,32,84,61.9,23,9,11,4,7,2,0,2,417.0,0:27,0,0,0,1120.0,1:14,500000
8470654,Maxim,Lapierre,1985-03-29,C,R,2010-11,78,6,6,12,0.15,-14,129,4.65,80,54413.0,11:37,173,167,340,50.88,194,23,20,8,12,0,0,0,332.0,0:4,0,0,0,3728.0,0:47,900000
8470655,David,Backes,1984-05-01,RW,R,2010-11,82,31,31,62,0.76,32,211,14.69,93,96953.0,19:42,506,632,1138,44.46,213,40,47,23,24,5,10,15,13260.0,2:41,0,1,1,8637.0,1:45,2500000
8470656,David,Liffiton,1984-10-18,D,L,2010-11,4,1,0,1,0.25,3,2,50.0,17,1790.0,7:27,0,0,0,0.0,3,3,1,0,1,0,0,0,0.0,0:0,0,0,0,0.0,0:0,500000
8470661,Jean-Francois,Jacques,1985-04-29,LW,L,2010-11,51,4,1,5,0.1,-6,28,14.29,63,21641.0,7:4,5,11,16,31.25,111,17,6,11,-5,0,0,0,185.0,0:3,0,0,0,136.0,0:2,615000
8470662,Colin,Fraser,1985-01-28,C,L,2010-11,67,3,2,5,0.07,-2,57,5.26,60,41309.0,10:16,246,306,552,44.57,79,54,27,20,7,0,0,0,318.0,0:4,1,0,1,10655.0,2:39,825000
8470666,Daniel,Carcillo,1985-01-28,LW,L,2010-11,57,4,2,6,0.11,-14,56,7.14,127,26553.0,7:45,1,1,2,50.0,80,14,7,6,1,0,0,0,172.0,0:3,0,0,0,49.0,0:0,1075000
8470667,Clarke,MacArthur,1985-04-06,LW,L,2010-11,82,21,41,62,0.76,-3,154,13.64,37,84204.0,17:6,9,7,16,56.25,115,20,24,49,-25,6,13,19,14357.0,2:55,0,0,0,73.0,0:0,1100000
8470672,Ryan,O'Byrne,1984-07-19,D,R,2010-11,67,0,10,10,0.15,-7,45,0.0,75,81031.0,20:9,0,0,0,0.0,179,131,21,25,-4,0,0,0,434.0,0:6,0,0,0,10676.0,2:39,941667
8470678,Alexandre,Picard,1985-07-05,D,L,2010-11,43,3,5,8,0.19,0,49,6.12,17,42381.0,16:25,0,0,0,0.0,55,59,9,28,-19,2,0,2,2652.0,1:1,0,0,0,1491.0,0:34,600000
8470687,Zack,Stortini,1985-09-11,RW,R,2010-11,32,0,4,4,0.12,-2,16,0.0,76,13619.0,7:5,14,19,33,42.42,46,8,4,5,-1,0,0,0,119.0,0:3,0,0,0,0.0,0:0,700000
8470699,Jan,Hejda,1978-06-18,D,L,2010-11,77,5,15,20,0.26,-6,79,6.33,28,97584.0,21:7,1,0,1,100.0,152,158,21,30,-9,0,0,0,691.0,0:8,0,1,1,13143.0,2:50,2000000
8470713,Paul,Bissonnette,1985-03-11,LW,L,2010-11,48,1,0,1,0.02,6,18,5.56,71,15134.0,5:15,2,1,3,66.67,122,5,2,4,-2,0,0,0,55.0,0:1,0,0,0,10.0,0:0,612500
8470714,Corey,Potter,1984-01-05,D,R,2010-11,1,0,0,0,0.0,0,1,0.0,0,1003.0,16:43,0,0,0,0.0,1,2,0,0,0,0,0,0,0.0,0:0,0,0,0,38.0,0:38,500000
8470719,Alexandre,Bolduc,1985-06-26,C,L,2010-11,24,2,2,4,0.17,1,21,9.52,21,10705.0,7:26,44,53,97,45.36,29,14,4,2,2,0,0,0,211.0,0:8,0,0,0,671.0,0:27,500000
8470724,Kyle,Quincey,1985-08-12,D,L,2010-11,21,0,1,1,0.05,-5,39,0.0,18,24673.0,19:34,0,0,0,0.0,28,26,6,7,-1,0,0,0,2769.0,2:11,0,0,0,2457.0,1:57,3125000
8470729,Tyson,Strachan,1984-10-30,D,R,2010-11,29,0,1,1,0.03,-10,28,0.0,39,21124.0,12:8,0,0,0,0.0,23,30,3,8,-5,0,0,0,306.0,0:10,0,0,0,1398.0,0:48,600000
8470740,Lee,Stempniak,1983-02-04,RW,R,2010-11,82,19,19,38,0.46,4,199,9.55,19,75047.0,15:15,18,27,45,40.0,124,21,46,26,20,2,4,6,8957.0,1:49,0,0,0,156.0,0:1,1900000
8470741,Nigel,Dawes,1985-02-09,LW,L,2010-11,13,0,1,1,0.08,-6,12,0.0,0,7657.0,9:49,0,0,0,0.0,19,3,6,3,3,0,0,0,215.0,0:16,0,0,0,17.0,0:1,650000
8470750,John,Mitchell,1985-01-22,C,L,2010-11,23,2,1,3,0.13,-7,28,7.14,12,17268.0,12:30,83,66,149,55.7,31,17,8,5,3,1,0,1,511.0,0:22,0,0,0,1287.0,0:55,725000
8470755,Brad,Richardson,1985-02-04,C,L,2010-11,68,7,12,19,0.28,-13,103,6.8,47,47978.0,11:45,92,89,181,50.83,84,11,28,18,10,0,0,0,237.0,0:3,1,0,1,3908.0,0:57,900000
8470760,Marc,Methot,1985-06-21,D,L,2010-11,74,0,15,15,0.2,2,58,0.0,58,88308.0,19:53,0,0,0,0.0,176,98,21,27,-6,0,0,0,1496.0,0:20,0,1,1,13081.0,2:56,1012500
8470774,Bruno,Gervais,1984-10-03,D,R,2010-11,53,0,6,6,0.11,-14,43,0.0,30,49848.0,15:40,0,0,0,0.0,40,79,28,19,9,0,0,0,812.0,0:15,0,0,0,4554.0,1:25,740833
8470775,Nate,Thompson,1984-10-05,C,L,2010-11,79,10,15,25,0.32,-6,123,8.13,29,71528.0,15:5,360,304,664,54.22,115,81,35,14,21,0,1,1,1002.0,0:12,1,0,1,12877.0,2:43,625000
8470778,Drew,Miller,1984-02-17,LW,L,2010-11,67,10,8,18,0.27,-2,85,11.76,13,47220.0,11:44,4,13,17,23.53,84,58,12,7,5,0,0,0,311.0,0:4,1,0,1,8952.0,2:13,650000
8470787,Drew,Bagnall,1983-10-26,D,L,2010-11,2,0,0,0,0.0,-2,1,0.0,4,1561.0,13:0,0,0,0,0.0,0,1,0,0,0,0,0,0,0.0,0:0,0,0,0,96.0,0:48,600000
8470794,Joe,Pavelski,1984-07-11,C,R,2010-11,74,20,46,66,0.89,10,282,7.09,24,87262.0,19:39,554,466,1020,54.31,61,67,51,49,2,11,17,28,14914.0,3:21,1,2,3,8665.0,1:57,4000000
8470798,Dylan,Reese,1984-08-29,D,R,2010-11,27,0,6,6,0.22,-12,23,0.0,15,24002.0,14:48,0,0,0,0.0,17,22,11,15,-4,0,0,0,503.0,0:18,0,0,0,2041.0,1:15,577500
8470803,Kyle,Brodziak,1984-05-25,C,R,2010-11,80,16,21,37,0.46,-4,126,12.7,56,75725.0,15:46,532,556,1088,48.9,52,55,48,30,18,2,2,4,6085.0,1:16,1,3,4,8184.0,1:42,1150000
8470816,Jay,Rosehill,1985-07-16,LW,L,2010-11,26,1,2,3,0.12,-6,12,8.33,71,8123.0,5:12,0,0,0,0.0,36,4,3,4,-1,0,0,0,26.0,0:1,0,0,0,0.0,0:0,512500
8470828,Toby,Enstrom,1984-11-05,D,L,2010-11,72,10,41,51,0.71,-10,113,8.85,54,102322.0,23:41,0,0,0,0.0,30,137,26,29,-3,6,22,28,19649.0,4:32,0,1,1,3372.0,0:46,3750000
8470834,Dustin,Byfuglien,1985-03-27,D,R,2010-11,81,20,33,53,0.65,-2,347,5.76,93,113260.0,23:18,0,0,0,0.0,140,72,85,59,26,8,16,24,19611.0,4:2,0,0,0,469.0,0:5,3000000
8470839,Shane,O'Brien,1983-08-09,D,L,2010-11,80,2,7,9,0.11,1,50,4.0,83,82159.0,17:6,0,0,0,0.0,164,80,30,50,-20,0,0,0,367.0,0:4,0,0,0,13611.0,2:50,1600000
8470852,Matt,Moulson,1983-11-01,LW,L,2010-11,82,31,22,53,0.65,-10,237,13.08,24,92838.0,18:52,5,4,9,55.56,84,48,46,22,24,9,6,15,16562.0,3:21,0,0,0,2874.0,0:35,2450000
8470854,Tanner,Glass,1983-11-29,LW,L,2010-11,73,3,7,10,0.14,-5,45,6.67,72,39092.0,8:55,25,37,62,40.32,130,29,9,10,-1,0,0,0,378.0,0:5,0,0,0,4572.0,1:2,625000
8470867,Troy,Bodie,1985-01-25,RW,R,2010-11,59,1,3,4,0.07,-7,44,2.27,61,24186.0,6:49,0,1,1,0.0,86,13,12,5,7,0,0,0,53.0,0:0,0,0,0,1472.0,0:24,500000
8470871,Chris,Porter,1984-05-29,LW,L,2010-11,45,3,4,7,0.16,-4,55,5.45,16,28039.0,10:23,12,10,22,54.55,91,5,10,5,5,0,0,0,82.0,0:1,0,0,0,1122.0,0:24,562500
8470877,David,Jones,1984-08-10,RW,R,2010-11,77,27,18,45,0.58,-2,153,17.65,28,81664.0,17:40,10,11,21,47.62,93,38,24,28,-4,6,3,9,11063.0,2:23,0,1,1,6726.0,1:27,837500
8470886,Clayton,Stoner,1985-02-19,D,L,2010-11,57,2,7,9,0.16,5,40,5.0,96,57672.0,16:51,0,0,0,0.0,110,81,23,24,-1,0,0,0,157.0,0:2,0,0,0,7197.0,2:6,550000
8470920,David,Clarkson,1984-03-31,RW,R,2010-11,82,12,6,18,0.22,-20,192,6.25,116,67018.0,13:37,19,26,45,42.22,170,19,24,23,1,1,1,2,8188.0,1:39,0,0,0,54.0,0:0,2666667
8470966,Mark,Giordano,1983-10-03,D,L,2010-11,82,8,35,43,0.52,-8,165,4.85,67,113853.0,23:8,0,0,0,0.0,140,193,25,42,-17,5,20,25,17401.0,3:32,0,0,0,10371.0,2:6,891667
8471185,Curtis,Glencross,1982-12-28,LW,L,2010-11,79,24,19,43,0.54,6,149,16.11,59,77002.0,16:14,57,84,141,40.43,105,54,47,55,-8,3,2,5,5568.0,1:10,2,1,3,11349.0,2:23,1200000
8471187,Brett,Lebda,1982-01-15,D,L,2010-11,41,1,3,4,0.1,-14,34,2.94,14,32812.0,13:20,0,2,2,0.0,33,31,3,17,-14,0,1,1,4977.0,2:1,0,0,0,281.0,0:6,1450000
8471208,Dustin,Penner,1982-09-28,RW,L,2010-11,81,23,22,45,0.56,-12,173,13.29,47,88079.0,18:7,131,175,306,42.81,90,30,45,69,-24,6,2,8,14997.0,3:5,1,0,1,5557.0,1:8,4250000
8471214,Alex,Ovechkin,1985-09-17,LW,R,2010-11,79,32,53,85,1.08,24,367,8.72,41,101275.0,21:21,6,12,18,33.33,241,23,48,59,-11,7,17,24,21240.0,4:28,0,0,0,217.0,0:2,9538462
8471215,Evgeni,Malkin,1986-07-31,C,L,2010-11,43,15,22,37,0.86,-4,182,8.24,18,51148.0,19:49,77,123,200,38.5,32,11,29,40,-11,5,9,14,13766.0,5:20,0,0,0,161.0,0:3,8700000
8471216,Cam,Barker,1986-04-04,D,L,2010-11,52,1,4,5,0.1,-10,44,2.27,34,51175.0,16:24,0,0,0,0.0,68,61,6,5,1,0,2,2,4297.0,1:22,0,0,0,2632.0,0:50,3083333
8471217,Andrew,Ladd,1985-12-12,LW,L,2010-11,81,29,30,59,0.73,-10,195,14.87,39,97550.0,20:4,15,29,44,34.09,68,45,61,44,17,9,9,18,14802.0,3:2,2,1,3,9158.0,1:53,2350000
8471218,Blake,Wheeler,1986-08-31,RW,R,2010-11,81,18,26,44,0.54,10,179,10.06,46,78962.0,16:14,52,96,148,35.14,74,47,40,29,11,0,5,5,6464.0,1:19,0,0,0,6543.0,1:20,2200000
8471220,Rostislav,Olesz,1985-10-10,LW,L,2010-11,44,6,11,17,0.39,-1,71,8.45,8,36640.0,13:52,2,8,10,20.0,68,19,19,9,10,1,0,1,2960.0,1:7,0,0,0,2476.0,0:56,3125000
8471222,Ladislav,Smid,1986-02-01,D,L,2010-11,78,0,10,10,0.13,-10,48,0.0,85,94892.0,20:16,0,0,0,0.0,145,118,19,59,-40,0,1,1,3556.0,0:45,0,0,0,12505.0,2:40,1300000
8471226,Drew,Stafford,1985-10-30,RW,R,2010-11,62,31,21,52,0.84,13,179,17.32,34,61521.0,16:32,17,39,56,30.36,53,5,19,17,2,11,8,19,10996.0,2:57,0,0,0,1283.0,0:20,1900000
8471231,Kyle,Chipchura,1986-02-19,C,L,2010-11,40,0,2,2,0.05,1,23,0.0,32,19185.0,7:59,132,151,283,46.64,30,10,8,5,3,0,0,0,41.0,0:1,0,0,0,2048.0,0:51,650000
8471232,Lauri,Korpikoski,1986-07-28,LW,L,2010-11,79,19,21,40,0.51,17,103,18.45,20,73604.0,15:31,107,137,244,43.85,87,50,25,26,-1,0,1,1,3248.0,0:41,2,2,4,14361.0,3:1,700000
8471233,Travis,Zajac,1985-05-13,C,R,2010-11,82,13,31,44,0.54,-6,173,7.51,24,97332.0,19:46,707,571,1278,55.32,55,31,60,34,26,2,8,10,12660.0,2:34,1,1,2,10292.0,2:5,3887500
8471234,Wojtek,Wolski,1986-02-24,LW,L,2010-11,73,12,23,35,0.48,6,135,8.89,18,63863.0,14:34,15,16,31,48.39,47,12,21,26,-5,1,3,4,9166.0,2:5,0,0,0,24.0,0:0,3800000
8471236,Andrej,Meszaros,1985-10-13,D,L,2010-11,81,8,24,32,0.4,30,144,5.56,42,102647.0,21:7,0,0,0,0.0,189,139,34,40,-6,3,3,6,11840.0,2:26,0,0,0,9928.0,2:2,4000000
8471238,Rob,Schremp,1986-07-01,C,L,2010-11,63,13,13,26,0.41,-20,83,15.66,16,53075.0,14:2,224,262,486,46.09,34,21,42,41,1,4,3,7,6717.0,1:46,0,0,0,40.0,0:0,750750
8471240,Jeff,Schultz,1986-02-25,D,L,2010-11,72,1,9,10,0.14,6,34,2.94,12,85439.0,19:46,0,0,0,0.0,53,138,17,43,-26,0,0,0,285.0,0:3,0,2,2,10574.0,2:26,2750000
8471241,Mark,Fistric,1986-06-01,D,L,2010-11,57,2,3,5,0.09,-10,26,7.69,44,49191.0,14:23,0,0,0,0.0,173,78,11,14,-3,0,0,0,35.0,0:0,0,1,1,4592.0,1:20,1000000
8471242,Mike,Green,1985-10-12,D,R,2010-11,49,8,16,24,0.49,6,115,6.96,48,74067.0,25:11,0,0,0,0.0,100,109,25,54,-29,5,5,10,13076.0,4:26,0,1,1,6937.0,2:21,5250000
8471245,Dave,Bolland,1986-06-05,C,R,2010-11,61,15,22,37,0.61,11,102,14.71,34,64572.0,17:38,455,553,1008,45.14,41,35,55,22,33,4,8,12,7418.0,2:1,0,0,0,7947.0,2:10,3375000
8471254,Bryan,Bickell,1986-03-09,LW,L,2010-11,78,17,20,37,0.47,6,130,13.08,40,64762.0,13:50,3,9,12,25.0,178,13,34,7,27,2,1,3,4308.0,0:55,0,0,0,10.0,0:0,541667
8471260,Blake,Comeau,1986-02-18,LW,R,2010-11,77,24,22,46,0.6,-17,182,13.19,43,86354.0,18:41,35,77,112,31.25,120,32,55,55,0,5,7,12,11585.0,2:30,1,0,1,10459.0,2:15,650000
8471265,Raymond,Sawada,1985-02-19,RW,R,2010-11,1,0,0,0,0.0,-1,1,0.0,0,350.0,5:50,0,0,0,0.0,2,0,0,1,-1,0,0,0,0.0,0:0,0,0,0,0.0,0:0,575000
8471266,David,Booth,1984-11-24,LW,L,2010-11,82,23,17,40,0.49,-31,280,8.21,26,92985.0,18:53,24,24,48,50.0,129,25,28,24,4,8,2,10,14119.0,2:52,0,0,0,720.0,0:8,4250000
8471268,Victor,Oreskovich,1986-08-15,RW,R,2010-11,16,0,3,3,0.19,1,19,0.0,8,7586.0,7:54,1,1,2,50.0,28,7,3,3,0,0,0,0,51.0,0:3,0,0,0,0.0,0:0,575000
8471269,Nicklas,Grossmann,1985-01-22,D,L,2010-11,59,1,9,10,0.17,7,38,2.63,35,64420.0,18:11,0,0,0,0.0,161,78,8,26,-18,0,0,0,474.0,0:8,0,0,0,8243.0,2:19,1625000
8471273,Brandon,Dubinsky,1986-04-29,C,L,2010-11,77,24,30,54,0.7,-3,202,11.88,100,93448.0,20:13,459,416,875,52.46,141,31,48,18,30,4,7,11,14244.0,3:4,2,2,4,9695.0,2:5,1850000
8471274,Alex,Goligoski,1985-07-30,D,L,2010-11,83,14,32,46,0.55,20,162,8.64,40,110733.0,22:14,0,0,0,0.0,75,106,14,56,-42,7,17,24,19963.0,4:0,0,0,0,6662.0,1:20,1833333
8471276,David,Krejci,1986-04-28,C,R,2010-11,75,13,49,62,0.83,23,157,8.28,28,84854.0,18:51,560,589,1149,48.74,56,40,33,28,5,1,11,12,12138.0,2:41,0,0,0,5522.0,1:13,3750000
8471279,Sami,Lepisto,1984-10-17,D,L,2010-11,70,4,12,16,0.23,10,56,7.14,55,73733.0,17:33,1,0,1,100.0,72,90,20,24,-4,0,0,0,2227.0,0:31,0,0,0,6842.0,1:37,800000
8471283,Brandon,Prust,1984-03-16,LW,L,2010-11,82,13,16,29,0.35,2,87,14.94,160,67965.0,13:48,4,5,9,44.44,161,36,26,29,-3,0,1,1,1440.0,0:17,5,2,7,8324.0,1:41,800000
8471284,Andrej,Sekera,1986-06-08,D,L,2010-11,76,3,26,29,0.38,11,88,3.41,34,96180.0,21:5,0,0,0,0.0,61,85,38,51,-13,0,6,6,9503.0,2:5,0,0,0,8315.0,1:49,1000000
8471299,Peter,Regin,1986-04-16,C,L,2010-11,55,3,14,17,0.31,-4,87,3.45,12,44170.0,13:23,132,184,316,41.77,30,20,40,15,25,0,2,2,3370.0,1:1,0,0,0,193.0,0:3,1000000
8471303,Alexander,Edler,1986-04-21,D,L,2010-11,51,8,25,33,0.65,13,121,6.61,24,74331.0,24:17,0,2,2,0.0,83,86,25,24,1,5,12,17,11576.0,3:46,0,0,0,6801.0,2:13,3250000
8471309,Johan,Franzen,1979-12-23,RW,L,2010-11,76,28,27,55,0.72,5,248,11.29,58,79498.0,17:26,74,73,147,50.34,143,29,36,35,1,10,7,17,12866.0,2:49,0,0,0,245.0,0:3,3954545
8471310,Dustin,Boyd,1986-07-16,C,L,2010-11,10,1,0,1,0.1,-6,8,12.5,2,5903.0,9:50,23,32,55,41.82,12,6,0,2,-2,0,0,0,0.0,0:0,0,0,0,657.0,1:5,650000
8471311,Tyler,Kennedy,1986-07-15,C,R,2010-11,80,21,24,45,0.56,1,234,8.97,37,69737.0,14:31,27,33,60,45.0,95,23,25,20,5,7,7,14,9015.0,1:52,0,0,0,180.0,0:2,725000
8471314,Mike,Lundin,1984-09-24,D,L,2010-11,69,1,11,12,0.17,-3,55,1.82,12,84472.0,20:24,0,0,0,0.0,25,108,17,18,-1,0,0,0,2000.0,0:28,0,0,0,10711.0,2:35,750000
8471321,Brett,Carson,1985-11-29,D,R,2010-11,19,0,0,0,0.0,9,12,0.0,4,13045.0,11:26,0,0,0,0.0,19,11,1,2,-1,0,0,0,298.0,0:15,0,0,0,692.0,0:36,500000
8471323,Ryan,Jones,1984-06-14,LW,L,2010-11,81,18,7,25,0.31,-5,126,14.29,34,67248.0,13:50,10,19,29,34.48,152,57,38,33,5,2,2,4,4072.0,0:50,1,0,1,10303.0,2:7,975000
8471331,Kevin,Porter,1986-03-12,C,L,2010-11,74,14,11,25,0.34,-11,102,13.73,27,61351.0,13:49,19,39,58,32.76,126,29,22,27,-5,1,1,2,7237.0,1:37,0,0,0,1314.0,0:17,660000
8471338,Torrey,Mitchell,1985-01-30,C,R,2010-11,66,9,14,23,0.35,10,116,7.76,46,52852.0,13:20,99,104,203,48.77,57,27,32,25,7,0,0,0,574.0,0:8,0,0,0,4249.0,1:4,1366667
8471339,Ryan,Callahan,1985-03-21,RW,R,2010-11,60,23,25,48,0.8,-7,179,12.85,46,71641.0,19:54,2,15,17,11.76,224,77,42,12,30,10,5,15,12202.0,3:23,0,2,2,8026.0,2:13,2300000
8471346,Kris,Versteeg,1986-05-13,RW,R,2010-11,80,21,25,46,0.57,-9,180,11.67,53,85104.0,17:43,63,67,130,48.46,45,56,53,35,18,6,8,14,13785.0,2:52,1,0,1,3435.0,0:42,3083333
8471348,Nikita,Nikitin,1986-06-16,D,L,2010-11,41,1,8,9,0.22,1,46,2.17,10,40325.0,16:23,0,0,0,0.0,40,52,4,12,-8,0,4,4,3160.0,1:17,0,0,0,3937.0,1:36,800000
8471362,Mikhail,Grabovski,1984-01-31,C,L,2010-11,81,29,29,58,0.72,14,239,12.13,60,94098.0,19:21,642,684,1326,48.42,44,25,49,45,4,10,5,15,15277.0,3:8,0,0,0,4868.0,1:0,2900000
8471371,Mike,Brown,1985-06-24,RW,R,2010-11,50,3,5,8,0.16,1,59,5.08,69,30282.0,10:5,4,11,15,26.67,105,27,11,15,-4,1,0,1,320.0,0:6,0,1,1,4753.0,1:35,537500
8471385,Adam,Pardy,1984-03-29,D,L,2010-11,30,1,6,7,0.23,3,36,2.78,24,26437.0,14:41,0,0,0,0.0,42,44,8,16,-8,0,1,1,413.0,0:13,0,0,0,1105.0,0:36,700000
8471388,Patrick,Kaleta,1986-06-08,RW,R,2010-11,51,4,5,9,0.18,-4,65,6.15,78,31171.0,10:11,5,7,12,41.67,126,33,11,9,2,0,0,0,351.0,0:6,1,0,1,1943.0,0:38,907500
8471390,Mike,Santorelli,1985-12-14,C,R,2010-11,82,20,21,41,0.5,-17,193,10.36,20,82092.0,16:41,518,514,1032,50.19,60,22,32,16,16,5,7,12,13273.0,2:41,1,0,1,6787.0,1:22,600000
8471392,Roman,Polak,1986-04-28,D,R,2010-11,55,3,9,12,0.22,-4,54,5.56,33,65857.0,19:57,0,1,1,0.0,110,78,11,12,-1,0,0,0,308.0,0:5,0,0,0,7312.0,2:12,1100000
8471409,Andrew,Gordon,1985-12-13,RW,R,2010-11,9,1,1,2,0.22,-2,5,20.0,0,4682.0,8:40,0,0,0,0.0,5,4,0,2,-2,0,0,0,395.0,0:43,0,0,0,0.0,0:0,500000
8471426,Troy,Brouwer,1985-08-17,RW,R,2010-11,79,17,19,36,0.46,-2,122,13.93,38,71606.0,15:6,12,13,25,48.0,262,36,24,20,4,7,6,13,10014.0,2:6,0,0,0,2890.0,0:36,1025000
8471436,Matt,Hunwick,1985-05-21,D,L,2010-11,73,1,12,13,0.18,-15,100,1.0,25,81084.0,18:30,0,0,0,0.0,65,71,26,36,-10,0,3,3,7715.0,1:45,0,0,0,7682.0,1:45,1450000
8471474,Travis,Morin,1984-01-09,C,L,2010-11,3,0,0,0,0.0,0,2,0.0,0,1596.0,8:52,8,6,14,57.14,1,2,0,0,0,0,0,0,5.0,0:1,0,0,0,0.0,0:0,500000
8471476,Daniel,Winnik,1985-03-06,LW,L,2010-11,80,11,15,26,0.32,-2,167,6.59,35,79431.0,16:32,25,44,69,36.23,54,52,49,19,30,2,3,5,1630.0,0:20,2,1,3,13131.0,2:44,950000
8471482,Grant,Clitsome,1985-04-14,D,L,2010-11,31,4,15,19,0.61,2,50,8.0,16,39560.0,21:16,0,0,0,0.0,67,29,6,13,-7,2,8,10,6537.0,3:30,0,0,0,3054.0,1:38,550000
8471483,Kyle,Wilson,1984-12-15,C,R,2010-11,32,4,7,11,0.34,-3,38,10.53,12,20420.0,10:38,63,70,133,47.37,21,8,10,8,2,0,0,0,1358.0,0:42,0,0,0,1476.0,0:46,600000
8471490,Adam,Cracknell,1985-07-15,RW,R,2010-11,24,3,4,7,0.29,1,26,11.54,8,12850.0,8:55,46,72,118,38.98,29,7,8,1,7,0,0,0,49.0,0:2,0,0,0,325.0,0:13,500000
8471498,Jannik,Hansen,1986-03-15,RW,R,2010-11,82,9,20,29,0.35,13,113,7.96,32,72382.0,14:42,8,11,19,42.11,149,26,42,16,26,0,0,0,579.0,0:7,0,1,1,11852.0,2:24,825000
8471504,Rene,Bourque,1981-12-10,RW,L,2010-11,80,27,23,50,0.62,-17,218,12.39,42,85217.0,17:45,7,17,24,29.17,90,26,35,48,-13,6,9,15,14431.0,3:0,1,2,3,5150.0,1:4,3333333
8471514,Rich,Peverley,1982-07-08,C,R,2010-11,82,18,23,41,0.5,-17,201,8.96,37,89817.0,18:15,657,519,1176,55.87,32,44,63,23,40,6,6,12,12643.0,2:34,2,1,3,8120.0,1:39,1325000
8471521,Brad,Staubitz,1984-07-28,RW,R,2010-11,71,4,5,9,0.13,-5,29,13.79,173,27757.0,6:30,0,4,4,0.0,133,18,6,7,-1,0,0,0,177.0,0:2,0,0,0,36.0,0:0,575000
8471636,Tim,Sestito,1984-08-28,LW,L,2010-11,36,0,2,2,0.06,-5,22,0.0,9,23372.0,10:49,116,137,253,45.85,79,14,8,11,-3,0,0,0,375.0,0:10,0,0,0,1622.0,0:45,500000
8471657,Cody,McLeod,1984-06-26,LW,L,2010-11,71,5,3,8,0.11,-7,73,6.85,189,41663.0,9:46,3,5,8,37.5,147,20,7,3,4,2,0,2,739.0,0:10,0,0,0,2119.0,0:29,1033333
8471663,Mike,Blunden,1986-12-15,RW,R,2010-11,1,0,0,0,0.0,-1,2,0.0,0,631.0,10:31,5,5,10,50.0,6,0,0,0,0,0,0,0,0.0,0:0,0,0,0,0.0,0:0,590000
8471664,Mason,Raymond,1985-09-17,LW,L,2010-11,70,15,24,39,0.56,8,197,7.61,10,66356.0,15:47,26,39,65,40.0,38,14,35,14,21,2,4,6,5742.0,1:22,1,0,1,4497.0,1:4,2550000
8471669,Paul,Stastny,1985-12-27,C,L,2010-11,74,22,35,57,0.77,-7,181,12.15,56,87629.0,19:44,810,714,1524,53.15,74,31,52,22,30,4,15,19,13579.0,3:3,1,0,1,4593.0,1:2,6600000
8471670,Guillaume,Latendresse,1987-05-24,LW,L,2010-11,11,3,3,6,0.55,2,18,16.67,8,8388.0,12:42,0,6,6,0.0,18,2,2,4,-2,1,1,2,1122.0,1:42,0,0,0,7.0,0:0,2500000
8471675,Sidney,Crosby,1987-08-07,C,L,2010-11,41,32,34,66,1.61,20,161,19.88,31,53917.0,21:55,546,435,981,55.66,31,23,15,29,-14,10,9,19,13348.0,5:25,1,0,1,1161.0,0:28,8700000
8471676,Bobby,Ryan,1987-03-17,RW,R,2010-11,82,34,37,71,0.87,15,270,12.59,61,99284.0,20:10,87,132,219,39.73,156,34,62,42,20,5,5,10,11815.0,2:24,1,0,1,5621.0,1:8,5100000
8471677,Jack,Johnson,1987-01-13,D,L,2010-11,82,5,37,42,0.51,-21,153,3.27,44,114135.0,23:11,0,0,0,0.0,84,133,16,59,-43,3,25,28,19111.0,3:53,0,1,1,4770.0,0:58,1425000
8471678,Benoit,Pouliot,1986-09-29,LW,L,2010-11,79,13,17,30,0.38,2,129,10.08,87,54679.0,11:32,10,12,22,45.45,110,20,26,14,12,1,0,1,3794.0,0:48,0,0,0,97.0,0:1,1350000
8471680,Gilbert,Brule,1987-01-01,C,R,2010-11,41,7,2,9,0.22,-7,72,9.72,41,33929.0,13:47,106,93,199,53.27,95,16,9,29,-20,1,0,1,3139.0,1:16,0,0,0,405.0,0:9,1850000
8471681,Jack,Skille,1987-05-19,RW,R,2010-11,62,8,11,19,0.31,-9,154,5.19,29,44358.0,11:55,3,7,10,30.0,134,20,23,7,16,1,0,1,2248.0,0:36,0,0,0,216.0,0:3,600000
8471682,Devin,Setoguchi,1987-01-01,RW,R,2010-11,72,22,19,41,0.57,-2,199,11.06,37,65690.0,15:12,5,6,11,45.45,138,25,29,45,-16,4,6,10,8437.0,1:57,0,0,0,103.0,0:1,1800000
8471683,Brian,Lee,1987-03-26,D,R,2010-11,50,0,3,3,0.06,-10,35,0.0,24,51874.0,17:17,0,0,0,0.0,88,77,5,20,-15,0,0,0,263.0,0:5,0,0,0,6374.0,2:7,875000
8471685,Anze,Kopitar,1987-08-24,C,L,2010-11,75,25,48,73,0.97,25,233,10.73,20,97143.0,21:35,579,581,1160,49.91,92,45,62,40,22,6,12,18,16335.0,3:37,1,0,1,9288.0,2:3,6800000
8471686,Marc,Staal,1987-01-13,D,L,2010-11,77,7,22,29,0.38,8,116,6.03,50,118915.0,25:44,0,0,0,0.0,140,109,54,37,17,4,7,11,12169.0,2:38,2,2,4,14499.0,3:8,3975000
8471689,Ryan,O'Marra,1987-06-09,C,R,2010-11,21,1,4,5,0.24,-2,13,7.69,13,13883.0,11:1,75,103,178,42.13,41,9,8,17,-9,0,1,1,178.0,0:8,0,0,0,642.0,0:30,700000
8471691,Martin,Hanzal,1987-02-20,C,L,2010-11,61,16,10,26,0.43,4,149,10.74,54,71379.0,19:30,518,511,1029,50.34,147,35,28,23,5,7,0,7,11000.0,3:0,0,0,0,7775.0,2:7,1800000
8471692,Ryan,Parent,1987-03-17,D,L,2010-11,4,0,0,0,0.0,-3,3,0.0,0,3334.0,13:53,0,0,0,0.0,4,7,0,2,-2,0,0,0,16.0,0:4,0,0,0,20.0,0:5,925000
8471693,Jakub,Kindl,1987-02-10,D,L,2010-11,48,2,2,4,0.08,-6,62,3.23,36,39196.0,13:36,0,0,0,0.0,44,36,11,20,-9,0,0,0,2036.0,0:42,0,0,0,478.0,0:9,883333
8471694,Kenndal,McArdle,1987-01-04,LW,L,2010-11,11,0,0,0,0.0,-3,6,0.0,16,6564.0,9:56,1,2,3,33.33,36,3,1,1,0,0,0,0,18.0,0:1,0,0,0,0.0,0:0,803250
8471696,Matt,Lashoff,1986-09-29,D,L,2010-11,11,0,1,1,0.09,1,8,0.0,6,9129.0,13:49,0,0,0,0.0,10,14,6,4,2,0,1,1,1345.0,2:2,0,0,0,198.0,0:18,550000
8471697,Niclas,Bergfors,1987-03-07,RW,R,2010-11,72,12,24,36,0.5,-9,152,7.89,8,63733.0,14:45,4,5,9,44.44,12,13,48,14,34,3,6,9,7374.0,1:42,0,0,0,60.0,0:0,900000
8471698,T.J.,Oshie,1986-12-23,RW,R,2010-11,49,12,22,34,0.69,10,103,11.65,15,56415.0,19:11,100,127,227,44.05,71,40,47,17,30,3,6,9,7605.0,2:35,1,0,1,5561.0,1:53,850000
8471699,Andrew,Cogliano,1987-06-14,LW,L,2010-11,82,11,24,35,0.43,-12,129,8.53,64,84902.0,17:15,461,647,1108,41.61,89,46,32,46,-14,0,5,5,4547.0,0:55,1,2,3,13381.0,2:43,1000000
8471702,Matt,Niskanen,1986-12-06,D,R,2010-11,63,1,9,10,0.16,-3,77,1.3,50,62476.0,16:31,0,0,0,0.0,122,66,7,16,-9,0,5,5,6811.0,1:48,0,0,0,1725.0,0:27,1500000
8471703,Steve,Downie,1987-04-03,RW,R,2010-11,57,10,22,32,0.56,8,83,12.05,171,49650.0,14:31,43,53,96,44.79,94,21,30,25,5,2,3,5,7736.0,2:15,0,0,0,63.0,0:1,1850000
8471705,Brendan,Mikkelson,1987-06-22,D,L,2010-11,24,0,2,2,0.08,-6,14,0.0,9,20489.0,14:13,0,0,0,0.0,21,18,2,9,-7,0,0,0,341.0,0:14,0,0,0,1833.0,1:16,687500
8471707,James,Neal,1987-09-03,LW,L,2010-11,79,22,23,45,0.57,7,212,10.38,66,82934.0,17:29,8,15,23,34.78,159,26,59,34,25,5,5,10,12241.0,2:34,0,0,0,475.0,0:6,2875000
8471708,Ryan,Stoa,1987-04-13,C,L,2010-11,25,2,2,4,0.16,-4,45,4.44,20,20013.0,13:20,2,3,5,40.0,30,6,4,3,1,0,2,2,2338.0,1:33,0,0,0,4.0,0:0,850000
8471709,Marc-Edouard,Vlasic,1987-03-30,D,L,2010-11,80,4,14,18,0.22,14,116,3.45,18,100141.0,20:51,0,0,0,0.0,50,147,30,45,-15,0,1,1,4151.0,0:51,0,0,0,10940.0,2:16,3100000
8471710,Taylor,Chorney,1987-04-27,D,L,2010-11,12,1,3,4,0.33,-5,13,7.69,4,11508.0,15:59,0,0,0,0.0,13,17,4,11,-7,1,2,3,1310.0,1:49,0,0,0,477.0,0:39,735000
8471714,Michael,Sauer,1987-08-07,D,R,2010-11,76,3,12,15,0.2,20,54,5.56,75,79876.0,17:31,0,0,0,0.0,78,96,25,13,12,1,0,1,639.0,0:8,0,0,0,6632.0,1:27,500000
8471716,Justin,Abdelkader,1987-02-25,LW,L,2010-11,74,7,12,19,0.26,15,129,5.43,61,54613.0,12:18,227,203,430,52.79,188,39,17,20,-3,0,0,0,726.0,0:9,0,1,1,7580.0,1:42,787500
8471717,Adam,McQuaid,1986-10-12,D,R,2010-11,67,3,12,15,0.22,30,46,6.52,96,59760.0,14:51,0,0,0,0.0,102,131,5,15,-10,0,0,0,252.0,0:3,0,0,0,5794.0,1:26,575000
8471719,Matt,Kassian,1986-10-28,LW,L,2010-11,4,0,0,0,0.0,-1,1,0.0,12,1316.0,5:29,0,0,0,0.0,6,3,0,1,-1,0,0,0,0.0,0:0,0,0,0,0.0,0:0,512500
8471724,Kris,Letang,1987-04-24,D,R,2010-11,82,8,42,50,0.61,15,236,3.39,101,118245.0,24:2,1,0,1,100.0,167,109,39,52,-13,4,20,24,21992.0,4:28,0,1,1,10377.0,2:6,3500000
8471729,Kris,Russell,1987-05-02,D,L,2010-11,73,5,18,23,0.32,-9,88,5.68,37,76724.0,17:31,0,0,0,0.0,63,128,25,19,6,1,5,6,12113.0,2:45,0,1,1,1508.0,0:20,1300000
8471735,Keith,Yandle,1986-09-09,D,L,2010-11,82,11,48,59,0.72,12,199,5.53,68,119944.0,24:22,0,0,0,0.0,30,103,31,61,-30,3,23,26,20154.0,4:5,0,1,1,3588.0,0:43,1200000
8471742,Cody,Franson,1987-08-08,D,R,2010-11,80,8,21,29,0.36,10,156,5.13,30,72840.0,15:10,0,0,0,0.0,81,52,29,39,-10,2,4,6,9068.0,1:53,0,0,0,558.0,0:6,800000
8471743,Vladimir,Sobotka,1987-07-02,LW,L,2010-11,65,7,22,29,0.45,-4,75,9.33,69,63093.0,16:10,216,203,419,51.55,137,37,19,14,5,1,4,5,3283.0,0:50,1,0,1,7905.0,2:1,750000
8471748,Mark,Fraser,1986-09-29,D,L,2010-11,26,0,2,2,0.08,2,16,0.0,29,21804.0,13:58,0,0,0,0.0,58,19,3,8,-5,0,0,0,104.0,0:4,0,0,0,2026.0,1:17,500000
8471752,Marc-Andre,Gragnani,1987-03-11,D,L,2010-11,9,1,2,3,0.33,0,11,9.09,2,8255.0,15:17,0,0,0,0.0,6,6,6,3,3,0,2,2,1086.0,2:0,0,0,0,89.0,0:9,500000
8471753,T.J.,Hensick,1985-12-10,C,R,2010-11,13,1,2,3,0.23,-5,12,8.33,2,7085.0,9:5,11,18,29,37.93,1,1,2,0,2,0,1,1,259.0,0:19,0,0,0,5.0,0:0,600000
8471756,Oskars,Bartulis,1987-01-21,D,L,2010-11,13,0,0,0,0.0,-4,7,0.0,4,10159.0,13:1,0,0,0,0.0,8,13,3,2,1,0,0,0,5.0,0:0,0,0,0,108.0,0:8,600000
8471761,Chris,Butler,1986-10-27,D,L,2010-11,49,2,7,9,0.18,8,52,3.85,26,53412.0,18:10,0,0,0,0.0,38,56,18,21,-3,0,1,1,3541.0,1:12,0,0,0,3075.0,1:2,576667
8471762,Chris,VandeVelde,1987-03-15,C,L,2010-11,12,0,2,2,0.17,-6,16,0.0,12,12439.0,17:16,84,75,159,52.83,19,12,6,4,2,0,0,0,1135.0,1:34,0,0,0,1027.0,1:25,745000
8471766,Jared,Boll,1986-05-13,RW,R,2010-11,73,7,5,12,0.16,-2,66,10.61,182,33613.0,7:40,0,6,6,0.0,144,18,14,8,6,0,0,0,328.0,0:4,0,0,0,24.0,0:0,725000
8471767,Blair,Jones,1986-09-27,C,R,2010-11,18,1,2,3,0.17,-2,20,5.0,2,8655.0,8:0,46,40,86,53.49,12,6,5,5,0,0,0,0,23.0,0:1,0,0,0,0.0,0:0,550000
8471768,Tom,Pyatt,1987-02-14,LW,L,2010-11,61,2,5,7,0.11,-1,65,3.08,9,38941.0,10:38,55,55,110,50.0,39,34,17,6,11,0,0,0,155.0,0:2,0,2,2,8020.0,2:11,500000
8471769,Niklas,Hjalmarsson,1987-06-06,D,L,2010-11,80,3,7,10,0.12,13,64,4.69,39,88688.0,18:28,0,0,0,0.0,46,166,32,55,-23,0,0,0,477.0,0:5,0,0,0,10329.0,2:9,3500000
8471794,Darren,Helm,1987-01-21,LW,L,2010-11,82,12,20,32,0.39,9,177,6.78,16,65468.0,13:18,493,445,938,52.56,128,30,46,20,26,0,0,0,265.0,0:3,2,1,3,15071.0,3:3,912500
8471804,Nathan,Gerbe,1987-07-24,C,L,2010-11,64,16,15,31,0.48,11,171,9.36,34,51199.0,13:19,4,13,17,23.53,53,23,24,19,5,2,2,4,4919.0,1:16,0,0,0,143.0,0:2,850000
8471807,Tom,Wandell,1987-01-29,C,L,2010-11,75,7,2,9,0.12,-5,94,7.45,14,52900.0,11:45,190,245,435,43.68,65,49,40,34,6,0,0,0,813.0,0:10,0,0,0,4423.0,0:58,775000
8471810,Derek,Joslin,1987-03-17,D,L,2010-11,34,2,7,9,0.26,5,34,5.88,10,31139.0,15:15,0,0,0,0.0,40,28,7,17,-10,1,0,1,2338.0,1:8,0,0,0,2276.0,1:6,500000
8471811,Cal,O'Reilly,1986-09-30,C,L,2010-11,38,6,12,18,0.47,4,44,13.64,2,38537.0,16:54,231,266,497,46.48,5,13,29,14,15,1,3,4,5289.0,2:19,0,0,0,633.0,0:16,562500
8471816,Mark,Fayne,1987-05-15,D,R,2010-11,57,4,10,14,0.25,10,77,5.19,27,60999.0,17:50,0,0,0,0.0,51,39,13,24,-11,0,4,4,2579.0,0:45,0,0,0,1828.0,0:32,542500
8471817,Ryan,Reaves,1987-01-20,RW,R,2010-11,28,2,2,4,0.14,-1,16,12.5,78,11433.0,6:48,0,2,2,0.0,86,9,2,3,-1,0,0,0,135.0,0:4,0,0,0,23.0,0:0,525000
8471832,Nick,Drazenovic,1987-01-14,C,L,2010-11,3,0,0,0,0.0,-3,2,0.0,0,1616.0,8:58,6,5,11,54.55,7,1,0,1,-1,0,0,0,187.0,1:2,0,0,0,0.0,0:0,500000
8471840,Brett,Sutter,1987-06-02,LW,L,2010-11,5,0,1,1,0.2,-1,3,0.0,5,2677.0,8:55,13,13,26,50.0,3,1,0,2,-2,0,0,0,42.0,0:8,0,1,1,648.0,2:9,500000
8471842,Tim,Kennedy,1986-04-30,LW,L,2010-11,6,0,1,1,0.17,0,2,0.0,0,3737.0,10:22,12,18,30,40.0,16,6,4,0,4,0,0,0,64.0,0:10,0,0,0,0.0,0:0,1000000
8471851,Matt,D'Agostini,1986-10-23,RW,R,2010-11,82,21,25,46,0.56,8,163,12.88,40,72615.0,14:45,21,34,55,38.18,70,36,24,12,12,6,8,14,8139.0,1:39,0,0,0,369.0,0:4,550000
8471856,Joe,Vitale,1985-08-20,C,R,2010-11,9,1,1,2,0.22,-1,13,7.69,13,5709.0,10:34,36,28,64,56.25,18,2,5,2,3,0,1,1,75.0,0:8,0,0,0,229.0,0:25,512500
8471859,Sergei,Kostitsyn,1987-03-20,LW,L,2010-11,77,23,27,50,0.65,10,93,24.73,20,70182.0,15:11,1,5,6,16.67,41,15,28,44,-16,4,9,13,8727.0,1:53,1,0,1,1585.0,0:20,550000
8471862,Colin,Greening,1986-03-09,C,L,2010-11,24,6,7,13,0.54,2,57,10.53,10,21725.0,15:5,11,13,24,45.83,56,9,11,8,3,0,0,0,676.0,0:28,0,0,0,1298.0,0:54,735000
8471873,Anton,Stralman,1986-08-01,D,R,2010-11,51,1,17,18,0.35,-11,80,1.25,22,60387.0,19:44,0,0,0,0.0,39,46,15,11,4,1,9,10,9060.0,2:57,0,0,0,990.0,0:19,1950000
8471879,Kyle,Cumiskey,1986-12-02,D,L,2010-11,18,1,7,8,0.44,-3,21,4.76,10,21238.0,19:39,0,0,0,0.0,9,27,14,7,7,0,1,1,2292.0,2:7,0,0,0,3162.0,2:55,600000
8471887,Patric,Hornqvist,1987-01-01,RW,R,2010-11,79,21,27,48,0.61,11,265,7.92,47,74539.0,15:43,22,23,45,48.89,86,36,40,21,19,6,8,14,13050.0,2:45,0,0,0,49.0,0:0,3083333
8471956,Andrew,Desjardins,1986-07-27,LW,L,2010-11,17,1,2,3,0.18,-1,12,8.33,4,7283.0,7:8,31,25,56,55.36,34,5,6,1,5,0,0,0,52.0,0:3,0,0,0,266.0,0:15,500000
8471958,Dan,Girardi,1984-04-29,D,R,2010-11,80,4,27,31,0.39,7,110,3.64,37,117971.0,24:34,0,0,0,0.0,195,236,30,51,-21,2,5,7,9705.0,2:1,0,2,2,15421.0,3:12,3325000
8471976,David,Desharnais,1986-09-14,C,L,2010-11,43,8,14,22,0.51,-3,55,14.55,12,33206.0,12:52,221,224,445,49.66,16,19,10,6,4,4,4,8,4861.0,1:53,0,0,0,2351.0,0:54,550000
8472368,Chris,Conner,1983-12-23,RW,L,2010-11,60,7,9,16,0.27,5,91,7.69,10,42544.0,11:49,1,3,4,25.0,50,20,15,7,8,0,0,0,2181.0,0:36,0,0,0,79.0,0:1,550000
8472382,Andy,Greene,1982-10-30,D,L,2010-11,82,4,19,23,0.28,-23,91,4.4,22,110015.0,22:21,0,0,0,0.0,49,157,34,34,0,1,5,6,6305.0,1:16,0,0,0,11425.0,2:19,737500
8472394,Peter,Harrold,1983-06-08,D,R,2010-11,19,1,3,4,0.21,3,12,8.33,4,13973.0,12:15,0,0,0,0.0,5,6,5,6,-1,0,0,0,752.0,0:39,0,0,0,56.0,0:2,583333
8472410,Stephen,Gionta,1983-10-09,RW,R,2010-11,12,0,0,0,0.0,-3,13,0.0,6,6484.0,9:0,0,0,0,0.0,16,5,5,2,3,0,0,0,26.0,0:2,0,0,0,1138.0,1:34,512500
8473412,Bryan,Little,1987-11-12,C,R,2010-11,76,18,30,48,0.63,11,158,11.39,33,84159.0,18:27,616,715,1331,46.28,41,31,80,22,58,2,8,10,11272.0,2:28,2,1,3,7789.0,1:42,2383333
8473419,Brad,Marchand,1988-05-11,LW,L,2010-11,77,21,20,41,0.53,25,149,14.09,51,64607.0,13:59,8,17,25,32.0,89,30,36,39,-3,2,1,3,2495.0,0:32,5,1,6,7260.0,1:34,590000
8473422,Nick,Foligno,1987-10-31,LW,L,2010-11,82,14,20,34,0.41,-19,149,9.4,43,76639.0,15:34,65,73,138,47.1,119,41,31,25,6,5,5,10,8639.0,1:45,0,0,0,195.0,0:2,1200000
8473426,Mike,Weber,1987-12-16,D,L,2010-11,58,4,13,17,0.29,13,53,7.55,69,58789.0,16:53,0,0,0,0.0,158,99,14,34,-20,0,0,0,309.0,0:5,0,0,0,5531.0,1:35,550000
8473432,Derek,Dorsett,1986-12-20,RW,R,2010-11,76,4,13,17,0.22,-15,112,3.57,184,60230.0,13:12,19,32,51,37.25,195,37,25,7,18,0,0,0,471.0,0:6,0,3,3,7078.0,1:33,562500
8473446,Erik,Johnson,1988-03-21,D,R,2010-11,77,8,21,29,0.38,-13,161,4.97,56,105438.0,22:49,0,0,0,0.0,99,133,28,43,-15,3,7,10,12590.0,2:43,1,1,2,11288.0,2:26,2600000
8473449,Kyle,Okposo,1988-04-16,RW,R,2010-11,38,5,15,20,0.53,3,72,6.94,40,37809.0,16:34,36,51,87,41.38,31,16,26,22,4,0,5,5,5798.0,2:32,0,0,0,1133.0,0:29,821667
8473453,Trevor,Lewis,1987-01-08,C,R,2010-11,72,3,10,13,0.18,-11,105,2.86,6,49629.0,11:29,151,234,385,39.22,102,25,27,16,11,0,0,0,229.0,0:3,0,0,0,7646.0,1:46,803250
8473465,Jamie,McGinn,1988-08-05,LW,L,2010-11,49,1,5,6,0.12,-6,63,1.59,33,34056.0,11:35,8,3,11,72.73,101,17,18,6,12,0,0,0,269.0,0:5,0,0,0,611.0,0:12,681667
8473466,Ryan,White,1988-03-17,C,R,2010-11,27,2,3,5,0.19,5,30,6.67,38,14453.0,8:55,13,19,32,40.62,70,8,8,5,3,0,0,0,190.0,0:7,0,0,0,203.0,0:7,610000
8473473,Milan,Lucic,1988-06-07,LW,L,2010-11,79,30,32,62,0.78,28,173,17.34,121,78589.0,16:34,21,33,54,38.89,167,22,27,43,-16,5,9,14,11919.0,2:30,0,0,0,123.0,0:1,4083333
8473482,Jiri,Tlusty,1988-03-16,LW,L,2010-11,57,6,6,12,0.21,1,53,11.32,14,33727.0,9:51,2,13,15,13.33,36,19,21,7,14,0,0,0,525.0,0:9,0,0,0,163.0,0:2,500000
8473485,Chris,Stewart,1987-10-30,RW,R,2010-11,62,28,25,53,0.85,-6,162,17.28,53,65052.0,17:29,13,19,32,40.62,56,18,14,22,-8,12,4,16,10695.0,2:52,0,0,0,207.0,0:3,2875000
8473492,Matt,Beleskey,1988-06-07,LW,L,2010-11,35,3,7,10,0.29,-10,58,5.17,36,27264.0,12:58,3,5,8,37.5,64,20,7,10,-3,0,0,0,766.0,0:21,0,1,1,1034.0,0:29,583333
8473493,Ben,Maxwell,1988-03-30,C,L,2010-11,12,1,1,2,0.17,-7,13,7.69,9,8636.0,11:59,16,20,36,44.44,1,2,5,3,2,0,0,0,153.0,0:12,0,0,0,512.0,0:42,710000
8473501,Ty,Wishart,1988-05-19,D,L,2010-11,20,1,4,5,0.25,5,23,4.35,10,20181.0,16:49,0,0,0,0.0,26,29,9,10,-1,1,0,1,600.0,0:30,0,1,1,1723.0,1:26,788333
8473504,Cal,Clutterbuck,1987-11-18,RW,R,2010-11,76,19,15,34,0.45,-5,191,9.95,79,72265.0,15:50,3,8,11,27.27,336,32,24,25,-1,4,1,5,9552.0,2:5,0,1,1,6608.0,1:26,1400000
8473507,Jeff,Petry,1987-12-09,D,R,2010-11,35,1,4,5,0.14,-12,41,2.44,10,42785.0,20:22,0,0,0,0.0,48,49,16,32,-16,0,3,3,4588.0,2:11,0,0,0,2689.0,1:16,850000
8473512,Claude,Giroux,1988-01-12,C,R,2010-11,82,25,51,76,0.93,20,169,14.79,47,95437.0,19:23,548,547,1095,50.05,117,44,48,44,4,8,11,19,15092.0,3:4,3,4,7,10363.0,2:6,821667
8473514,Jesse,Joensuu,1987-10-05,LW,L,2010-11,42,6,3,9,0.21,-6,41,14.63,33,29171.0,11:34,5,4,9,55.56,59,13,11,10,1,0,0,0,319.0,0:7,0,0,0,24.0,0:0,618333
8473533,Jordan,Staal,1988-09-10,C,L,2010-11,42,11,19,30,0.71,7,91,12.09,24,53810.0,21:21,376,425,801,46.94,70,13,20,10,10,3,4,7,7946.0,3:9,0,2,2,6313.0,2:30,4000000
8473534,Patrik,Berglund,1988-06-02,C,L,2010-11,81,22,30,52,0.64,-3,175,12.57,26,83546.0,17:11,450,524,974,46.2,116,33,28,19,9,8,9,17,14090.0,2:53,0,1,1,2400.0,0:29,821667
8473537,Viktor,Stalberg,1986-01-17,LW,L,2010-11,77,12,12,24,0.31,2,135,8.89,43,49426.0,10:41,5,4,9,55.56,102,25,36,14,22,0,1,1,950.0,0:12,0,0,0,68.0,0:0,750000
8473542,Tom,Sestito,1987-09-28,LW,L,2010-11,9,2,2,4,0.44,-4,7,28.57,40,5145.0,9:31,1,0,1,100.0,31,3,1,2,-1,1,1,2,726.0,1:20,0,0,0,0.0,0:0,577500
8473544,Derick,Brassard,1987-09-22,C,L,2010-11,74,17,30,47,0.64,-11,183,9.29,55,75607.0,17:1,414,474,888,46.62,121,14,26,23,3,6,10,16,13244.0,2:58,0,0,0,259.0,0:3,3200000
8473546,Michael,Grabner,1987-10-05,RW,L,2010-11,76,34,18,52,0.68,13,228,14.91,10,68779.0,15:4,2,4,6,33.33,22,26,69,30,39,2,2,4,4174.0,0:54,6,1,7,6980.0,1:31,793333
8473548,Phil,Kessel,1987-10-02,RW,R,2010-11,82,32,32,64,0.78,-20,325,9.85,24,96660.0,19:38,24,35,59,40.68,11,22,45,45,0,12,11,23,18456.0,3:45,1,0,1,575.0,0:7,5400000
8473558,Cory,Emmerton,1988-06-01,C,L,2010-11,2,1,0,1,0.5,1,3,33.33,0,1001.0,8:20,0,1,1,0.0,0,0,0,0,0,0,0,0,0.0,0:0,0,0,0,0.0,0:0,623333
8473560,Korbinian,Holzer,1988-02-16,D,R,2010-11,2,0,0,0,0.0,-1,1,0.0,2,1562.0,13:1,0,0,0,0.0,1,3,1,2,-1,0,0,0,59.0,0:29,0,0,0,68.0,0:34,595000
8473562,John,McCarthy,1986-08-09,C,L,2010-11,37,2,2,4,0.11,-8,41,4.88,8,19409.0,8:44,13,23,36,36.11,28,9,7,5,2,0,0,0,16.0,0:0,0,0,0,1040.0,0:28,550000
8473563,Nicklas,Backstrom,1987-11-23,C,L,2010-11,77,18,47,65,0.84,24,202,8.91,40,95160.0,20:35,690,625,1315,52.47,69,64,73,42,31,4,18,22,15358.0,3:19,1,0,1,6671.0,1:26,6700000
8473564,Michael,Frolik,1988-02-17,RW,L,2010-11,80,11,27,38,0.48,2,251,4.38,30,74844.0,15:35,48,71,119,40.34,52,37,49,16,33,1,5,6,8087.0,1:41,0,0,0,346.0,0:4,850000
8473571,Jamie,McBain,1988-02-25,D,R,2010-11,76,7,23,30,0.39,-8,95,7.37,32,87105.0,19:6,0,0,0,0.0,41,117,22,36,-14,1,7,8,12497.0,2:44,0,0,0,2896.0,0:38,685000
8473573,Artem,Anisimov,1988-05-24,C,L,2010-11,82,18,26,44,0.54,3,190,9.47,20,79742.0,16:12,306,382,688,44.48,74,45,46,16,30,3,5,8,8848.0,1:47,0,0,0,5084.0,1:2,821667
8473574,Shawn,Matthias,1988-02-19,LW,L,2010-11,51,6,10,16,0.31,0,90,6.67,16,36232.0,11:50,188,182,370,50.81,60,20,22,7,15,0,2,2,2029.0,0:39,0,0,0,430.0,0:8,773333
8473579,Nikolay,Kulemin,1986-07-14,LW,L,2010-11,82,30,27,57,0.7,7,173,17.34,26,85235.0,17:19,60,51,111,54.05,101,48,37,28,9,5,8,13,13075.0,2:39,1,0,1,4564.0,0:55,2350000
8473580,Matthew,Corrente,1988-03-17,D,R,2010-11,22,0,6,6,0.27,-5,21,0.0,44,17951.0,13:35,0,0,0,0.0,30,15,0,10,-10,0,0,0,59.0,0:2,0,0,0,455.0,0:20,590000
8473584,Andrew,MacDonald,1986-09-07,D,L,2010-11,60,4,23,27,0.45,9,72,5.56,37,84291.0,23:24,0,0,0,0.0,38,160,49,35,14,1,11,12,10986.0,3:3,0,0,0,8614.0,2:23,550000
8473588,Erik,Condra,1986-08-06,RW,R,2010-11,26,6,5,11,0.42,-1,48,12.5,12,24755.0,15:52,2,2,4,50.0,4,21,9,11,-2,1,0,1,1137.0,0:43,0,1,1,3113.0,1:59,605000
8473600,Benn,Ferriero,1987-04-29,RW,R,2010-11,33,5,4,9,0.27,8,56,8.93,9,25914.0,13:5,2,9,11,18.18,46,8,11,11,0,1,0,1,1871.0,0:56,0,0,0,10.0,0:0,635000
8473604,Jonathan,Toews,1988-04-29,C,L,2010-11,80,32,44,76,0.95,25,233,13.73,26,99668.0,20:45,937,716,1653,56.68,74,28,93,30,63,10,15,25,14823.0,3:5,1,1,2,9404.0,1:57,6300000
8473605,Alexander,Vasyunov,1988-04-22,LW,R,2010-11,18,1,4,5,0.28,0,18,5.56,0,12394.0,11:28,0,0,0,0.0,6,2,5,5,0,0,0,0,78.0,0:4,0,0,0,10.0,0:0,618333
8473608,Blake,Geoffrion,1988-02-03,C,L,2010-11,20,6,2,8,0.4,3,24,25.0,7,9929.0,8:16,46,53,99,46.46,8,4,11,6,5,0,0,0,23.0,0:1,0,0,0,28.0,0:1,850000
8473618,Mathieu,Perreault,1988-01-05,C,L,2010-11,35,7,7,14,0.4,-3,41,17.07,20,24952.0,11:52,139,166,305,45.57,13,9,21,12,9,1,2,3,3164.0,1:30,0,0,0,18.0,0:0,675000
8473646,Ryan,Carter,1983-08-03,LW,L,2010-11,62,3,6,9,0.15,-1,63,4.76,66,37272.0,10:1,242,236,478,50.63,133,22,23,7,16,0,0,0,205.0,0:3,0,1,1,5244.0,1:24,625000
8473673,David,Schlemko,1987-05-07,D,L,2010-11,43,4,10,14,0.33,8,47,8.51,24,41376.0,16:2,0,0,0,0.0,56,57,3,21,-18,0,5,5,4165.0,1:36,0,0,0,1071.0,0:24,550000
8473682,Andrew,Ebbett,1983-01-02,C,L,2010-11,33,2,3,5,0.15,-1,23,8.7,4,19830.0,10:0,104,125,229,45.41,13,12,8,5,3,0,0,0,25.0,0:0,1,0,1,1924.0,0:58,500000
8473700,Ryan,Wilson,1987-02-03,D,L,2010-11,67,3,13,16,0.24,-8,62,4.84,68,79620.0,19:48,0,0,0,0.0,135,110,28,31,-3,1,1,2,3173.0,0:47,0,0,0,9759.0,2:25,525000
8473712,Frazer,McLaren,1987-10-29,LW,L,2010-11,9,0,0,0,0.0,-1,1,0.0,22,2296.0,4:15,0,0,0,0.0,6,0,0,2,-2,0,0,0,0.0,0:0,0,0,0,0.0,0:0,543333
8473722,John,Scott,1982-09-26,LW,L,2010-11,40,0,1,1,0.02,0,15,0.0,72,15008.0,6:15,0,3,3,0.0,60,10,3,3,0,0,0,0,59.0,0:1,0,0,0,349.0,0:8,512500
8473908,Kevin,Westgarth,1984-02-07,RW,R,2010-11,56,0,3,3,0.05,-6,20,0.0,105,18266.0,5:26,2,2,4,50.0,59,5,5,11,-6,0,0,0,18.0,0:0,0,0,0,37.0,0:0,525000
8473914,Mark,Letestu,1985-02-04,C,R,2010-11,64,14,13,27,0.42,4,128,10.94,13,54730.0,14:15,407,327,734,55.45,51,15,26,14,12,4,2,6,8338.0,2:10,0,0,0,220.0,0:3,500000
8473927,Brad,Mills,1983-05-03,C,R,2010-11,4,1,0,1,0.25,1,6,16.67,5,1986.0,8:16,7,10,17,41.18,7,2,0,0,0,0,0,0,0.0,0:0,0,0,0,177.0,0:44,505000
8473932,Darroll,Powe,1985-06-22,C,L,2010-11,81,7,10,17,0.21,-6,87,8.05,41,59712.0,12:17,66,68,134,49.25,196,60,20,12,8,0,0,0,258.0,0:3,2,1,3,15436.0,3:10,725000
8473933,Ben,Lovejoy,1984-02-20,D,R,2010-11,47,3,14,17,0.36,11,60,5.0,48,42305.0,15:0,0,0,0,0.0,44,60,7,8,-1,0,1,1,224.0,0:4,0,1,1,2512.0,0:53,525000
8473953,Derek,Smith,1984-10-13,D,L,2010-11,9,0,1,1,0.11,3,13,0.0,0,8271.0,15:19,0,0,0,0.0,5,11,3,2,1,0,0,0,318.0,0:35,0,0,0,7.0,0:0,550000
8473962,Teddy,Purcell,1985-09-08,LW,R,2010-11,81,17,34,51,0.63,5,196,8.67,10,68535.0,14:6,12,25,37,32.43,21,16,35,19,16,3,18,21,13369.0,2:45,0,0,0,110.0,0:1,750000
8473970,Rob,Klinkhammer,1986-08-12,LW,L,2010-11,1,0,0,0,0.0,1,1,0.0,0,696.0,11:36,0,0,0,0.0,3,1,0,0,0,0,0,0,18.0,0:18,0,0,0,0.0,0:0,500000
8473991,Karl,Alzner,1988-09-24,D,L,2010-11,82,2,10,12,0.15,14,64,3.12,24,98481.0,20:0,0,0,0,0.0,98,132,24,40,-16,0,0,0,1838.0,0:22,0,0,0,10452.0,2:7,875000
8473992,Justin,Falk,1988-10-11,D,L,2010-11,22,0,3,3,0.14,-4,7,0.0,6,18687.0,14:9,0,0,0,0.0,22,17,3,7,-4,0,0,0,100.0,0:4,0,0,0,1673.0,1:16,591667
8473994,Jamie,Benn,1989-07-18,LW,L,2010-11,69,22,34,56,0.81,-5,177,12.43,52,74579.0,18:0,84,111,195,43.08,124,41,66,33,33,6,5,11,9494.0,2:17,4,2,6,6744.0,1:37,630000
8473999,Nick,Palmieri,1989-07-12,RW,R,2010-11,43,9,8,17,0.4,9,66,13.64,6,36960.0,14:19,2,0,2,100.0,36,8,16,16,0,1,1,2,1427.0,0:33,0,0,0,0.0,0:0,536667
8474000,Steven,Kampfer,1988-09-24,D,R,2010-11,38,5,5,10,0.26,9,57,8.77,12,40430.0,17:43,0,0,0,0.0,41,56,5,10,-5,0,3,3,4259.0,1:52,0,0,0,393.0,0:10,635000
8474001,TJ,Galiardi,1988-04-22,LW,L,2010-11,35,7,8,15,0.43,-6,62,11.29,12,34009.0,16:11,62,72,134,46.27,41,19,26,15,11,0,2,2,1540.0,0:44,0,0,0,4011.0,1:54,595833
8474002,Colby,Cohen,1989-04-25,D,R,2010-11,3,0,0,0,0.0,-1,2,0.0,4,3192.0,17:44,0,0,0,0.0,4,3,2,0,2,0,0,0,444.0,2:28,0,0,0,308.0,1:42,845500
8474009,Nick,Bonino,1988-04-20,C,L,2010-11,26,0,0,0,0.0,-3,23,0.0,4,15299.0,9:48,78,88,166,46.99,18,10,10,4,6,0,0,0,457.0,0:17,0,0,0,104.0,0:4,796250
8474013,Ian,Cole,1989-02-21,D,L,2010-11,26,1,3,4,0.15,6,22,4.55,35,27468.0,17:36,0,0,0,0.0,36,37,5,14,-9,0,0,0,690.0,0:26,0,0,0,1567.0,1:0,875000
8474024,Jim,O'Brien,1989-01-29,C,R,2010-11,6,0,0,0,0.0,-3,11,0.0,2,3482.0,9:40,8,8,16,50.0,5,0,2,4,-2,0,0,0,114.0,0:19,0,0,0,65.0,0:10,620833
8474025,Eric,Tangradi,1989-02-10,LW,L,2010-11,15,1,2,3,0.2,-4,18,5.56,10,10080.0,11:12,1,2,3,33.33,25,5,2,5,-3,0,0,0,1497.0,1:39,0,0,0,41.0,0:2,708333
8474027,Justin,Braun,1987-02-10,D,R,2010-11,28,2,9,11,0.39,-1,44,4.55,2,27720.0,16:30,0,0,0,0.0,27,21,14,14,0,2,0,2,1724.0,1:1,0,0,0,1773.0,1:3,662500
8474030,Aaron,Palushaj,1989-09-07,RW,R,2010-11,3,0,0,0,0.0,1,3,0.0,2,1533.0,8:31,0,1,1,0.0,3,1,0,2,-2,0,0,0,96.0,0:32,0,0,0,0.0,0:0,737500
8474031,Kevin,Shattenkirk,1989-01-29,D,R,2010-11,72,9,34,43,0.6,-4,108,8.33,36,85712.0,19:50,0,0,0,0.0,66,96,41,23,18,3,12,15,12785.0,2:57,0,0,0,1738.0,0:24,875000
8474037,James,van Riemsdyk,1989-05-04,LW,L,2010-11,75,21,19,40,0.53,15,173,12.14,35,65399.0,14:31,0,3,3,0.0,107,25,27,16,11,3,1,4,5929.0,1:19,0,0,0,252.0,0:3,875000
8474038,Paul,Byron,1989-04-27,LW,L,2010-11,8,1,1,2,0.25,0,5,20.0,2,5258.0,10:57,29,42,71,40.85,18,2,8,2,6,0,0,0,40.0,0:5,0,0,0,97.0,0:12,555000
8474040,Sam,Gagner,1989-08-10,C,R,2010-11,68,15,27,42,0.62,-17,138,10.87,37,72419.0,17:44,410,525,935,43.85,24,29,33,38,-5,3,6,9,12018.0,2:56,1,0,1,1536.0,0:22,2275000
8474042,Cody,Almond,1989-07-24,C,L,2010-11,8,0,0,0,0.0,0,3,0.0,2,3373.0,7:1,13,19,32,40.62,11,3,1,1,0,0,0,0,11.0,0:1,0,0,0,49.0,0:6,585000
8474045,Zach,Hamill,1988-09-23,C,R,2010-11,3,0,1,1,0.33,1,1,0.0,0,1885.0,10:28,5,11,16,31.25,0,3,1,2,-1,0,0,0,0.0,0:0,0,0,0,14.0,0:4,816667
8474046,Alex,Plante,1989-05-09,D,R,2010-11,3,0,0,0,0.0,-2,5,0.0,11,2709.0,15:3,0,0,0,0.0,4,3,0,1,-1,0,0,0,8.0,0:2,0,0,0,151.0,0:50,875000
8474048,Keith,Aulie,1989-06-11,D,L,2010-11,40,2,0,2,0.05,-1,32,6.25,32,45902.0,19:7,0,0,0,0.0,98,74,5,46,-41,0,0,0,560.0,0:14,0,0,0,4962.0,2:4,558333
8474050,Brett,MacLean,1988-12-24,LW,R,2010-11,13,2,1,3,0.23,0,16,12.5,2,6835.0,8:45,1,1,2,50.0,8,0,1,1,0,1,0,1,1342.0,1:43,0,0,0,0.0,0:0,737500
8474053,Logan,Couture,1989-03-28,C,L,2010-11,79,32,24,56,0.71,18,253,12.65,41,84482.0,17:49,474,414,888,53.38,60,66,49,25,24,10,4,14,10419.0,2:11,0,0,0,5117.0,1:4,816667
8474056,P.K.,Subban,1989-05-13,D,R,2010-11,77,14,24,38,0.49,-8,197,7.11,124,102881.0,22:16,0,0,0,0.0,110,106,37,56,-19,9,9,18,14235.0,3:4,0,0,0,11727.0,2:32,875000
8474068,Kyle,Turris,1989-08-14,C,R,2010-11,65,11,14,25,0.38,0,116,9.48,16,43965.0,11:16,270,270,540,50.0,30,15,14,19,-5,0,1,1,5642.0,1:26,0,0,0,313.0,0:4,845833
8474074,Paul,Postma,1989-02-22,D,R,2010-11,1,0,0,0,0.0,0,1,0.0,0,595.0,9:55,0,0,0,0.0,1,2,0,0,0,0,0,0,43.0,0:43,0,0,0,0.0,0:0,670833
8474091,Brandon,Sutter,1989-02-14,C,R,2010-11,82,14,15,29,0.35,13,145,9.66,25,82891.0,16:50,598,751,1349,44.33,69,73,48,25,23,1,2,3,3812.0,0:46,0,1,1,11576.0,2:21,875000
8474094,Matt,Halischuk,1988-06-01,RW,R,2010-11,27,4,8,12,0.44,5,29,13.79,2,16406.0,10:7,0,4,4,0.0,6,9,16,4,12,0,0,0,134.0,0:4,0,0,0,291.0,0:10,587500
8474095,Dana,Tyrell,1989-04-23,C,L,2010-11,78,6,9,15,0.19,-5,73,8.22,12,56423.0,12:3,5,6,11,45.45,47,33,21,14,7,0,0,0,468.0,0:6,0,0,0,7896.0,1:41,683333
8474096,Nick,Spaling,1988-09-19,C,L,2010-11,74,8,6,14,0.19,-10,75,10.67,20,61849.0,13:55,253,244,497,50.91,37,33,44,15,29,1,0,1,589.0,0:7,0,0,0,11905.0,2:40,737500
8474100,Dwight,King,1989-07-05,LW,L,2010-11,6,0,0,0,0.0,-2,3,0.0,2,4220.0,11:43,0,0,0,0.0,7,1,1,1,0,0,0,0,27.0,0:4,0,0,0,0.0,0:0,566667
8474102,David,Perron,1988-05-28,LW,R,2010-11,10,5,2,7,0.7,7,29,17.24,12,11051.0,18:25,0,0,0,0.0,6,1,9,3,6,0,0,0,2701.0,4:30,0,1,1,272.0,0:27,2150000
8474114,Oscar,Moller,1989-01-22,RW,R,2010-11,13,1,3,4,0.31,-1,27,3.7,2,11383.0,14:35,4,1,5,80.0,10,5,3,5,-2,0,0,0,1822.0,2:20,0,0,0,45.0,0:3,654167
8474121,Colton,Gillies,1989-02-12,C,L,2010-11,7,1,0,1,0.14,-2,3,33.33,2,4354.0,10:22,1,1,2,50.0,16,2,0,1,-1,0,0,0,264.0,0:37,0,0,0,0.0,0:0,875000
8474125,Carl,Gunnarsson,1986-11-09,D,L,2010-11,68,4,16,20,0.29,-2,69,5.8,14,74429.0,18:14,0,0,0,0.0,63,120,24,44,-20,1,3,4,5476.0,1:20,0,0,0,10626.0,2:36,630000
8474134,Yannick,Weber,1988-09-23,D,R,2010-11,41,1,10,11,0.27,0,63,1.59,14,40734.0,16:33,0,0,0,0.0,44,33,8,32,-24,0,5,5,4592.0,1:52,0,0,0,2669.0,1:5,612500
8474137,Drayson,Bowman,1989-03-08,LW,L,2010-11,23,0,1,1,0.04,0,28,0.0,12,13537.0,9:48,0,0,0,0.0,24,9,8,4,4,0,0,0,641.0,0:27,0,0,0,20.0,0:0,658333
8474138,Dustin,Jeffrey,1988-02-27,LW,L,2010-11,25,7,5,12,0.48,5,39,17.95,4,19462.0,12:58,109,138,247,44.13,14,10,9,8,1,1,0,1,2864.0,1:54,0,0,0,566.0,0:22,508333
8474141,Patrick,Kane,1988-11-19,RW,L,2010-11,73,27,46,73,1.0,7,216,12.5,28,84467.0,19:17,2,12,14,14.29,17,17,55,40,15,5,19,24,14208.0,3:14,0,0,0,229.0,0:3,6300000
8474149,Evgenii,Dadonov,1989-03-12,RW,L,2010-11,36,8,9,17,0.47,0,60,13.33,14,30789.0,14:15,1,4,5,20.0,45,11,10,12,-2,1,0,1,1968.0,0:54,0,0,0,6.0,0:0,654167
8474150,Mikael,Backlund,1989-03-17,C,L,2010-11,73,10,15,25,0.34,4,144,6.94,18,52907.0,12:4,319,345,664,48.04,35,19,37,26,11,2,2,4,2691.0,0:36,0,1,1,4085.0,0:55,845833
8474151,Ryan,McDonagh,1989-06-13,D,L,2010-11,40,1,8,9,0.22,16,27,3.7,14,44975.0,18:44,0,0,0,0.0,56,69,18,11,7,0,0,0,278.0,0:6,0,2,2,3630.0,1:30,875000
8474153,Michal,Repik,1988-12-31,RW,R,2010-11,31,2,6,8,0.26,-6,54,3.7,22,23781.0,12:47,3,4,7,42.86,47,8,3,8,-5,0,1,1,1678.0,0:54,0,0,0,51.0,0:1,629167
8474157,Max,Pacioretty,1988-11-20,LW,L,2010-11,37,14,10,24,0.65,-1,112,12.5,39,35289.0,15:53,0,1,1,0.0,67,13,20,10,10,7,1,8,5408.0,2:26,0,0,0,29.0,0:0,875000
8474161,Jakub,Voracek,1989-08-15,RW,L,2010-11,80,14,32,46,0.57,-3,183,7.65,26,81460.0,16:58,24,41,65,36.92,55,22,38,27,11,2,6,8,14200.0,2:57,0,0,0,129.0,0:1,845833
8474162,Jake,Muzzin,1989-02-21,D,L,2010-11,11,0,1,1,0.09,-2,8,0.0,0,9051.0,13:42,0,0,0,0.0,22,2,2,7,-5,0,0,0,919.0,1:23,0,0,0,3.0,0:0,606667
8474164,Jonathon,Blum,1989-01-30,D,R,2010-11,23,3,5,8,0.35,8,18,16.67,8,24502.0,17:45,0,0,0,0.0,20,36,14,11,3,1,0,1,1920.0,1:23,0,0,0,657.0,0:28,816667
8474166,Alec,Martinez,1987-07-26,D,L,2010-11,60,5,11,16,0.27,11,74,6.76,18,55003.0,15:16,0,0,0,0.0,69,73,4,22,-18,1,4,5,6337.0,1:45,0,0,0,276.0,0:4,637500
8474184,Keaton,Ellerby,1988-11-05,D,L,2010-11,54,2,10,12,0.22,-15,56,3.57,22,52143.0,16:5,0,0,0,0.0,74,68,14,14,0,0,1,1,1277.0,0:23,0,0,0,1820.0,0:33,875000
8474189,Lars,Eller,1989-05-08,C,L,2010-11,77,7,10,17,0.22,-4,79,8.86,48,51452.0,11:8,183,248,431,42.46,85,22,24,25,-1,0,0,0,1324.0,0:17,0,0,0,413.0,0:5,845833
8474190,Wayne,Simmonds,1988-08-26,RW,R,2010-11,80,14,16,30,0.38,-2,117,11.97,75,64584.0,13:27,7,12,19,36.84,125,23,30,44,-14,1,0,1,4055.0,0:50,0,0,0,400.0,0:5,556667
8474192,Matt,Frattin,1988-01-03,RW,R,2010-11,1,0,0,0,0.0,-1,5,0.0,0,934.0,15:34,0,0,0,0.0,1,0,1,1,0,0,0,0,129.0,2:9,0,0,0,0.0,0:0,875000
8474207,Nick,Holden,1987-05-15,D,L,2010-11,5,0,0,0,0.0,0,6,0.0,0,5157.0,17:11,0,0,0,0.0,4,9,0,0,0,0,0,0,1105.0,3:41,0,0,0,159.0,0:31,775000
8474218,Jason,Demers,1988-06-09,D,R,2010-11,75,2,22,24,0.32,19,105,1.9,28,87739.0,19:29,0,0,0,0.0,87,72,30,49,-19,0,6,6,9885.0,2:11,0,0,0,7168.0,1:35,543333
8474222,Maxim,Noreau,1987-05-24,D,R,2010-11,5,0,0,0,0.0,-1,8,0.0,0,4286.0,14:17,0,0,0,0.0,2,4,3,2,1,0,0,0,958.0,3:11,0,0,0,16.0,0:3,575000
8474230,Micheal,Haley,1986-03-30,C,L,2010-11,27,2,1,3,0.11,-4,13,15.38,85,13004.0,8:1,7,13,20,35.0,55,3,7,4,3,0,0,0,315.0,0:11,0,0,0,236.0,0:8,500000
8474250,Zack,Smith,1988-04-05,LW,L,2010-11,55,4,5,9,0.16,-11,78,5.13,120,41601.0,12:36,209,179,388,53.87,129,27,21,13,8,0,0,0,1432.0,0:26,0,0,0,3436.0,1:2,558333
8474291,Jay,Beagle,1985-10-16,C,R,2010-11,31,2,1,3,0.1,-2,27,7.41,8,19538.0,10:30,58,47,105,55.24,45,8,10,1,9,0,0,0,192.0,0:6,0,0,0,2143.0,1:9,512500
8474498,Jesse,Winchester,1983-10-04,C,R,2010-11,72,4,9,13,0.18,-9,118,3.39,42,46807.0,10:50,303,242,545,55.6,101,27,24,9,15,0,0,0,745.0,0:10,0,0,0,3788.0,0:52,750000
8474518,Davis,Drewiske,1984-11-22,D,L,2010-11,38,0,5,5,0.13,-1,27,0.0,19,32723.0,14:21,0,0,0,0.0,23,61,6,12,-6,0,0,0,685.0,0:18,0,0,0,3867.0,1:41,616667
8474519,Jack,Hillen,1986-01-24,D,L,2010-11,64,4,18,22,0.34,-5,81,4.94,45,72261.0,18:49,0,0,0,0.0,54,137,39,26,13,0,1,1,3022.0,0:47,0,1,1,7376.0,1:55,525000
8474520,Jason,Garrison,1984-11-13,D,L,2010-11,73,5,13,18,0.25,-2,116,4.31,26,97648.0,22:17,0,0,0,0.0,136,127,19,41,-22,0,3,3,6801.0,1:33,0,0,0,13774.0,3:8,675000
8474531,Mike,Moore,1984-12-12,D,L,2010-11,6,1,0,1,0.17,-1,5,20.0,7,3640.0,10:6,0,0,0,0.0,4,2,0,3,-3,0,0,0,15.0,0:2,0,0,0,76.0,0:12,512500
8474535,Chris,Mueller,1986-03-06,C,R,2010-11,15,0,3,3,0.2,0,7,0.0,2,7773.0,8:38,43,46,89,48.31,19,0,6,1,5,0,0,0,89.0,0:5,0,0,0,47.0,0:3,500000
8474551,Ville,Leino,1983-10-06,LW,L,2010-11,81,19,34,53,0.65,14,117,16.24,22,77838.0,16:0,78,58,136,57.35,35,40,39,37,2,5,6,11,11190.0,2:18,0,0,0,44.0,0:0,800000
8474557,Anssi,Salmela,1984-08-13,D,L,2010-11,48,1,6,7,0.15,-11,57,1.75,14,50103.0,17:23,0,0,0,0.0,48,36,14,16,-2,0,0,0,944.0,0:19,0,0,0,642.0,0:13,612500
8474563,Drew,Doughty,1989-12-08,D,R,2010-11,76,11,29,40,0.53,13,139,7.91,68,116932.0,25:38,0,0,0,0.0,137,101,22,77,-55,5,10,15,19040.0,4:10,0,0,0,9304.0,2:2,875000
8474564,Steven,Stamkos,1990-02-07,C,R,2010-11,82,45,46,91,1.11,3,272,16.54,74,99356.0,20:11,431,496,927,46.49,84,37,40,60,-20,17,19,36,22373.0,4:32,0,0,0,1594.0,0:19,875000
8474565,Alex,Pietrangelo,1990-01-18,D,R,2010-11,79,11,32,43,0.54,18,161,6.83,19,104285.0,22:0,0,0,0,0.0,57,121,40,36,4,4,10,14,14241.0,3:0,0,1,1,9397.0,1:58,816667
8474566,Nikita,Filatov,1990-05-25,LW,R,2010-11,23,0,7,7,0.3,3,31,0.0,8,16998.0,12:19,0,0,0,0.0,10,4,4,1,3,0,3,3,3564.0,2:34,0,0,0,0.0,0:0,845833
8474567,Zach,Bogosian,1990-07-15,D,R,2010-11,71,5,12,17,0.24,-27,155,3.23,29,95440.0,22:24,0,0,0,0.0,111,91,33,53,-20,0,4,4,8443.0,1:58,0,0,0,8609.0,2:1,875000
8474568,Luke,Schenn,1989-11-02,D,R,2010-11,82,5,17,22,0.27,-7,128,3.91,34,110057.0,22:22,0,0,0,0.0,251,168,38,95,-57,0,0,0,4839.0,0:59,0,1,1,13469.0,2:44,875000
8474569,Colin,Wilson,1989-10-20,C,L,2010-11,82,16,18,34,0.41,9,101,15.84,17,65407.0,13:17,108,120,228,47.37,38,24,24,41,-17,2,4,6,8270.0,1:40,0,0,0,37.0,0:0,875000
8474570,Cody,Hodgson,1990-02-18,C,R,2010-11,8,1,1,2,0.25,1,9,11.11,0,3716.0,7:44,16,26,42,38.1,4,2,2,1,1,0,0,0,375.0,0:46,0,0,0,0.0,0:0,816667
8474571,Mikkel,Boedker,1989-12-16,LW,L,2010-11,34,4,10,14,0.41,11,39,10.26,8,22239.0,10:54,3,2,5,60.0,42,6,7,3,4,0,2,2,2626.0,1:17,0,0,0,0.0,0:0,875000
8474573,Josh,Bailey,1989-10-02,RW,L,2010-11,70,11,17,28,0.4,-13,102,10.78,37,74904.0,17:50,273,342,615,44.39,47,41,72,44,28,5,4,9,10059.0,2:23,0,3,3,9914.0,2:21,875000
8474574,Tyler,Myers,1990-02-01,D,R,2010-11,80,10,27,37,0.46,0,122,8.2,40,107798.0,22:27,0,0,0,0.0,107,98,41,67,-26,3,11,14,13423.0,2:47,0,0,0,12942.0,2:41,875000
8474576,Zach,Boychuk,1989-10-04,LW,L,2010-11,23,4,3,7,0.3,-2,44,9.09,4,14797.0,10:43,1,4,5,20.0,50,6,5,7,-2,1,0,1,1081.0,0:47,0,0,0,5.0,0:0,845833
8474577,Joe,Colborne,1990-01-30,C,L,2010-11,1,0,1,1,1.0,1,1,0.0,0,1121.0,18:41,3,6,9,33.33,0,1,1,3,-2,0,0,0,263.0,4:23,0,0,0,4.0,0:4,875000
8474578,Erik,Karlsson,1990-05-31,D,R,2010-11,75,13,32,45,0.6,-30,182,7.14,50,105822.0,23:30,0,0,0,0.0,32,74,56,79,-23,4,17,21,16494.0,3:39,0,1,1,6606.0,1:28,875000
8474579,Luca,Sbisa,1990-01-30,D,L,2010-11,68,2,9,11,0.16,-11,76,2.63,43,68523.0,16:47,0,0,0,0.0,170,85,15,28,-13,1,0,1,5304.0,1:18,0,2,2,6245.0,1:31,875000
8474582,Mattias,Tedenby,1990-02-21,RW,L,2010-11,58,8,14,22,0.38,3,87,9.2,14,43652.0,12:32,0,0,0,0.0,24,2,13,31,-18,2,3,5,6500.0,1:52,0,0,0,43.0,0:0,875000
8474584,Michael,Del Zotto,1990-06-24,D,L,2010-11,47,2,9,11,0.23,-5,58,3.45,20,54949.0,19:29,0,0,0,0.0,92,72,16,24,-8,2,5,7,10600.0,3:45,0,0,0,1486.0,0:31,875000
8474586,Jordan,Eberle,1990-05-15,C,R,2010-11,69,18,25,43,0.62,-12,158,11.39,22,73208.0,17:40,11,15,26,42.31,32,17,56,41,15,4,7,11,10555.0,2:32,2,0,2,2801.0,0:40,875000
8474587,Greg,Nemisz,1990-06-05,RW,R,2010-11,6,0,1,1,0.17,-1,5,0.0,0,1834.0,5:5,1,2,3,33.33,1,2,1,1,0,0,0,0,0.0,0:0,0,0,0,0.0,0:0,845833
8474589,Tyler,Ennis,1989-10-06,LW,L,2010-11,82,20,29,49,0.6,0,210,9.52,30,77110.0,15:40,2,7,9,22.22,42,27,45,25,20,5,9,14,11190.0,2:16,0,0,0,192.0,0:2,875000
8474590,John,Carlson,1990-01-10,D,R,2010-11,82,7,30,37,0.45,21,144,4.86,44,111406.0,22:38,0,0,0,0.0,70,160,60,80,-20,1,5,6,10873.0,2:12,0,0,0,11448.0,2:19,845833
8474592,Philip,McRae,1990-03-15,C,L,2010-11,15,1,2,3,0.2,-10,13,7.69,2,8133.0,9:2,34,30,64,53.12,8,5,0,3,-3,0,0,0,205.0,0:13,0,0,0,0.0,0:0,875000
8474601,Yann,Sauve,1990-02-18,D,L,2010-11,5,0,0,0,0.0,-2,6,0.0,0,3900.0,13:0,0,0,0,0.0,9,4,0,4,-4,0,0,0,11.0,0:2,0,0,0,102.0,0:20,670833
8474605,Patrick,Wiercioch,1990-09-12,D,L,2010-11,8,0,2,2,0.25,0,3,0.0,4,6673.0,13:54,0,0,0,0.0,4,2,0,2,-2,0,1,1,490.0,1:1,0,0,0,6.0,0:0,875000
8474609,Luke,Adam,1990-06-18,C,L,2010-11,19,3,1,4,0.21,-6,31,9.68,12,12780.0,11:12,41,78,119,34.45,17,5,2,7,-5,0,1,1,1839.0,1:36,0,0,0,9.0,0:0,737500
8474610,Zac,Dalpe,1989-11-01,C,R,2010-11,15,3,1,4,0.27,0,16,18.75,0,7145.0,7:56,7,19,26,26.92,10,5,5,1,4,0,0,0,82.0,0:5,0,0,0,40.0,0:2,704167
8474611,Cameron,Gaunce,1990-03-19,D,L,2010-11,11,1,0,1,0.09,-3,4,25.0,16,8403.0,12:43,0,0,0,0.0,10,7,1,5,-4,0,0,0,67.0,0:6,0,0,0,971.0,1:28,687500
8474612,Travis,Hamonic,1990-08-16,D,R,2010-11,62,5,21,26,0.42,4,118,4.24,103,80250.0,21:34,0,0,0,0.0,118,118,45,50,-5,1,3,4,7438.0,1:59,0,1,1,8071.0,2:10,875000
8474613,Derek,Stepan,1990-06-18,C,R,2010-11,82,21,24,45,0.55,8,166,12.65,20,80904.0,16:26,277,442,719,38.53,83,26,39,25,14,3,7,10,11644.0,2:22,0,0,0,2213.0,0:26,820833
8474616,Patrice,Cormier,1990-06-14,C,L,2010-11,21,1,1,2,0.1,-5,27,3.7,4,12152.0,9:38,39,28,67,58.21,31,15,6,1,5,0,0,0,277.0,0:13,0,0,0,57.0,0:2,575000
8474618,Marco,Scandella,1990-02-23,D,L,2010-11,20,0,2,2,0.1,-9,13,0.0,2,17963.0,14:58,0,0,0,0.0,20,22,5,10,-5,0,0,0,216.0,0:10,0,0,0,818.0,0:40,643333
8474634,Evgeny,Grachev,1990-02-21,C,R,2010-11,8,0,0,0,0.0,-3,3,0.0,0,3697.0,7:42,0,1,1,0.0,8,0,4,0,4,0,0,0,52.0,0:6,0,0,0,0.0,0:0,675000
8474641,Adam,Henrique,1990-02-06,C,L,2010-11,1,0,0,0,0.0,1,3,0.0,0,801.0,13:21,0,1,1,0.0,0,2,0,0,0,0,0,0,45.0,0:45,0,0,0,0.0,0:0,575000
8474642,Lance,Bouma,1990-03-25,LW,L,2010-11,16,0,1,1,0.06,-1,9,0.0,2,5638.0,5:52,0,3,3,0.0,15,6,2,3,-1,0,0,0,0.0,0:0,0,0,0,0.0,0:0,563333
8474646,Brandon,McMillan,1990-03-22,LW,L,2010-11,60,11,10,21,0.35,-5,77,14.29,18,50662.0,14:4,114,179,293,38.91,53,24,11,19,-8,2,1,3,1433.0,0:23,2,2,4,7322.0,2:2,687500
8474668,Dale,Weise,1988-08-05,RW,R,2010-11,10,0,0,0,0.0,-1,9,0.0,19,3903.0,6:30,0,0,0,0.0,20,3,2,0,2,0,0,0,70.0,0:7,0,0,0,0.0,0:0,578333
8474673,TJ,Brodie,1990-06-07,D,L,2010-11,3,0,0,0,0.0,-3,1,0.0,2,2881.0,16:0,0,0,0,0.0,2,4,1,2,-1,0,0,0,592.0,3:17,0,0,0,53.0,0:17,566667
8474681,Andrei,Loktionov,1990-05-30,C,L,2010-11,19,4,3,7,0.37,2,26,15.38,2,16827.0,14:45,23,32,55,41.82,6,8,10,9,1,0,1,1,2931.0,2:34,0,0,0,0.0,0:0,604167
8474685,Matt,Calvert,1989-12-24,LW,L,2010-11,42,11,9,20,0.48,3,50,22.0,12,27956.0,11:5,3,6,9,33.33,51,8,7,8,-1,3,1,4,2454.0,0:58,0,0,0,41.0,0:0,712500
8474693,Tomas,Kubalik,1990-05-01,RW,R,2010-11,4,0,2,2,0.5,-3,5,0.0,0,3540.0,14:45,1,0,1,100.0,14,0,2,1,1,0,0,0,562.0,2:20,0,0,0,0.0,0:0,613333
8474707,Philip,Larsen,1989-12-07,D,R,2010-11,6,0,2,2,0.33,1,11,0.0,0,4836.0,13:26,0,0,0,0.0,1,3,1,1,0,0,0,0,1145.0,3:10,0,0,0,0.0,0:0,635000
8474709,Matt,Martin,1989-05-08,LW,L,2010-11,68,5,9,14,0.21,-13,60,8.33,147,44707.0,10:57,10,17,27,37.04,299,49,25,11,14,0,0,0,894.0,0:13,0,1,1,3231.0,0:47,631667
8474716,Jared,Spurgeon,1989-11-29,D,R,2010-11,53,4,8,12,0.23,-1,38,10.53,2,47929.0,15:4,0,0,0,0.0,37,45,11,15,-4,2,4,6,4689.0,1:28,0,0,0,881.0,0:16,526667
8474719,Teemu,Hartikainen,1990-05-03,C,L,2010-11,12,3,2,5,0.42,-3,21,14.29,4,12535.0,17:24,6,12,18,33.33,19,6,4,5,-1,1,1,2,1860.0,2:35,0,0,0,11.0,0:0,875000
8474727,Ben,Smith,1988-07-11,RW,R,2010-11,6,1,0,1,0.17,1,6,16.67,0,4961.0,13:46,6,2,8,75.0,7,5,3,0,3,0,0,0,126.0,0:21,0,0,0,37.0,0:6,592500
8474739,Tommy,Wingels,1988-04-12,C,R,2010-11,5,0,0,0,0.0,-1,1,0.0,0,1533.0,5:6,1,2,3,33.33,6,1,0,0,0,0,0,0,3.0,0:0,0,0,0,0.0,0:0,687500
8474749,Matt,Bartkowski,1988-06-04,D,L,2010-11,6,0,0,0,0.0,-1,2,0.0,4,3302.0,9:10,0,0,0,0.0,4,2,0,1,-1,0,0,0,65.0,0:10,0,0,0,94.0,0:15,660000
8474850,Brandon,Mashinter,1988-09-20,LW,L,2010-11,13,0,0,0,0.0,-2,5,0.0,17,4974.0,6:22,0,0,0,0.0,16,1,2,2,0,0,0,0,152.0,0:11,0,0,0,0.0,0:0,569167
8475060,Matt,Taormina,1986-10-20,D,L,2010-11,17,3,2,5,0.29,-2,38,7.89,2,21083.0,20:40,0,0,0,0.0,12,22,7,13,-6,1,0,1,3120.0,3:3,0,0,0,436.0,0:25,510000
8475098,Tyler,Bozak,1986-03-19,C,R,2010-11,82,15,17,32,0.39,-29,120,12.5,14,94861.0,19:16,787,654,1441,54.61,85,48,46,51,-5,6,5,11,14560.0,2:57,1,0,1,8893.0,1:48,875000
8475105,Dan,Sexton,1987-04-29,RW,R,2010-11,47,4,9,13,0.28,-6,78,5.13,4,32687.0,11:35,1,3,4,25.0,29,20,8,12,-4,1,0,1,1091.0,0:23,0,0,0,39.0,0:0,575000
8475149,Marcus,Johansson,1990-10-06,LW,L,2010-11,69,13,14,27,0.39,2,102,12.75,10,60954.0,14:43,271,398,669,40.51,47,22,47,29,18,2,1,3,3953.0,0:57,1,0,1,4891.0,1:10,900000
8475150,Jordan,Caron,1990-11-02,RW,L,2010-11,23,3,4,7,0.3,3,27,11.11,6,17487.0,12:40,1,6,7,14.29,19,11,3,5,-2,0,0,0,111.0,0:4,0,0,0,3081.0,2:13,886667
8475151,Kyle,Palmieri,1991-02-01,RW,R,2010-11,10,1,0,1,0.1,-1,10,10.0,0,5212.0,8:41,0,0,0,0.0,5,1,0,1,-1,0,0,0,7.0,0:0,0,0,0,0.0,0:0,900000
8475158,Ryan,O'Reilly,1991-02-07,C,L,2010-11,74,13,13,26,0.35,-7,119,10.92,16,71294.0,16:3,531,494,1025,51.8,53,31,72,23,49,2,2,4,2782.0,0:37,1,1,2,10688.0,2:24,880000
8475160,Kyle,Clifford,1991-01-13,LW,L,2010-11,76,7,7,14,0.18,-10,69,10.14,141,43341.0,9:30,8,7,15,53.33,138,17,10,22,-12,0,0,0,127.0,0:1,0,0,0,15.0,0:0,710000
8475166,John,Tavares,1990-09-20,C,L,2010-11,79,29,38,67,0.85,-16,243,11.93,53,91245.0,19:15,693,626,1319,52.54,22,23,75,51,24,9,15,24,16595.0,3:30,0,0,0,797.0,0:10,900000
8475167,Victor,Hedman,1990-12-18,D,L,2010-11,79,3,23,26,0.33,3,101,2.97,70,99582.0,21:0,0,0,0,0.0,54,85,48,64,-16,0,3,3,7784.0,1:38,0,0,0,9640.0,2:2,900000
8475168,Matt,Duchene,1991-01-16,C,L,2010-11,80,27,40,67,0.84,-8,202,13.37,33,90935.0,18:56,628,618,1246,50.4,57,48,65,52,13,3,12,15,13677.0,2:50,0,0,0,349.0,0:4,900000
8475169,Evander,Kane,1991-08-02,LW,L,2010-11,73,19,24,43,0.59,-12,234,8.12,68,78237.0,17:51,26,38,64,40.62,154,32,53,39,14,4,4,8,10133.0,2:18,0,0,0,3661.0,0:50,900000
8475170,Brayden,Schenn,1991-08-22,C,L,2010-11,8,0,2,2,0.25,-1,11,0.0,0,5399.0,11:14,17,34,51,33.33,12,1,0,2,-2,0,0,0,759.0,1:34,0,0,0,63.0,0:7,900000
8475171,Oliver,Ekman-Larsson,1991-07-17,D,L,2010-11,48,1,10,11,0.23,3,50,2.0,24,43302.0,15:2,0,0,0,0.0,41,31,3,13,-10,0,2,2,2857.0,0:59,0,0,0,2666.0,0:55,900000
8475172,Nazem,Kadri,1990-10-06,C,L,2010-11,29,3,9,12,0.41,-3,51,5.88,8,27449.0,15:46,49,72,121,40.5,16,6,15,26,-11,0,2,2,4498.0,2:35,0,0,0,9.0,0:0,870000
8475175,Magnus,Paajarvi,1991-04-12,LW,L,2010-11,80,15,19,34,0.42,-13,180,8.33,16,73865.0,15:23,1,4,5,20.0,22,25,25,35,-10,3,6,9,8838.0,1:50,0,0,0,127.0,0:1,900000
8475179,Dmitry,Kulikov,1990-10-29,D,L,2010-11,72,6,20,26,0.36,-5,83,7.23,45,86186.0,19:57,0,0,0,0.0,107,79,18,38,-20,1,4,5,11279.0,2:36,0,0,0,3771.0,0:52,900000
8475181,Nick,Leddy,1991-03-20,D,L,2010-11,46,4,3,7,0.15,-3,37,10.81,4,39502.0,14:18,0,0,0,0.0,26,46,10,15,-5,0,1,1,564.0,0:12,0,0,0,872.0,0:18,900000
8475185,Jacob,Josefson,1991-03-02,C,L,2010-11,28,3,7,10,0.36,5,31,9.68,6,22238.0,13:14,95,107,202,47.03,8,8,8,7,1,0,3,3,2946.0,1:45,0,0,0,34.0,0:1,900000
8475193,Tomas,Tatar,1990-12-01,LW,L,2010-11,9,1,0,1,0.11,0,6,16.67,0,5185.0,9:36,0,0,0,0.0,7,0,2,2,0,0,0,0,61.0,0:6,0,0,0,0.0,0:0,660000
8475204,Brandon,Pirri,1991-04-10,RW,L,2010-11,1,0,0,0,0.0,-1,1,0.0,0,536.0,8:56,2,4,6,33.33,0,1,0,0,0,0,0,0,0.0,0:0,0,0,0,0.0,0:0,648333
8475214,Jeremy,Morin,1991-04-16,LW,R,2010-11,9,2,1,3,0.33,2,13,15.38,9,6532.0,12:5,0,0,0,0.0,12,2,3,3,0,0,1,1,1058.0,1:57,0,0,0,0.0,0:0,765000
8475248,Alexander,Urbom,1990-12-20,D,L,2010-11,8,1,0,1,0.12,-2,5,20.0,0,6038.0,12:34,0,0,0,0.0,5,6,1,5,-4,0,0,0,89.0,0:11,0,0,0,138.0,0:17,576667
8475266,Tomas,Vincour,1990-11-19,C,R,2010-11,24,1,1,2,0.08,-5,26,3.85,4,13575.0,9:25,3,1,4,75.0,36,11,4,3,1,0,0,0,206.0,0:8,0,0,0,10.0,0:0,621667
8475304,Scott,Timmins,1989-09-11,C,L,2010-11,19,1,0,1,0.05,-8,13,7.69,8,12332.0,10:49,61,69,130,46.92,18,11,7,4,3,0,0,0,20.0,0:1,0,0,0,2201.0,1:55,581667
8475323,Marcus,Kruger,1990-05-27,C,L,2010-11,7,0,0,0,0.0,-4,7,0.0,4,5023.0,11:57,14,25,39,35.9,4,2,3,3,0,0,0,0,39.0,0:5,0,0,0,364.0,0:52,735000
8475602,Casey,Wellman,1987-10-18,C,R,2010-11,15,1,1,2,0.13,-1,20,5.0,4,9579.0,10:38,8,8,16,50.0,5,3,3,3,0,0,0,0,871.0,0:58,0,0,0,75.0,0:5,900000
8475613,Nate,Prosser,1986-05-07,D,R,2010-11,2,0,0,0,0.0,0,1,0.0,0,1776.0,14:48,0,0,0,0.0,0,2,0,0,0,0,0,0,8.0,0:4,0,0,0,0.0,0:0,650000
8475619,Aaron,Volpatti,1985-05-30,LW,L,2010-11,15,1,1,2,0.13,-1,6,16.67,16,6148.0,6:49,0,0,0,0.0,36,3,0,0,0,0,0,0,286.0,0:19,0,0,0,1.0,0:0,612500
8475637,Bobby,Butler,1987-04-26,RW,R,2010-11,36,10,11,21,0.58,-16,73,13.7,10,33327.0,15:25,0,2,2,0.0,28,15,9,13,-4,1,4,5,4775.0,2:12,0,0,0,33.0,0:0,900000
8475690,Christopher,Tanev,1989-12-20,D,R,2010-11,29,0,1,1,0.03,0,15,0.0,0,23996.0,13:47,0,0,0,0.0,10,32,10,8,2,0,1,1,116.0,0:4,0,0,0,990.0,0:34,900000
8475692,Mats,Zuccarello,1987-09-01,RW,L,2010-11,42,6,17,23,0.55,3,74,8.11,4,35714.0,14:10,8,7,15,53.33,56,19,16,6,10,0,9,9,6402.0,2:32,0,0,0,2.0,0:0,900000
8475764,Cam,Fowler,1991-12-05,D,L,2010-11,76,10,30,40,0.53,-25,123,8.13,20,100913.0,22:7,0,0,0,0.0,45,93,23,41,-18,6,17,23,16553.0,3:37,0,0,0,1689.0,0:22,900000
8475784,Jeff,Skinner,1992-05-16,LW,L,2010-11,82,31,32,63,0.77,3,215,14.42,46,82319.0,16:43,58,99,157,36.94,70,28,63,31,32,6,12,18,15615.0,3:10,0,0,0,152.0,0:1,900000
8475788,Alexander,Burmistrov,1991-10-21,C,L,2010-11,74,6,14,20,0.27,-12,92,6.52,27,58684.0,13:13,289,407,696,41.52,62,22,48,34,14,0,0,0,1366.0,0:18,0,1,1,5081.0,1:8,900000
8475791,Taylor,Hall,1991-11-14,LW,L,2010-11,65,22,20,42,0.65,-9,186,11.83,27,71018.0,18:12,42,63,105,40.0,48,37,45,45,0,8,3,11,10648.0,2:43,0,0,0,126.0,0:1,900000
8475794,Tyler,Seguin,1992-01-31,C,R,2010-11,74,11,11,22,0.3,-4,131,8.4,18,54212.0,12:12,150,153,303,49.5,20,21,22,24,-2,1,2,3,6049.0,1:21,0,0,0,118.0,0:1,900000
8475799,Nino,Niederreiter,1992-09-08,RW,L,2010-11,9,1,1,2,0.22,-1,12,8.33,8,7340.0,13:35,0,0,0,0.0,16,1,5,5,0,0,0,0,498.0,0:55,0,0,0,11.0,0:1,900000
8476205,Stephane,Da Costa,1989-07-11,C,R,2010-11,4,0,0,0,0.0,-1,9,0.0,0,2739.0,11:24,6,15,21,28.57,3,0,7,1,6,0,0,0,260.0,1:5,0,0,0,0.0,0:0,900000
8448208,Jaromir,Jagr,1972-02-15,RW,L,2011-12,73,19,35,54,0.74,5,170,11.18,30,71569.0,16:20,0,1,1,0.0,14,12,22,43,-21,8,12,20,14260.0,3:15,0,0,0,70.0,0:0,3300000
8457063,Nicklas,Lidstrom,1970-04-28,D,L,2011-12,70,11,23,34,0.49,21,148,7.43,28,99837.0,23:46,0,0,0,0.0,41,79,27,23,4,4,13,17,15513.0,3:41,0,0,0,7127.0,1:41,6200000
8457981,Teemu,Selanne,1970-07-03,RW,R,2011-12,82,26,40,66,0.8,-1,210,12.38,50,87980.0,17:52,145,155,300,48.33,23,20,29,46,-17,12,16,28,17584.0,3:34,0,0,0,276.0,0:3,4000000
8458525,Brian,Rolston,1973-02-21,RW,L,2011-12,70,7,17,24,0.34,-5,151,4.64,14,59978.0,14:16,37,40,77,48.05,86,21,18,23,-5,1,3,4,7917.0,1:53,0,0,0,2254.0,0:32,5062500
8458537,Ray,Whitney,1972-05-08,LW,R,2011-12,82,24,53,77,0.94,26,185,12.97,28,91738.0,18:38,4,11,15,26.67,28,10,34,39,-5,8,12,20,18581.0,3:46,0,0,0,120.0,0:1,3000000
8458951,Sergei,Gonchar,1974-04-13,D,L,2011-12,74,5,32,37,0.5,-4,131,3.82,55,98803.0,22:15,0,0,0,0.0,48,115,22,51,-29,2,12,14,13782.0,3:6,0,1,1,8124.0,1:49,5500000
8459424,Chris,Pronger,1974-10-10,D,L,2011-12,13,1,11,12,0.92,1,23,4.35,10,17531.0,22:28,0,0,0,0.0,15,27,7,7,0,1,7,8,3115.0,3:59,0,0,0,3712.0,4:45,4935714
8459429,Jason,Arnott,1974-10-11,C,R,2011-12,72,17,17,34,0.47,13,142,11.97,26,60867.0,14:5,387,382,769,50.33,24,13,17,11,6,6,8,14,10213.0,2:21,0,0,0,44.0,0:0,2500000
8459444,Todd,Bertuzzi,1975-02-02,RW,L,2011-12,71,14,24,38,0.54,23,118,11.86,64,66253.0,15:33,5,8,13,38.46,96,23,21,40,-19,0,4,4,7223.0,1:41,0,0,0,34.0,0:0,1937500
8459454,Jay,Pandolfo,1974-12-27,LW,L,2011-12,62,1,2,3,0.05,-14,44,2.27,8,40632.0,10:55,61,75,136,44.85,48,69,14,10,4,0,0,0,172.0,0:2,0,1,1,6590.0,1:46,600000
8459457,Jamie,Langenbrunner,1975-07-24,RW,R,2011-12,70,6,18,24,0.34,7,127,4.72,32,61384.0,14:36,10,17,27,37.04,70,19,15,10,5,0,0,0,3690.0,0:52,0,0,0,4569.0,1:5,2500000
8459514,Jamal,Mayers,1974-10-24,RW,R,2011-12,81,6,9,15,0.19,-4,70,8.57,91,47635.0,9:48,313,245,558,56.09,102,25,23,17,6,0,1,1,1410.0,0:17,0,0,0,6481.0,1:20,550000
8459628,Hal,Gill,1975-04-06,D,L,2011-12,76,1,12,13,0.17,-3,49,2.04,37,78141.0,17:8,0,0,0,0.0,75,161,20,62,-42,0,0,0,85.0,0:1,0,2,2,15827.0,3:28,2250000
8459670,Kimmo,Timonen,1975-03-18,D,L,2011-12,76,4,39,43,0.57,8,130,3.08,46,96846.0,21:14,1,0,1,100.0,68,129,14,35,-21,4,17,21,17275.0,3:47,0,0,0,15872.0,3:28,6333333
8460492,Ed,Jovanovski,1976-06-26,D,L,2011-12,66,3,10,13,0.2,-11,58,5.17,31,66111.0,16:41,0,0,0,0.0,71,73,15,38,-23,1,3,4,6718.0,1:41,0,0,0,6106.0,1:32,4125000
8460496,Ryan,Smyth,1976-02-21,LW,L,2011-12,82,19,27,46,0.56,-5,194,9.79,82,93885.0,19:4,66,84,150,44.0,53,31,54,51,3,4,4,8,12188.0,2:28,0,0,0,10617.0,2:9,6250000
8460542,Patrik,Elias,1976-04-13,C,L,2011-12,81,26,52,78,0.96,-8,164,15.85,16,96486.0,19:51,604,765,1369,44.12,61,26,32,50,-18,8,21,29,16894.0,3:28,2,2,4,8620.0,1:46,6000000
8460561,Sheldon,Souray,1976-07-13,D,L,2011-12,64,6,15,21,0.33,11,179,3.35,73,78577.0,20:27,0,0,0,0.0,55,90,23,33,-10,2,4,6,6970.0,1:48,1,0,1,9235.0,2:24,5400000
8460621,Daniel,Alfredsson,1972-12-11,RW,R,2011-12,75,27,32,59,0.79,16,191,14.14,18,85249.0,18:56,20,26,46,43.48,52,31,50,58,-8,7,7,14,13367.0,2:58,3,1,4,5826.0,1:17,4875000
8460626,Bryce,Salvador,1976-02-11,D,L,2011-12,82,0,9,9,0.11,18,52,0.0,66,99440.0,20:12,0,0,0,0.0,106,107,20,44,-24,0,0,0,188.0,0:2,0,1,1,15168.0,3:4,2900000
8460719,Steve,Sullivan,1974-07-06,LW,R,2011-12,79,17,31,48,0.61,-3,140,12.14,20,72802.0,15:21,4,5,9,44.44,38,16,17,22,-5,5,16,21,17279.0,3:38,0,0,0,3.0,0:0,1500000
8460720,Eric,Boulton,1976-08-17,LW,L,2011-12,51,0,0,0,0.0,-12,25,0.0,115,20150.0,6:35,1,2,3,33.33,89,10,1,6,-5,0,0,0,61.0,0:1,0,0,0,61.0,0:1,662500
8462038,Shane,Doan,1976-10-10,RW,R,2011-12,79,22,28,50,0.63,-8,226,9.73,48,92907.0,19:36,33,26,59,55.93,205,27,48,30,18,5,9,14,15140.0,3:11,0,1,1,4178.0,0:52,4550000
8462042,Jarome,Iginla,1977-07-01,RW,R,2011-12,82,32,35,67,0.82,-10,251,12.75,43,101390.0,20:36,214,212,426,50.23,124,43,52,58,-6,8,11,19,16408.0,3:20,0,0,0,97.0,0:1,7000000
8462129,Michal,Handzus,1977-03-11,C,L,2011-12,67,7,17,24,0.36,-6,81,8.64,18,58097.0,14:27,413,402,815,50.67,52,59,28,24,4,2,3,5,4394.0,1:5,0,0,0,5490.0,1:21,2500000
8462196,Stephane,Robidas,1977-03-03,D,R,2011-12,75,5,17,22,0.29,-5,75,6.67,48,102429.0,22:45,0,0,0,0.0,191,110,23,25,-2,2,7,9,11659.0,2:35,0,0,0,13248.0,2:56,3300000
8462225,Filip,Kuba,1976-12-29,D,L,2011-12,73,6,26,32,0.44,26,78,7.69,26,103428.0,23:36,0,0,0,0.0,53,149,23,66,-43,3,8,11,8666.0,1:58,0,2,2,14839.0,3:23,3700000
8462535,Jody,Shelley,1976-02-07,LW,L,2011-12,30,0,1,1,0.03,-6,19,0.0,64,10178.0,5:39,0,2,2,0.0,49,6,4,2,2,0,0,0,222.0,0:7,0,0,0,1.0,0:0,1100000
8464956,Chris,Phillips,1978-03-09,D,L,2011-12,80,5,14,19,0.24,12,85,5.88,16,91721.0,19:6,0,0,0,0.0,134,137,18,50,-32,4,0,4,2911.0,0:36,0,2,2,14623.0,3:2,3083333
8464966,Derek,Morris,1978-08-24,D,R,2011-12,59,2,9,11,0.19,-12,72,2.78,38,67221.0,18:59,0,0,0,0.0,95,78,12,20,-8,0,1,1,1639.0,0:27,0,0,0,9345.0,2:38,2750000
8464967,Marty,Reasoner,1977-02-26,C,L,2011-12,61,1,5,6,0.1,-25,69,1.45,34,42491.0,11:36,303,269,572,52.97,43,31,25,15,10,0,0,0,277.0,0:4,0,0,0,4805.0,1:18,1350000
8464975,Daniel,Briere,1977-10-06,C,R,2011-12,70,16,33,49,0.7,5,174,9.2,69,72911.0,17:21,406,425,831,48.86,48,16,18,32,-14,4,13,17,13507.0,3:12,0,0,0,240.0,0:3,6500000
8464977,Dainius,Zubrus,1978-06-16,C,L,2011-12,82,17,27,44,0.54,7,109,15.6,34,91947.0,18:41,191,250,441,43.31,102,41,34,23,11,4,2,6,8860.0,1:48,3,2,5,9912.0,2:0,3400000
8464989,Matt,Cullen,1976-11-02,C,L,2011-12,73,14,21,35,0.48,-10,164,8.54,24,82929.0,18:56,627,551,1178,53.23,46,39,37,31,6,4,5,9,11747.0,2:40,0,0,0,7833.0,1:47,3500000
8465009,Zdeno,Chara,1977-03-18,D,L,2011-12,79,12,40,52,0.66,33,224,5.36,86,118524.0,25:0,0,1,1,0.0,166,87,28,68,-40,8,10,18,12604.0,2:39,0,1,1,12888.0,2:43,6916667
8465042,Toni,Lydman,1977-09-25,D,L,2011-12,74,0,13,13,0.18,0,46,0.0,46,83921.0,18:54,0,0,0,0.0,134,153,13,35,-22,0,0,0,177.0,0:2,0,1,1,13869.0,3:7,3000000
8465050,Eric,Belanger,1977-12-16,C,L,2011-12,78,4,12,16,0.21,-13,118,3.39,32,68954.0,14:44,557,450,1007,55.31,36,41,50,38,12,1,4,5,5019.0,1:4,1,0,1,11546.0,2:28,1750000
8465058,Michal,Rozsival,1978-09-03,D,R,2011-12,54,1,12,13,0.24,8,49,2.04,34,62627.0,19:19,0,0,0,0.0,62,91,13,16,-3,0,0,0,243.0,0:4,0,0,0,6116.0,1:53,5000000
8465059,Matt,Bradley,1978-06-13,RW,R,2011-12,45,3,5,8,0.18,-3,35,8.57,31,29359.0,10:52,12,16,28,42.86,134,11,7,2,5,0,0,0,371.0,0:8,0,0,0,1098.0,0:24,950000
8465166,Craig,Adams,1977-04-26,RW,R,2011-12,82,5,13,18,0.22,-6,76,6.58,34,55521.0,11:17,132,160,292,45.21,162,45,13,7,6,0,0,0,68.0,0:0,0,3,3,14093.0,2:51,675000
8465185,Willie,Mitchell,1977-04-23,D,L,2011-12,76,5,19,24,0.32,20,104,4.81,44,101366.0,22:13,0,1,1,0.0,74,139,21,55,-34,0,5,5,3256.0,0:42,0,3,3,16353.0,3:35,3500000
8465192,Samuel,Pahlsson,1977-12-17,C,L,2011-12,80,4,13,17,0.21,-2,93,4.3,34,70913.0,14:46,540,486,1026,52.63,123,37,44,14,30,0,0,0,502.0,0:6,1,1,2,10385.0,2:9,2650000
8465200,Tomas,Kaberle,1978-03-02,D,L,2011-12,72,3,28,31,0.43,-18,87,3.45,12,76550.0,17:43,0,0,0,0.0,21,80,18,38,-20,1,15,16,16371.0,3:47,0,0,0,456.0,0:6,4250000
8465202,Sami,Salo,1974-09-02,D,R,2011-12,69,9,16,25,0.36,7,136,6.62,10,84654.0,20:26,0,0,0,0.0,29,77,23,35,-12,7,7,14,11403.0,2:45,0,0,0,9627.0,2:19,2000000
8465210,Pavel,Kubina,1977-04-15,D,R,2011-12,69,3,12,15,0.22,-2,75,4.0,74,79783.0,19:16,0,0,0,0.0,130,119,18,26,-8,0,0,0,4643.0,1:7,0,0,0,7126.0,1:43,3850000
8465914,Francis,Bouillon,1975-10-17,D,L,2011-12,66,4,7,11,0.17,-4,38,10.53,33,69482.0,17:32,0,0,0,0.0,103,65,23,29,-6,0,0,0,1273.0,0:19,0,0,0,3016.0,0:45,1350000
8465951,Matt,Cooke,1978-09-07,LW,L,2011-12,82,19,19,38,0.46,5,147,12.93,44,77145.0,15:40,18,15,33,54.55,160,41,37,23,14,1,5,6,5833.0,1:11,2,2,4,12509.0,2:32,1800000
8465978,Shawn,Thornton,1977-07-23,LW,R,2011-12,81,5,8,13,0.16,-7,114,4.39,154,44629.0,9:10,16,22,38,42.11,91,12,19,6,13,0,0,0,290.0,0:3,1,0,1,100.0,0:1,812500
8466138,Joe,Thornton,1979-07-02,C,L,2011-12,82,18,59,77,0.94,17,156,11.54,31,100709.0,20:28,557,436,993,56.09,42,26,96,95,1,4,19,23,16645.0,3:22,0,1,1,5192.0,1:3,7000000
8466139,Patrick,Marleau,1979-09-15,C,L,2011-12,82,30,34,64,0.78,10,251,11.95,26,100766.0,20:28,243,224,467,52.03,84,33,38,45,-7,10,15,25,15678.0,3:11,0,0,0,7271.0,1:28,6900000
8466140,Olli,Jokinen,1978-12-05,C,L,2011-12,82,23,38,61,0.74,-12,223,10.31,54,93284.0,18:57,620,713,1333,46.51,53,31,55,60,-5,9,15,24,15260.0,3:6,0,0,0,2012.0,0:24,3000000
8466142,Eric,Brewer,1979-04-17,D,L,2011-12,82,1,20,21,0.26,-5,83,1.2,49,114479.0,23:16,0,0,0,0.0,197,176,26,37,-11,0,3,3,5473.0,1:6,0,1,1,15919.0,3:14,3875000
8466148,Marian,Hossa,1979-01-12,RW,L,2011-12,81,29,48,77,0.95,18,248,11.69,20,97028.0,19:57,3,6,9,33.33,73,40,94,29,65,9,11,20,15368.0,3:9,2,1,3,8733.0,1:47,5275000
8466149,Daniel,Cleary,1978-12-18,RW,L,2011-12,75,12,21,33,0.44,2,199,6.03,30,71918.0,15:58,21,30,51,41.18,90,33,27,27,0,2,1,3,5990.0,1:19,0,0,0,7727.0,1:43,2800000
8466158,Scott,Hannan,1979-01-23,D,L,2011-12,78,2,10,12,0.15,-10,49,4.08,38,95264.0,20:21,1,0,1,100.0,60,126,13,39,-26,0,0,0,352.0,0:4,0,1,1,13329.0,2:50,1000000
8466160,Brenden,Morrow,1979-01-16,LW,L,2011-12,57,11,15,26,0.46,1,88,12.5,97,58272.0,17:2,11,16,27,40.74,130,33,18,41,-23,5,2,7,8502.0,2:29,0,0,0,1366.0,0:23,4100000
8466215,Joe,Corvo,1977-06-20,D,R,2011-12,75,4,21,25,0.33,10,168,2.38,13,84644.0,18:48,0,0,0,0.0,27,56,14,32,-18,1,8,9,10835.0,2:24,0,0,0,1404.0,0:18,2250000
8466251,Jason,Chimera,1979-05-02,LW,L,2011-12,82,20,19,39,0.48,4,205,9.76,78,71010.0,14:25,30,32,62,48.39,132,27,23,26,-3,1,0,1,4359.0,0:53,2,0,2,4495.0,0:54,1875000
8466285,Brian,Campbell,1979-05-23,D,L,2011-12,82,4,49,53,0.65,-9,131,3.05,6,132331.0,26:53,0,0,0,0.0,46,118,29,46,-17,1,30,31,20381.0,4:8,0,0,0,6299.0,1:16,7142875
8466333,Andrew,Ference,1979-03-17,D,L,2011-12,72,6,18,24,0.33,9,107,5.61,46,81597.0,18:53,1,0,1,100.0,68,81,7,38,-31,0,2,2,2766.0,0:38,0,1,1,8295.0,1:55,2250000
8466371,John,Madden,1973-05-04,C,L,2011-12,31,3,0,3,0.1,-4,33,9.09,4,22288.0,11:58,155,158,313,49.52,23,12,19,4,15,0,0,0,147.0,0:4,0,0,0,2095.0,1:7,600000
8466378,Martin,St. Louis,1975-06-18,RW,L,2011-12,77,25,49,74,0.96,-3,185,13.51,16,104563.0,22:37,18,23,41,43.9,17,39,66,53,13,4,12,16,17439.0,3:46,0,0,0,1976.0,0:25,5625000
8466393,Pascal,Dupuis,1979-04-07,RW,L,2011-12,82,25,34,59,0.72,18,214,11.68,34,83289.0,16:55,51,64,115,44.35,111,44,25,18,7,0,1,1,1947.0,0:23,3,0,3,11217.0,2:16,1500000
8466398,Tom,Kostopoulos,1979-01-24,RW,R,2011-12,81,4,8,12,0.15,-15,91,4.4,57,59892.0,12:19,25,59,84,29.76,124,48,29,23,6,1,0,1,517.0,0:6,1,0,1,7069.0,1:27,916667
8467096,Dan,Boyle,1976-07-12,D,R,2011-12,81,9,39,48,0.59,10,252,3.57,57,124334.0,25:34,0,0,0,0.0,58,137,21,66,-45,3,14,17,19121.0,3:56,0,0,0,7291.0,1:30,6666666
8467304,Andy,Sutton,1975-03-10,D,L,2011-12,52,3,7,10,0.19,5,41,7.32,80,52054.0,16:41,0,0,0,0.0,112,95,14,49,-35,0,0,0,89.0,0:1,0,0,0,5517.0,1:46,2062500
8467329,Vincent,Lecavalier,1980-04-21,C,L,2011-12,64,22,27,49,0.77,-2,182,12.09,50,72696.0,18:55,556,606,1162,47.85,103,31,24,34,-10,5,6,11,13058.0,3:24,0,0,0,702.0,0:10,7727272
8467330,David,Legwand,1980-08-17,C,L,2011-12,78,19,34,53,0.68,3,140,13.57,26,86678.0,18:31,512,597,1109,46.17,31,29,46,43,3,5,14,19,10522.0,2:14,0,1,1,5983.0,1:16,4500000
8467331,Brad,Stuart,1979-11-06,D,L,2011-12,81,6,15,21,0.26,16,96,6.25,29,102326.0,21:3,0,0,0,0.0,177,115,22,27,-5,1,0,1,1501.0,0:18,1,0,1,15436.0,3:10,3750000
8467332,Bryan,Allen,1980-08-21,D,L,2011-12,82,1,13,14,0.17,-1,87,1.15,76,94269.0,19:9,0,0,0,0.0,111,188,22,36,-14,0,0,0,617.0,0:7,0,1,1,12381.0,2:30,2900000
8467334,Manny,Malhotra,1980-05-18,C,L,2011-12,78,7,11,18,0.23,-11,60,11.67,14,57780.0,12:20,536,380,916,58.52,44,45,22,22,0,0,0,0,346.0,0:4,0,0,0,11295.0,2:24,2500000
8467336,Mike,Rupp,1980-01-13,LW,L,2011-12,60,4,1,5,0.08,-1,31,12.9,97,23928.0,6:38,19,15,34,55.88,103,13,3,9,-6,0,0,0,677.0,0:11,0,0,0,32.0,0:0,1333333
8467338,Alex,Tanguay,1979-11-21,LW,L,2011-12,64,13,36,49,0.77,7,84,15.48,28,73135.0,19:2,25,42,67,37.31,22,47,35,54,-19,1,14,15,12468.0,3:14,1,1,2,5200.0,1:21,3500000
8467344,Robyn,Regehr,1980-04-19,D,L,2011-12,76,1,4,5,0.07,-12,49,2.04,56,84933.0,18:37,0,0,0,0.0,172,112,11,28,-17,0,0,0,205.0,0:2,0,0,0,12179.0,2:40,4020000
8467346,Simon,Gagne,1980-02-29,LW,L,2011-12,34,7,10,17,0.5,-1,75,9.33,18,36697.0,17:59,2,5,7,28.57,17,10,8,24,-16,0,4,4,6286.0,3:4,1,0,1,2411.0,1:10,3500000
8467351,Scott,Gomez,1979-12-23,C,L,2011-12,38,2,9,11,0.29,-9,59,3.39,14,32225.0,14:8,165,168,333,49.55,11,12,14,14,0,2,1,3,5339.0,2:20,0,0,0,139.0,0:3,7357143
8467365,John,Erskine,1980-06-26,D,L,2011-12,28,0,2,2,0.07,3,20,0.0,51,20325.0,12:5,0,0,0,0.0,39,27,4,8,-4,0,0,0,31.0,0:1,0,1,1,888.0,0:31,1500000
8467370,Mike,Fisher,1980-06-05,C,R,2011-12,72,24,27,51,0.71,11,157,15.29,33,83362.0,19:17,588,629,1217,48.32,116,76,44,34,10,5,9,14,9814.0,2:16,0,1,1,5435.0,1:15,4200000
8467371,Mike,Ribeiro,1980-02-10,C,L,2011-12,74,18,45,63,0.85,5,142,12.68,66,89011.0,20:2,341,467,808,42.2,113,46,39,64,-25,2,13,15,12691.0,2:51,0,0,0,4299.0,0:58,5000000
8467389,Brad,Richards,1980-05-02,C,L,2011-12,82,25,41,66,0.8,-1,229,10.92,22,99705.0,20:15,682,634,1316,51.82,51,49,47,46,1,7,17,24,20486.0,4:9,0,0,0,844.0,0:10,6666666
8467396,Erik,Cole,1978-11-06,LW,L,2011-12,82,35,26,61,0.74,11,241,14.52,48,91166.0,18:31,24,32,56,42.86,186,30,39,36,3,11,3,14,16064.0,3:15,0,0,0,716.0,0:8,4500000
8467400,Francois,Beauchemin,1980-06-04,D,L,2011-12,82,8,14,22,0.27,-14,139,5.76,48,125723.0,25:33,1,1,2,50.0,154,194,30,47,-17,3,2,5,7300.0,1:29,0,1,1,20797.0,4:13,3800000
8467407,Brian,Gionta,1979-01-18,RW,R,2011-12,31,8,7,15,0.48,-7,75,10.67,16,36149.0,19:26,14,19,33,42.42,35,13,15,13,2,2,1,3,5403.0,2:54,0,0,0,3878.0,2:5,5000000
8467408,Matt,Walker,1980-04-07,D,R,2011-12,4,0,0,0,0.0,-2,2,0.0,16,2631.0,10:57,0,0,0,0.0,1,5,2,1,1,0,0,0,6.0,0:1,0,0,0,30.0,0:7,1700000
8467412,Alexei,Ponikarovsky,1980-04-09,LW,L,2011-12,82,14,19,33,0.4,-3,156,8.97,34,72554.0,14:44,4,8,12,33.33,143,36,33,19,14,4,3,7,6584.0,1:20,0,0,0,1242.0,0:15,1500000
8467423,Shawn,Horcoff,1978-09-17,C,L,2011-12,81,13,21,34,0.42,-23,123,10.57,24,95186.0,19:35,728,747,1475,49.36,62,47,46,48,-2,5,8,13,13934.0,2:52,0,0,0,12920.0,2:39,5500000
8467428,Krys,Barch,1980-03-26,RW,L,2011-12,51,2,3,5,0.1,0,24,8.33,114,22491.0,7:21,2,5,7,28.57,67,10,5,5,0,0,0,0,81.0,0:1,0,0,0,42.0,0:0,837500
8467439,Jaroslav,Spacek,1974-02-11,D,L,2011-12,46,5,10,15,0.33,6,42,11.9,8,44391.0,16:5,0,0,0,0.0,29,68,14,18,-4,3,2,5,4600.0,1:40,0,0,0,1698.0,0:36,3833333
8467452,Rob,Scuderi,1978-12-30,D,L,2011-12,82,1,8,9,0.11,-7,63,1.59,16,101403.0,20:36,0,0,0,0.0,61,116,17,52,-35,0,0,0,481.0,0:5,0,0,0,12992.0,2:38,3400000
8467463,Mikael,Samuelsson,1976-12-23,RW,R,2011-12,54,14,17,31,0.57,1,138,10.14,20,51670.0,15:56,12,21,33,36.36,79,11,23,15,8,7,6,13,8307.0,2:33,0,0,0,165.0,0:3,2500000
8467466,Trent,Hunter,1980-07-05,RW,R,2011-12,38,2,5,7,0.18,-4,51,3.92,8,23025.0,10:5,4,20,24,16.67,72,6,3,7,-4,0,1,1,1935.0,0:50,0,0,0,21.0,0:0,2000000
8467478,Kent,Huskins,1979-05-04,D,L,2011-12,25,2,5,7,0.28,9,16,12.5,10,23202.0,15:28,0,0,0,0.0,6,35,0,11,-11,0,0,0,330.0,0:13,0,0,0,1101.0,0:44,1000000
8467493,Chris,Neil,1979-06-18,RW,R,2011-12,72,13,15,28,0.39,-10,127,10.24,178,55263.0,12:47,0,2,2,0.0,271,20,21,20,1,2,4,6,7375.0,1:42,0,0,0,0.0,0:0,2000000
8467496,Andrei,Markov,1978-12-20,D,L,2011-12,13,0,3,3,0.23,-4,17,0.0,4,14046.0,18:0,0,0,0,0.0,7,7,2,1,1,0,2,2,2914.0,3:44,0,0,0,377.0,0:29,5750000
8467514,Pavel,Datsyuk,1978-07-20,C,L,2011-12,70,19,48,67,0.96,21,164,11.59,14,82188.0,19:34,702,547,1249,56.2,76,31,97,40,57,4,19,23,12928.0,3:4,0,0,0,5129.0,1:13,6700000
8467545,Michael,Ryder,1980-03-31,RW,R,2011-12,82,35,27,62,0.76,17,211,16.59,46,85519.0,17:22,34,37,71,47.89,86,50,48,39,9,7,3,10,13142.0,2:40,0,0,0,124.0,0:1,3500000
8467831,Jeff,Halpern,1976-05-03,C,R,2011-12,69,4,12,16,0.23,-1,63,6.35,24,52197.0,12:36,365,260,625,58.4,55,44,22,6,16,0,0,0,432.0,0:6,0,0,0,7228.0,1:44,825000
8467844,Jason,Blake,1973-09-02,LW,L,2011-12,45,7,5,12,0.27,-4,109,6.42,6,38185.0,14:8,0,1,1,0.0,41,17,19,9,10,2,1,3,3915.0,1:27,0,0,0,23.0,0:0,4000000
8467875,Daniel,Sedin,1980-09-26,LW,L,2011-12,72,30,37,67,0.93,14,229,13.1,40,81281.0,18:48,6,13,19,31.58,21,15,28,25,3,10,15,25,15146.0,3:30,0,0,0,327.0,0:4,6100000
8467876,Henrik,Sedin,1980-09-26,C,L,2011-12,82,14,67,81,0.99,23,113,12.39,52,93913.0,19:5,652,650,1302,50.08,32,17,31,37,-6,8,19,27,18041.0,3:40,0,0,0,453.0,0:5,6100000
8467878,Tim,Connolly,1981-05-07,C,R,2011-12,70,13,23,36,0.51,-14,104,12.5,40,71418.0,17:0,383,403,786,48.73,29,76,32,41,-9,2,3,5,7875.0,1:52,0,0,0,7131.0,1:41,4750000
8467890,Barret,Jackman,1981-03-05,D,L,2011-12,81,1,12,13,0.16,20,82,1.22,57,100498.0,20:40,0,0,0,0.0,106,153,22,31,-9,0,0,0,253.0,0:3,0,0,0,16705.0,3:26,3625000
8467899,Martin,Havlat,1981-04-19,RW,L,2011-12,39,7,20,27,0.69,10,96,7.29,22,41237.0,17:37,0,7,7,0.0,6,14,19,25,-6,4,4,8,5173.0,2:12,0,1,1,1367.0,0:35,4250000
8467915,Mike,Commodore,1979-11-07,D,R,2011-12,30,0,2,2,0.07,7,23,0.0,38,22685.0,12:36,0,0,0,0.0,53,32,4,7,-3,0,0,0,74.0,0:2,0,0,0,1525.0,0:50,3750000
8467917,Jordan,Leopold,1980-08-03,D,L,2011-12,79,10,14,24,0.3,4,110,9.09,28,106037.0,22:22,0,0,0,0.0,54,128,14,40,-26,1,4,5,9476.0,1:59,0,0,0,11008.0,2:19,3000000
8467925,Adam,Hall,1980-08-14,RW,R,2011-12,57,2,5,7,0.12,-11,63,3.17,17,40581.0,11:51,276,188,464,59.48,89,30,12,6,6,0,0,0,208.0,0:3,0,0,0,9808.0,2:52,600000
8467928,Doug,Janik,1980-03-26,D,L,2011-12,9,0,1,1,0.11,2,6,0.0,6,7831.0,14:30,0,0,0,0.0,7,6,2,2,0,0,0,0,37.0,0:4,0,0,0,346.0,0:38,512500
8467931,Matt,Carkner,1980-11-03,D,R,2011-12,29,1,2,3,0.1,0,17,5.88,33,20721.0,11:54,0,0,0,0.0,58,26,3,6,-3,0,0,0,0.0,0:0,0,0,0,1563.0,0:53,700000
8467943,Niklas,Hagman,1979-12-05,LW,L,2011-12,71,9,14,23,0.32,-7,125,7.2,14,62099.0,14:34,8,12,20,40.0,49,29,20,17,3,2,0,2,2488.0,0:35,0,0,0,6321.0,1:29,3000000
8467967,Chris,Kelly,1980-11-11,C,L,2011-12,82,20,19,39,0.48,33,122,16.39,41,72498.0,14:44,419,390,809,51.79,79,56,35,15,20,1,0,1,989.0,0:12,2,0,2,8775.0,1:47,2125000
8467977,Brian,McGrattan,1981-09-02,RW,R,2011-12,30,0,2,2,0.07,-1,10,0.0,61,9576.0,5:19,0,0,0,0.0,29,3,4,1,3,0,0,0,25.0,0:0,0,0,0,0.0,0:0,600000
8467988,Ryan,Malone,1979-12-01,LW,L,2011-12,68,20,28,48,0.71,-11,144,13.89,82,72156.0,17:41,29,50,79,36.71,142,36,37,30,7,5,10,15,11949.0,2:55,1,0,1,2293.0,0:33,4500000
8468001,Derek,MacKenzie,1981-06-11,C,L,2011-12,66,7,7,14,0.21,4,61,11.48,40,41584.0,10:30,234,195,429,54.55,189,19,26,10,16,1,0,1,196.0,0:2,2,1,3,7093.0,1:47,600000
8468064,Martin,Erat,1981-08-29,RW,L,2011-12,71,19,39,58,0.82,12,107,17.76,30,78731.0,18:28,60,66,126,47.62,52,37,60,49,11,5,13,18,10061.0,2:21,1,0,1,4111.0,0:57,4500000
8468083,Henrik,Zetterberg,1980-10-09,C,L,2011-12,82,22,47,69,0.84,14,267,8.24,47,97609.0,19:50,548,567,1115,49.15,45,26,42,54,-12,3,11,14,15838.0,3:13,0,2,2,5293.0,1:4,6083333
8468085,Radim,Vrbata,1981-06-13,RW,R,2011-12,77,35,27,62,0.81,24,232,15.09,24,86128.0,18:38,27,40,67,40.3,57,16,37,24,13,9,8,17,14883.0,3:13,1,0,1,5870.0,1:16,3000000
8468095,George,Parros,1979-12-29,RW,R,2011-12,46,1,3,4,0.09,1,17,5.88,85,17606.0,6:22,0,0,0,0.0,57,16,5,8,-3,0,0,0,10.0,0:0,0,0,0,0.0,0:0,875000
8468101,Radek,Martinek,1976-08-31,D,R,2011-12,7,1,0,1,0.14,-3,10,10.0,0,8164.0,19:26,0,0,0,0.0,5,7,3,4,-1,0,0,0,220.0,0:31,0,0,0,1138.0,2:42,2200000
8468114,Douglas,Murray,1980-03-12,D,L,2011-12,60,0,4,4,0.07,3,71,0.0,31,66173.0,18:22,0,0,0,0.0,126,143,14,33,-19,0,0,0,427.0,0:7,0,0,0,6489.0,1:48,2500000
8468162,Jerred,Smithson,1979-02-04,C,R,2011-12,69,1,5,6,0.09,-5,37,2.7,34,48503.0,11:42,362,283,645,56.12,128,43,17,14,3,0,0,0,410.0,0:5,0,1,1,7852.0,1:53,800000
8468208,Joel,Ward,1980-12-02,RW,R,2011-12,73,6,12,18,0.25,12,79,7.59,20,54437.0,12:25,29,23,52,55.77,75,41,35,21,14,0,0,0,626.0,0:8,0,0,0,2761.0,0:37,3000000
8468213,Jim,Vandermeer,1980-02-21,D,L,2011-12,25,1,3,4,0.16,3,19,5.26,33,15622.0,10:24,0,0,0,0.0,14,10,6,7,-1,0,0,0,114.0,0:4,0,0,0,602.0,0:24,1000000
8468224,Sean,Avery,1980-04-10,LW,L,2011-12,15,3,0,3,0.2,2,15,20.0,21,6313.0,7:0,0,3,3,0.0,10,1,4,3,1,0,0,0,14.0,0:0,0,0,0,0.0,0:0,3875000
8468309,Mark,Streit,1977-12-11,D,L,2011-12,82,7,40,47,0.57,-27,149,4.7,46,115024.0,23:22,0,1,1,0.0,110,115,50,63,-13,3,20,23,18247.0,3:42,0,0,0,3493.0,0:42,4100000
8468434,Andy,McDonald,1977-08-25,LW,L,2011-12,25,10,12,22,0.88,4,64,15.62,2,27788.0,18:31,66,50,116,56.9,3,5,11,12,-1,3,3,6,4410.0,2:56,0,0,0,1962.0,1:18,4700000
8468478,Mike,Weaver,1978-05-02,D,R,2011-12,82,0,16,16,0.2,-2,51,0.0,14,100013.0,20:19,0,0,0,0.0,114,137,38,23,15,0,0,0,446.0,0:5,0,1,1,14422.0,2:55,900000
8468482,Dany,Heatley,1981-01-21,LW,L,2011-12,82,24,29,53,0.65,2,238,10.08,28,103046.0,20:56,36,31,67,53.73,70,45,33,33,0,8,11,19,16717.0,3:23,0,0,0,970.0,0:11,7500000
8468483,Marian,Gaborik,1982-02-14,RW,L,2011-12,82,41,35,76,0.93,15,276,14.86,34,96018.0,19:30,0,2,2,0.0,63,40,30,41,-11,10,11,21,17607.0,3:34,0,0,0,489.0,0:5,7500000
8468484,Rostislav,Klesla,1982-03-21,D,L,2011-12,65,3,10,13,0.2,13,87,3.45,54,75498.0,19:21,1,1,2,50.0,112,150,13,23,-10,0,0,0,223.0,0:3,0,0,0,10734.0,2:45,2975000
8468485,Raffi,Torres,1981-10-08,LW,L,2011-12,79,15,11,26,0.33,2,99,15.15,83,53886.0,11:22,7,8,15,46.67,128,21,18,22,-4,1,0,1,3867.0,0:48,0,0,0,11.0,0:0,1750000
8468486,Scott,Hartnell,1982-04-18,LW,L,2011-12,82,37,30,67,0.82,19,232,15.95,136,87462.0,17:46,20,43,63,31.75,188,37,27,42,-15,16,7,23,15801.0,3:12,0,0,0,434.0,0:5,4200000
8468493,Ron,Hainsey,1981-03-24,D,L,2011-12,56,0,10,10,0.18,9,57,0.0,23,70889.0,21:5,0,0,0,0.0,33,133,10,33,-23,0,1,1,2440.0,0:43,0,0,0,8645.0,2:34,4500000
8468498,Brooks,Orpik,1980-09-26,D,L,2011-12,73,2,16,18,0.25,19,44,4.55,61,98780.0,22:33,0,0,0,0.0,259,139,13,25,-12,0,0,0,265.0,0:3,0,1,1,14670.0,3:20,3750000
8468501,Anton,Volchenkov,1982-02-25,D,L,2011-12,72,2,9,11,0.15,3,63,3.17,34,77669.0,17:58,0,0,0,0.0,177,125,14,15,-1,0,0,0,146.0,0:2,0,1,1,13391.0,3:5,4250000
8468504,Brad,Boyes,1982-04-17,RW,R,2011-12,65,8,15,23,0.35,2,100,8.0,6,51351.0,13:10,126,141,267,47.19,29,24,18,26,-8,2,6,8,7744.0,1:59,0,0,0,328.0,0:5,4000000
8468505,Steve,Ott,1982-08-19,C,L,2011-12,74,11,28,39,0.53,5,108,10.19,156,81439.0,18:20,561,450,1011,55.49,278,27,26,25,1,4,4,8,8968.0,2:1,0,2,2,7772.0,1:45,2950000
8468508,Justin,Williams,1981-10-04,RW,R,2011-12,82,22,37,59,0.72,10,241,9.13,44,84385.0,17:9,11,14,25,44.0,36,37,32,62,-30,9,10,19,12910.0,2:37,0,0,0,673.0,0:8,3825000
8468509,Niklas,Kronwall,1981-01-12,D,L,2011-12,82,15,21,36,0.44,-2,141,10.64,38,112499.0,22:51,0,0,0,0.0,133,177,21,31,-10,7,7,14,13208.0,2:41,0,1,1,14189.0,2:53,3000000
8468513,Nick,Schultz,1982-08-25,D,L,2011-12,82,1,6,7,0.09,-12,51,1.96,40,96964.0,19:42,0,0,0,0.0,83,165,14,32,-18,1,0,1,1790.0,0:21,0,0,0,11917.0,2:25,3500000
8468515,Brad,Winchester,1981-03-01,LW,L,2011-12,67,6,4,10,0.15,-5,72,8.33,88,31386.0,7:48,20,13,33,60.61,78,13,13,13,0,0,0,0,632.0,0:9,0,0,0,78.0,0:1,725000
8468518,Tomas,Kopecky,1982-02-05,RW,L,2011-12,80,10,22,32,0.4,-8,143,6.99,32,82897.0,17:16,140,126,266,52.63,45,35,60,27,33,2,6,8,10250.0,2:8,0,0,0,9634.0,2:0,3000000
8468520,Kurtis,Foster,1981-11-24,D,R,2011-12,51,4,10,14,0.27,-13,85,4.71,35,48631.0,15:53,0,0,0,0.0,46,35,4,17,-13,2,9,11,9496.0,3:6,0,0,0,536.0,0:10,1800000
8468526,Jarret,Stoll,1982-06-24,C,R,2011-12,78,6,15,21,0.27,2,133,4.51,60,78051.0,16:40,662,542,1204,54.98,165,46,19,18,1,1,7,8,9650.0,2:3,0,0,0,9588.0,2:2,3600000
8468534,Andreas,Lilja,1975-07-13,D,L,2011-12,46,0,6,6,0.13,9,35,0.0,34,37777.0,13:41,0,0,0,0.0,61,72,8,17,-9,0,0,0,62.0,0:1,0,0,0,2523.0,0:54,737500
8468535,Antoine,Vermette,1982-07-20,C,L,2011-12,82,11,26,37,0.45,-13,149,7.38,28,84659.0,17:12,645,495,1140,56.58,124,48,44,34,10,4,5,9,10008.0,2:2,1,1,2,6857.0,1:23,3750000
8468542,Paul,Martin,1981-03-05,D,L,2011-12,73,2,25,27,0.37,9,93,2.15,18,100750.0,23:0,0,0,0,0.0,24,117,27,37,-10,0,4,4,7993.0,1:49,0,1,1,11440.0,2:36,5000000
8468575,Dominic,Moore,1980-08-03,C,L,2011-12,79,4,21,25,0.32,-18,103,3.88,54,73631.0,15:32,419,343,762,54.99,52,23,25,20,5,0,3,3,3950.0,0:50,1,0,1,7772.0,1:38,1100000
8468598,Lubomir,Visnovsky,1976-08-11,D,L,2011-12,68,6,21,27,0.4,7,112,5.36,47,84816.0,20:47,1,0,1,100.0,63,78,22,35,-13,1,9,10,14419.0,3:32,0,0,0,418.0,0:6,5600000
8468611,Matt,Hendricks,1981-06-17,C,L,2011-12,78,4,5,9,0.12,-6,97,4.12,95,56733.0,12:7,142,123,265,53.58,219,52,26,18,8,0,0,0,452.0,0:5,0,1,1,5701.0,1:13,825000
8468635,Travis,Moen,1982-04-06,LW,L,2011-12,48,9,7,16,0.33,-3,45,20.0,41,45262.0,15:42,5,7,12,41.67,75,41,13,13,0,0,0,0,393.0,0:8,1,0,1,6827.0,2:22,1500000
8468636,Greg,Zanon,1980-06-05,D,L,2011-12,56,3,5,8,0.14,3,41,7.32,18,59799.0,17:47,0,0,0,0.0,116,136,11,13,-2,0,0,0,207.0,0:3,0,0,0,5983.0,1:46,1933333
8468639,John-Michael,Liles,1980-11-25,D,L,2011-12,66,7,20,27,0.41,-14,106,6.6,20,84542.0,21:20,0,0,0,0.0,68,111,16,51,-35,4,9,13,12860.0,3:14,0,0,0,2136.0,0:32,4200000
8468660,Darcy,Hordichuk,1980-08-10,LW,L,2011-12,43,1,2,3,0.07,-3,27,3.7,64,11223.0,4:21,0,1,1,0.0,67,2,4,5,-1,0,0,0,3.0,0:0,0,0,0,0.0,0:0,825000
8468674,Deryk,Engelland,1982-04-03,D,R,2011-12,73,4,13,17,0.23,10,86,4.65,56,70730.0,16:8,0,0,0,0.0,174,77,9,18,-9,0,0,0,50.0,0:0,0,0,0,4507.0,1:1,566667
8468695,Matthew,Lombardi,1982-03-18,C,L,2011-12,62,8,10,18,0.29,-19,101,7.92,10,50471.0,13:34,151,155,306,49.35,58,34,16,16,0,0,0,0,1597.0,0:25,1,0,1,4677.0,1:15,3500000
8468700,Paul,Gaustad,1982-02-03,C,L,2011-12,70,7,14,21,0.3,-1,75,9.33,76,62022.0,14:46,659,491,1150,57.3,114,47,22,26,-4,0,0,0,342.0,0:4,0,1,1,11573.0,2:45,2300000
8468704,Antti,Miettinen,1980-07-03,RW,R,2011-12,45,5,8,13,0.29,-5,58,8.62,0,31609.0,11:42,9,12,21,42.86,38,11,7,5,2,1,3,4,2244.0,0:49,0,0,0,2449.0,0:54,1300000
8468778,Colton,Orr,1982-03-03,RW,R,2011-12,5,1,0,1,0.2,1,3,33.33,5,1344.0,4:28,0,1,1,0.0,7,0,0,2,-2,0,0,0,0.0,0:0,0,0,0,0.0,0:0,1000000
8468789,Jason,Williams,1980-08-11,C,R,2011-12,8,1,1,2,0.25,1,4,25.0,4,5075.0,10:34,0,1,1,0.0,1,2,4,3,1,0,1,1,1068.0,2:13,0,0,0,17.0,0:2,600000
8468927,Steve,Montador,1979-12-21,D,R,2011-12,52,5,9,14,0.27,4,57,8.77,45,46051.0,14:45,0,0,0,0.0,49,46,6,21,-15,2,4,6,4532.0,1:27,0,0,0,399.0,0:7,2750000
8469454,Ilya,Kovalchuk,1983-04-15,RW,R,2011-12,77,37,46,83,1.08,-9,310,11.94,33,112901.0,24:26,13,24,37,35.14,27,18,42,120,-78,10,19,29,22748.0,4:55,3,2,5,5328.0,1:9,6666666
8469455,Jason,Spezza,1983-06-13,C,R,2011-12,80,34,50,84,1.05,11,232,14.66,36,95623.0,19:55,909,791,1700,53.47,28,23,64,84,-20,10,14,24,16194.0,3:22,0,0,0,2028.0,0:25,7000000
8469457,Stephen,Weiss,1983-04-03,C,L,2011-12,80,20,37,57,0.71,5,149,13.42,60,98449.0,20:30,781,688,1469,53.17,92,61,56,33,23,5,12,17,15815.0,3:17,1,0,1,6072.0,1:15,3100000
8469459,Mikko,Koivu,1983-03-12,C,L,2011-12,55,12,32,44,0.8,10,129,9.3,28,70455.0,21:21,587,536,1123,52.27,62,21,47,44,3,2,13,15,11632.0,3:31,1,3,4,5718.0,1:43,6750000
8469460,Mike,Komisarek,1982-01-19,D,R,2011-12,45,1,4,5,0.11,-13,34,2.94,41,44972.0,16:39,0,0,0,0.0,104,80,25,26,-1,0,0,0,151.0,0:3,0,0,0,4563.0,1:41,4300000
8469462,Tuomo,Ruutu,1983-02-16,LW,L,2011-12,72,18,16,34,0.47,-3,156,11.54,50,71110.0,16:27,44,80,124,35.48,151,24,32,42,-10,3,2,5,10702.0,2:28,0,0,0,255.0,0:3,3800000
8469465,Dan,Hamhuis,1982-12-13,D,L,2011-12,82,4,33,37,0.45,29,140,2.86,46,115271.0,23:25,0,0,0,0.0,103,99,48,62,-14,1,10,11,9171.0,1:51,0,2,2,14418.0,2:55,4500000
8469466,Ales,Hemsky,1983-08-13,RW,R,2011-12,69,10,26,36,0.52,-13,137,7.3,43,72864.0,17:36,2,4,6,33.33,22,21,37,55,-18,1,8,9,8855.0,2:8,0,0,0,174.0,0:2,4100000
8469467,Chuck,Kobasew,1982-04-17,RW,R,2011-12,58,7,7,14,0.24,-10,65,10.77,51,41233.0,11:50,7,15,22,31.82,62,20,17,7,10,0,1,1,1757.0,0:30,1,0,1,4390.0,1:15,1250000
8469469,R.J.,Umberger,1982-05-03,C,L,2011-12,77,20,20,40,0.52,-10,200,10.0,27,84045.0,18:11,150,156,306,49.02,102,70,45,24,21,5,5,10,14596.0,3:9,0,1,1,4721.0,1:1,3750000
8469470,Carlo,Colaiacovo,1983-01-27,D,L,2011-12,64,2,17,19,0.3,7,68,2.94,22,72975.0,19:0,0,0,0,0.0,73,81,9,14,-5,0,8,8,7782.0,2:1,0,0,0,1067.0,0:16,2125000
8469473,Marcel,Goc,1983-08-24,C,L,2011-12,57,11,16,27,0.47,5,97,11.34,10,60252.0,17:37,505,473,978,51.64,38,23,43,13,30,3,1,4,4227.0,1:14,0,0,0,6889.0,2:0,1700000
8469474,Colby,Armstrong,1982-11-23,RW,R,2011-12,29,1,2,3,0.1,-8,14,7.14,9,16218.0,9:19,7,11,18,38.89,37,5,6,7,-1,0,0,0,150.0,0:5,0,0,0,478.0,0:16,3000000
8469476,Tim,Gleason,1983-01-29,D,L,2011-12,82,1,17,18,0.22,12,65,1.54,71,101893.0,20:42,0,0,0,0.0,129,112,18,32,-14,0,2,2,1484.0,0:18,0,1,1,12814.0,2:36,2750000
8469480,Jeff,Woywitka,1983-09-01,D,L,2011-12,27,1,5,6,0.22,2,13,7.69,8,16865.0,10:24,0,0,0,0.0,18,22,4,7,-3,0,0,0,29.0,0:1,0,0,0,406.0,0:15,650000
8469483,David,Steckel,1982-03-15,C,L,2011-12,76,8,5,13,0.17,-14,79,10.13,10,58495.0,12:49,643,465,1108,58.03,170,66,33,31,2,1,0,1,804.0,0:10,2,0,2,10442.0,2:17,1100000
8469485,Derek,Roy,1983-05-04,C,L,2011-12,80,17,27,44,0.55,-7,176,9.66,54,92757.0,19:19,672,657,1329,50.56,35,50,46,59,-13,6,6,12,12568.0,2:37,1,0,1,8219.0,1:42,4000000
8469490,Tim,Jackman,1981-11-14,RW,R,2011-12,75,1,6,7,0.09,-21,103,0.97,94,41035.0,9:7,15,19,34,44.12,160,16,18,7,11,0,0,0,1630.0,0:21,0,0,0,92.0,0:1,550000
8469492,Fedor,Tyutin,1983-07-19,D,L,2011-12,66,5,21,26,0.39,-21,124,4.03,49,95605.0,24:8,0,0,0,0.0,100,91,16,20,-4,1,11,12,13091.0,3:18,0,1,1,11175.0,2:49,2843750
8469500,Michael,Cammalleri,1982-06-08,LW,L,2011-12,66,20,21,41,0.62,-10,175,11.43,26,71721.0,18:6,104,124,228,45.61,17,19,25,39,-14,3,9,12,12017.0,3:2,0,0,0,2424.0,0:36,6000000
8469501,Chris,Thorburn,1983-06-03,RW,R,2011-12,72,4,7,11,0.15,-6,69,5.8,83,43988.0,10:10,39,28,67,58.21,151,46,13,14,-1,0,0,0,316.0,0:4,0,0,0,2125.0,0:29,866667
8469506,Jason,Pominville,1982-11-30,RW,R,2011-12,82,30,43,73,0.89,-7,235,12.77,12,96825.0,19:40,179,196,375,47.73,30,52,45,38,7,8,18,26,15416.0,3:8,2,1,3,10908.0,2:13,5300000
8469508,Jay,McClement,1983-03-02,C,L,2011-12,80,10,7,17,0.21,-8,95,10.53,31,66013.0,13:45,448,425,873,51.32,72,54,34,16,18,0,0,0,259.0,0:3,1,0,1,14900.0,3:6,1450000
8469516,Brendan,Bell,1983-03-31,D,L,2011-12,1,0,0,0,0.0,-1,2,0.0,0,686.0,11:26,0,0,0,0.0,0,0,0,0,0,0,0,0,0.0,0:0,0,0,0,0.0,0:0,525000
8469521,Tomas,Plekanec,1982-10-31,C,L,2011-12,81,17,35,52,0.64,-15,220,7.73,56,100848.0,20:45,824,854,1678,49.11,67,57,43,48,-5,5,13,18,15010.0,3:5,3,3,6,15658.0,3:13,5000000
8469531,Jay,Harrison,1982-11-03,D,L,2011-12,72,9,14,23,0.32,-10,128,7.03,60,88788.0,20:33,0,0,0,0.0,117,153,15,40,-25,2,3,5,5817.0,1:20,0,0,0,7149.0,1:39,700000
8469534,Aaron,Johnson,1983-04-30,D,L,2011-12,56,3,13,16,0.29,-12,63,4.76,26,55464.0,16:30,0,0,0,0.0,99,72,17,21,-4,1,1,2,2844.0,0:50,0,0,0,4529.0,1:20,550000
8469542,Stephane,Veilleux,1981-11-16,LW,L,2011-12,22,0,2,2,0.09,-2,16,0.0,15,12955.0,9:48,3,7,10,30.0,27,5,11,1,10,0,0,0,56.0,0:2,0,0,0,1161.0,0:52,525000
8469544,Patrick,Sharp,1981-12-27,LW,R,2011-12,74,33,36,69,0.93,28,282,11.7,38,88353.0,19:53,139,152,291,47.77,80,18,55,29,26,7,10,17,15672.0,3:31,1,0,1,4861.0,1:5,3900000
8469547,Jordin,Tootoo,1983-02-02,RW,R,2011-12,77,6,24,30,0.39,-5,136,4.41,92,60771.0,13:9,4,8,12,33.33,151,17,42,44,-2,1,1,2,986.0,0:12,0,0,0,307.0,0:3,1250000
8469555,Christian,Ehrhoff,1982-07-06,D,L,2011-12,66,5,27,32,0.48,-2,136,3.68,47,91309.0,23:3,0,0,0,0.0,47,82,24,51,-27,1,10,11,11754.0,2:58,0,2,2,5230.0,1:19,4000000
8469581,Kyle,Wellwood,1983-05-16,C,R,2011-12,77,18,29,47,0.61,3,93,19.35,4,69080.0,14:57,135,115,250,54.0,10,13,35,26,9,4,6,10,9190.0,1:59,0,0,0,231.0,0:3,700000
8469591,Cody,McCormick,1983-04-18,C,R,2011-12,50,1,3,4,0.08,-7,43,2.33,56,23492.0,7:49,8,9,17,47.06,67,11,8,9,-1,0,0,0,11.0,0:0,0,0,0,121.0,0:2,1200000
8469598,Kevin,Bieksa,1981-06-16,D,R,2011-12,78,8,36,44,0.56,12,166,4.82,94,110635.0,23:38,0,1,1,0.0,159,106,29,68,-39,2,8,10,8091.0,1:43,0,0,0,12132.0,2:35,4600000
8469619,Dennis,Seidenberg,1981-07-18,D,L,2011-12,80,5,18,23,0.29,15,174,2.87,39,115388.0,24:2,0,0,0,0.0,154,151,17,25,-8,0,8,8,12494.0,2:36,0,2,2,12387.0,2:34,3250000
8469622,Ryane,Clowe,1982-09-30,LW,L,2011-12,76,17,28,45,0.59,-5,180,9.44,97,81469.0,17:51,6,14,20,30.0,109,36,42,55,-13,4,11,15,10350.0,2:16,0,0,0,127.0,0:1,3625000
8469623,Marek,Zidlicky,1977-02-03,D,R,2011-12,63,2,20,22,0.35,-6,70,2.86,34,80630.0,21:19,0,0,0,0.0,62,58,14,44,-30,2,6,8,12985.0,3:26,0,0,0,1586.0,0:25,4000000
8469626,Andrew,Alberts,1981-06-30,D,L,2011-12,44,2,1,3,0.07,4,19,10.53,40,37743.0,14:17,0,0,0,0.0,91,39,13,16,-3,0,0,0,168.0,0:3,0,0,0,3054.0,1:9,1225000
8469638,Jussi,Jokinen,1983-04-01,LW,L,2011-12,79,12,34,46,0.58,-2,118,10.17,54,83766.0,17:40,459,374,833,55.1,41,48,37,40,-3,3,15,18,13352.0,2:49,2,0,2,6155.0,1:17,3000000
8469639,Brooks,Laich,1983-06-23,C,L,2011-12,82,16,25,41,0.5,-8,191,8.38,34,90991.0,18:29,664,730,1394,47.63,120,92,52,31,21,5,4,9,10823.0,2:11,1,0,1,12176.0,2:28,4500000
8469664,David,Moss,1981-12-28,RW,R,2011-12,32,2,7,9,0.28,-3,82,2.44,12,26907.0,14:0,93,127,220,42.27,43,24,15,18,-3,0,0,0,1744.0,0:54,0,0,0,2833.0,1:28,1300000
8469665,Johnny,Oduya,1981-10-01,D,L,2011-12,81,3,15,18,0.22,-6,82,3.66,33,99440.0,20:27,0,0,0,0.0,64,140,23,36,-13,0,0,0,3787.0,0:46,0,0,0,10403.0,2:8,3500000
8469684,Milan,Jurcina,1983-06-07,D,R,2011-12,65,3,8,11,0.17,-34,127,2.36,30,73230.0,18:46,0,0,0,0.0,173,116,26,25,1,2,1,3,3264.0,0:50,0,0,0,6621.0,1:41,1600000
8469685,Andrew,Murray,1981-11-06,C,L,2011-12,39,1,3,4,0.1,3,33,3.03,4,18029.0,7:42,5,10,15,33.33,66,8,6,4,2,0,0,0,100.0,0:2,0,0,0,886.0,0:22,575000
8469707,PA,Parenteau,1983-03-24,RW,R,2011-12,80,18,49,67,0.84,-8,167,10.78,89,89532.0,18:39,10,16,26,38.46,99,23,37,56,-19,6,13,19,14116.0,2:56,0,0,0,100.0,0:1,1250000
8469759,Vernon,Fiddler,1980-05-09,C,L,2011-12,82,8,13,21,0.26,-13,123,6.5,60,68807.0,13:59,534,515,1049,50.91,82,67,40,13,27,0,0,0,617.0,0:7,0,1,1,9829.0,1:59,1800000
8469760,Zbynek,Michalek,1982-12-23,D,R,2011-12,62,2,11,13,0.21,0,77,2.6,24,80537.0,21:38,0,0,0,0.0,47,144,10,26,-16,0,1,1,874.0,0:14,0,1,1,13541.0,3:38,4000000
8469765,Marc-Andre,Bergeron,1980-10-13,D,L,2011-12,43,4,20,24,0.56,6,80,5.0,20,49933.0,19:21,0,0,0,0.0,37,43,19,19,0,1,8,9,7251.0,2:48,0,0,0,322.0,0:7,1000000
8469770,Dennis,Wideman,1983-03-20,D,R,2011-12,82,11,35,46,0.56,-8,175,6.29,46,117616.0,23:54,0,0,0,0.0,113,132,30,68,-38,4,16,20,16131.0,3:16,0,0,0,9534.0,1:56,3937500
8469812,Chad,LaRose,1982-03-27,RW,R,2011-12,67,19,13,32,0.48,-15,199,9.55,48,67395.0,16:45,18,25,43,41.86,131,15,26,19,7,3,4,7,7928.0,1:58,1,0,1,2811.0,0:41,1700000
8470018,Matt,Ellis,1981-08-31,LW,L,2011-12,60,3,5,8,0.13,-3,85,3.53,25,34986.0,9:43,117,127,244,47.95,34,17,22,7,15,0,0,0,141.0,0:2,0,0,0,1177.0,0:19,525000
8470039,Tomas,Fleischmann,1984-05-16,LW,L,2011-12,82,27,34,61,0.74,-7,217,12.44,26,93966.0,19:5,14,13,27,51.85,32,33,56,40,16,6,16,22,15580.0,3:10,0,0,0,692.0,0:8,4500000
8470041,Rick,Nash,1984-06-16,LW,L,2011-12,82,30,29,59,0.72,-19,306,9.8,40,93896.0,19:5,6,13,19,31.58,104,21,62,26,36,6,13,19,17017.0,3:27,2,0,2,3243.0,0:39,7800000
8470047,Valtteri,Filppula,1984-03-20,C,L,2011-12,81,23,43,66,0.81,18,144,15.97,14,88736.0,18:15,193,180,373,51.74,42,23,39,30,9,3,8,11,11956.0,2:27,1,0,1,4452.0,0:54,3000000
8470054,Keith,Ballard,1982-11-26,D,L,2011-12,47,1,6,7,0.15,0,41,2.44,64,43866.0,15:33,0,0,0,0.0,61,63,8,29,-21,0,0,0,565.0,0:12,0,0,0,2754.0,0:58,3300000
8470061,Derek,Meech,1984-04-21,D,L,2011-12,2,0,0,0,0.0,1,2,0.0,4,1373.0,11:26,0,0,0,0.0,1,0,1,1,0,0,0,0,155.0,1:17,0,0,0,0.0,0:0,700000
8470063,Adam,Burish,1983-01-06,RW,R,2011-12,65,6,13,19,0.29,6,82,7.32,76,49873.0,12:47,217,172,389,55.78,69,36,17,13,4,0,2,2,2098.0,0:32,0,0,0,5652.0,1:26,1150000
8470104,Tom,Gilbert,1983-01-10,D,R,2011-12,67,3,19,22,0.33,-8,72,4.17,20,96740.0,24:3,0,0,0,0.0,65,115,30,50,-20,2,4,6,9411.0,2:20,0,0,0,12894.0,3:12,4000000
8470105,Scottie,Upshall,1983-10-07,RW,L,2011-12,26,2,3,5,0.19,-3,53,3.77,29,19845.0,12:43,3,3,6,50.0,44,2,8,3,5,1,0,1,2095.0,1:20,0,0,0,479.0,0:18,3500000
8470110,Trevor,Daley,1983-10-09,D,L,2011-12,79,4,21,25,0.32,3,134,2.99,42,102610.0,21:38,0,0,0,0.0,45,115,22,25,-3,1,5,6,10278.0,2:10,0,0,0,11849.0,2:29,3300000
8470120,Alexander,Semin,1984-03-03,RW,R,2011-12,77,21,33,54,0.7,9,183,11.48,56,77570.0,16:47,1,10,11,9.09,31,19,52,39,13,2,9,11,11658.0,2:31,0,0,0,69.0,0:0,6700000
8470121,Matt,Greene,1983-05-13,D,R,2011-12,82,4,11,15,0.18,4,76,5.26,58,82029.0,16:40,0,0,0,0.0,241,112,10,44,-34,0,0,0,490.0,0:5,0,1,1,15074.0,3:3,2950000
8470123,Cam,Janssen,1984-04-15,RW,R,2011-12,48,0,1,1,0.02,-8,17,0.0,75,13484.0,4:40,2,3,5,40.0,74,3,2,4,-2,0,0,0,75.0,0:1,0,0,0,40.0,0:0,525000
8470137,Joni,Pitkanen,1983-09-19,D,L,2011-12,30,5,12,17,0.57,-15,62,8.06,16,40148.0,22:18,0,0,0,0.0,27,43,9,17,-8,2,6,8,7016.0,3:53,0,0,0,3052.0,1:41,4500000
8470144,Frans,Nielsen,1984-04-24,C,L,2011-12,82,17,30,47,0.57,-3,133,12.78,6,85867.0,17:27,523,633,1156,45.24,29,66,58,33,25,5,10,15,12276.0,2:29,0,0,0,9927.0,2:1,525000
8470151,Jay,Bouwmeester,1983-09-27,D,L,2011-12,82,5,24,29,0.35,-21,107,4.67,26,127711.0,25:57,0,0,0,0.0,69,118,25,60,-35,2,8,10,10727.0,2:10,0,0,0,16283.0,3:18,6680000
8470152,Joakim,Lindstrom,1983-12-05,C,L,2011-12,16,2,3,5,0.31,-9,22,9.09,0,13361.0,13:55,2,3,5,40.0,1,6,9,2,7,1,0,1,2192.0,2:17,0,0,0,2.0,0:0,600000
8470153,Pierre-Marc,Bouchard,1984-04-27,C,L,2011-12,37,9,13,22,0.59,-1,84,10.71,18,36239.0,16:19,4,12,16,25.0,3,9,22,11,11,2,5,7,7552.0,3:24,0,0,0,55.0,0:1,4080000
8470156,Joey,Crabb,1983-04-03,RW,R,2011-12,67,11,15,26,0.39,1,75,14.67,33,54045.0,13:26,1,9,10,10.0,101,34,23,29,-6,0,0,0,429.0,0:6,2,0,2,6309.0,1:34,750000
8470159,Boyd,Gordon,1983-10-19,C,R,2011-12,75,8,15,23,0.31,9,114,7.02,10,71669.0,15:55,669,508,1177,56.84,48,86,28,10,18,0,0,0,581.0,0:7,1,2,3,12981.0,2:53,1325000
8470162,Matt,Stajan,1983-12-19,C,L,2011-12,61,8,10,18,0.3,-3,77,10.39,29,47618.0,13:0,331,308,639,51.8,49,33,28,21,7,0,2,2,1722.0,0:28,0,0,0,3655.0,0:59,3500000
8470169,Gregory,Campbell,1983-12-17,C,L,2011-12,78,8,8,16,0.21,-3,74,10.81,80,59895.0,12:47,344,334,678,50.74,107,53,22,18,4,0,0,0,721.0,0:9,0,0,0,7870.0,1:40,1100000
8470171,Max,Talbot,1984-02-11,C,L,2011-12,81,19,15,34,0.42,5,115,16.52,59,77758.0,15:59,284,356,640,44.38,150,58,30,21,9,1,1,2,1164.0,0:14,2,1,3,16968.0,3:29,1800000
8470176,Sean,Bergenheim,1984-02-08,LW,L,2011-12,62,17,6,23,0.37,-5,185,9.19,48,61053.0,16:24,3,8,11,27.27,109,21,29,16,13,5,0,5,6298.0,1:41,1,0,1,4613.0,1:14,2750000
8470180,Eric,Nystrom,1983-02-14,LW,L,2011-12,74,16,5,21,0.28,-10,102,15.69,24,61021.0,13:44,14,15,29,48.28,176,38,20,24,-4,0,0,0,684.0,0:9,0,0,0,5635.0,1:16,1400000
8470187,Johnny,Boychuk,1984-01-19,D,R,2011-12,77,5,10,15,0.19,27,171,2.92,53,95237.0,20:36,0,0,0,0.0,145,133,8,31,-23,0,0,0,1524.0,0:19,0,0,0,10278.0,2:13,1875000
8470189,David,Van Der Gulik,1983-04-20,LW,L,2011-12,25,1,5,6,0.24,3,20,5.0,2,12304.0,8:12,11,27,38,28.95,32,11,8,2,6,0,0,0,25.0,0:1,0,0,0,1573.0,1:2,525000
8470192,Steve,Eminger,1983-10-31,D,R,2011-12,42,2,3,5,0.12,0,19,10.53,28,33469.0,13:16,0,0,0,0.0,63,53,5,9,-4,0,1,1,234.0,0:5,0,1,1,3055.0,1:12,800000
8470201,Jiri,Hudler,1984-01-04,RW,L,2011-12,81,25,25,50,0.62,10,127,19.69,42,76140.0,15:40,2,5,7,28.57,48,15,21,26,-5,2,8,10,10921.0,2:14,0,0,0,53.0,0:0,2875000
8470207,Joffrey,Lupul,1983-09-23,LW,R,2011-12,66,25,42,67,1.02,1,191,13.09,48,73699.0,18:36,21,37,58,36.21,110,25,26,41,-15,8,13,21,12986.0,3:16,0,0,0,81.0,0:1,4250000
8470222,James,Wisniewski,1984-02-21,D,R,2011-12,48,6,21,27,0.56,-13,99,6.06,37,71417.0,24:47,0,1,1,0.0,50,74,15,22,-7,2,10,12,11206.0,3:53,0,0,0,5244.0,1:49,5500000
8470230,Daniel,Paille,1984-04-15,LW,L,2011-12,69,9,6,15,0.22,-5,86,10.47,15,47593.0,11:29,2,5,7,28.57,59,24,20,17,3,0,0,0,242.0,0:3,2,0,2,5561.0,1:20,1075000
8470257,Alexander,Steen,1984-03-01,LW,L,2011-12,43,15,13,28,0.65,24,134,11.19,28,49347.0,19:7,53,42,95,55.79,24,29,22,14,8,3,2,5,6463.0,2:30,0,0,0,4391.0,1:42,3362500
8470265,Anton,Babchuk,1984-05-06,D,R,2011-12,32,2,8,10,0.31,2,48,4.17,6,27819.0,14:29,0,0,0,0.0,17,48,9,12,-3,1,2,3,4718.0,2:27,0,0,0,64.0,0:2,2500000
8470273,Ian,White,1984-06-04,D,R,2011-12,77,7,25,32,0.42,23,196,3.57,22,106178.0,22:58,0,0,0,0.0,49,92,20,32,-12,0,10,10,13822.0,2:59,0,0,0,4959.0,1:4,2875000
8470274,Chris,Higgins,1983-06-02,LW,L,2011-12,71,18,25,43,0.61,11,165,10.91,16,69504.0,16:18,12,18,30,40.0,61,29,50,16,34,1,7,8,7284.0,1:42,1,0,1,5072.0,1:11,1900000
8470280,Ben,Eager,1984-01-22,LW,L,2011-12,63,8,5,13,0.21,-1,69,11.59,107,32286.0,8:32,0,2,2,0.0,73,17,13,17,-4,0,0,0,193.0,0:3,0,0,0,22.0,0:0,1100000
8470281,Duncan,Keith,1983-07-16,D,L,2011-12,74,4,36,40,0.54,15,162,2.47,42,119412.0,26:53,0,0,0,0.0,45,121,48,50,-2,1,12,13,14037.0,3:9,0,2,2,10156.0,2:17,5538462
8470283,Tim,Brent,1984-03-10,C,R,2011-12,79,12,12,24,0.3,-8,71,16.9,27,51615.0,10:53,278,293,571,48.69,64,33,19,13,6,3,4,7,7350.0,1:33,1,0,1,2658.0,0:33,750000
8470289,Jim,Slater,1982-12-09,C,L,2011-12,78,13,8,21,0.27,-9,118,11.02,42,69091.0,14:45,634,531,1165,54.42,163,73,23,19,4,0,0,0,539.0,0:6,1,0,1,10366.0,2:12,1000000
8470299,Erik,Christensen,1983-12-17,C,L,2011-12,49,7,5,12,0.24,-13,44,15.91,8,30595.0,10:24,159,143,302,52.65,26,4,11,16,-5,3,1,4,4306.0,1:27,0,0,0,37.0,0:0,925000
8470302,Patrick,Dwyer,1983-06-22,RW,R,2011-12,73,5,7,12,0.16,0,120,4.17,23,67319.0,15:22,15,14,29,51.72,129,62,33,13,20,0,1,1,1159.0,0:15,2,0,2,8731.0,1:59,625000
8470309,Ryan,Whitney,1983-02-19,D,L,2011-12,51,3,17,20,0.39,-16,41,7.32,16,64147.0,20:57,0,0,0,0.0,18,85,16,54,-38,2,8,10,6902.0,2:15,0,0,0,2723.0,0:53,4000000
8470310,Aaron,Rome,1983-09-27,D,L,2011-12,43,4,6,10,0.23,-4,42,9.52,46,39284.0,15:13,0,0,0,0.0,64,62,4,13,-9,1,1,2,1378.0,0:32,0,0,0,1782.0,0:41,750000
8470317,Nate,Guenin,1982-12-10,D,R,2011-12,15,2,0,2,0.13,6,5,40.0,6,10037.0,11:9,0,0,0,0.0,26,17,2,3,-1,0,0,0,0.0,0:0,0,0,0,165.0,0:11,525000
8470318,Jonathan,Ericsson,1984-03-02,D,L,2011-12,69,1,10,11,0.16,16,63,1.59,47,70756.0,17:5,0,0,0,0.0,128,43,9,42,-33,0,0,0,433.0,0:6,0,0,0,8415.0,2:1,3250000
8470324,Josh,Gorges,1984-08-14,D,L,2011-12,82,2,14,16,0.2,14,59,3.39,39,111343.0,22:37,0,0,0,0.0,131,250,20,43,-23,0,0,0,2069.0,0:25,0,0,0,19153.0,3:53,2500000
8470329,Chris,Campoli,1984-07-09,D,L,2011-12,43,2,9,11,0.26,-3,43,4.65,8,44378.0,17:12,0,0,0,0.0,43,59,12,31,-19,0,3,3,5206.0,2:1,0,0,0,1695.0,0:39,1750000
8470358,Alexandre,Burrows,1981-04-11,RW,L,2011-12,80,28,24,52,0.65,24,198,14.14,90,88677.0,18:28,7,13,20,35.0,87,38,39,25,14,3,4,7,10303.0,2:8,2,0,2,9020.0,1:52,2000000
8470543,Chris,Kunitz,1979-09-26,LW,L,2011-12,82,26,35,61,0.74,16,230,11.3,49,90108.0,18:18,20,18,38,52.63,180,28,28,30,-2,6,12,18,17335.0,3:31,0,0,0,672.0,0:8,3725000
8470595,Eric,Staal,1984-10-29,C,L,2011-12,82,24,46,70,0.85,-20,262,9.16,48,106013.0,21:32,882,799,1681,52.47,48,35,66,47,19,7,16,23,17899.0,3:38,3,2,5,7116.0,1:26,8250000
8470596,Nathan,Horton,1985-05-29,RW,R,2011-12,46,17,15,32,0.7,0,90,18.89,54,43975.0,15:55,2,1,3,66.67,32,11,12,12,0,6,2,8,7032.0,2:32,0,0,0,67.0,0:1,4000000
8470598,Thomas,Vanek,1984-01-19,LW,R,2011-12,78,26,35,61,0.78,-6,204,12.75,52,79256.0,16:56,3,3,6,50.0,34,22,24,43,-19,10,14,24,14248.0,3:2,0,0,0,1334.0,0:17,7142857
8470599,Milan,Michalek,1984-12-07,LW,L,2011-12,77,35,25,60,0.78,4,212,16.51,32,90337.0,19:33,1,5,6,16.67,36,46,39,18,21,10,5,15,13406.0,2:54,1,1,2,6819.0,1:28,4333333
8470600,Ryan,Suter,1985-01-21,D,L,2011-12,79,7,39,46,0.58,15,134,5.22,30,125635.0,26:30,0,1,1,0.0,46,116,37,42,-5,3,22,25,17506.0,3:41,1,1,2,11130.0,2:20,3500000
8470601,Braydon,Coburn,1985-02-27,D,L,2011-12,81,4,20,24,0.3,10,113,3.54,56,107132.0,22:2,0,1,1,0.0,164,119,33,43,-10,0,0,0,1733.0,0:21,0,2,2,16120.0,3:19,3200000
8470602,Dion,Phaneuf,1985-04-10,D,L,2011-12,82,12,32,44,0.54,-10,202,5.94,92,124423.0,25:17,0,0,0,0.0,214,127,30,76,-46,7,15,22,17501.0,3:33,0,1,1,12304.0,2:30,6500000
8470603,Andrei,Kostitsyn,1985-02-03,LW,L,2011-12,72,16,20,36,0.5,-1,122,13.11,26,65300.0,15:6,3,14,17,17.65,112,9,23,37,-14,5,1,6,7447.0,1:43,0,0,0,91.0,0:1,3250000
8470604,Jeff,Carter,1985-01-01,C,R,2011-12,55,21,13,34,0.62,-12,184,11.41,16,63305.0,19:11,393,381,774,50.78,16,17,26,20,6,10,3,13,10248.0,3:6,0,0,0,2442.0,0:44,5272727
8470606,Dustin,Brown,1984-11-04,RW,R,2011-12,82,22,32,54,0.66,18,214,10.28,53,99231.0,20:10,17,22,39,43.59,293,32,39,53,-14,9,7,16,16384.0,3:19,1,2,3,8216.0,1:40,3175000
8470607,Brent,Seabrook,1985-04-20,D,R,2011-12,78,9,25,34,0.44,21,156,5.77,22,115711.0,24:43,0,0,0,0.0,198,165,34,57,-23,2,2,4,10545.0,2:15,0,1,1,11562.0,2:28,5800000
8470609,Steve,Bernier,1985-03-31,RW,R,2011-12,32,1,5,6,0.19,6,23,4.35,16,22972.0,11:57,3,12,15,20.0,61,13,10,3,7,0,0,0,970.0,0:30,0,0,0,98.0,0:3,525000
8470610,Zach,Parise,1984-07-28,LW,L,2011-12,82,31,38,69,0.84,-5,293,10.58,32,105707.0,21:29,30,33,63,47.62,65,39,65,35,30,7,7,14,16956.0,3:26,3,4,7,9608.0,1:57,6000000
8470611,Eric,Fehr,1985-09-07,C,R,2011-12,35,2,1,3,0.09,-6,54,3.7,12,20369.0,9:41,0,0,0,0.0,22,13,6,4,2,0,0,0,910.0,0:26,0,0,0,19.0,0:0,2200000
8470612,Ryan,Getzlaf,1985-05-10,C,R,2011-12,82,11,46,57,0.7,-11,185,5.95,75,106269.0,21:35,639,715,1354,47.19,182,72,35,95,-60,4,19,23,18088.0,3:40,0,1,1,5150.0,1:2,5325000
8470613,Brent,Burns,1985-03-09,D,R,2011-12,81,11,26,37,0.46,8,201,5.47,34,109539.0,22:32,0,0,0,0.0,68,117,25,75,-50,5,11,16,13304.0,2:44,0,0,0,8647.0,1:46,3550000
8470614,Mark,Stuart,1984-04-27,D,L,2011-12,80,3,11,14,0.18,-4,60,5.0,98,82569.0,17:12,0,0,0,0.0,198,182,7,43,-36,0,0,0,150.0,0:1,1,0,1,14018.0,2:55,1700000
8470616,Ryan,Kesler,1984-08-31,C,R,2011-12,77,22,27,49,0.64,11,222,9.91,56,92824.0,20:5,724,627,1351,53.59,108,59,43,20,23,8,11,19,16081.0,3:28,1,1,2,9311.0,2:0,5000000
8470617,Mike,Richards,1985-02-11,C,L,2011-12,74,18,26,44,0.59,3,171,10.53,71,83856.0,18:53,539,528,1067,50.52,115,39,40,42,-2,3,11,14,13819.0,3:6,4,0,4,9073.0,2:2,5750000
8470618,Anthony,Stewart,1985-01-05,RW,R,2011-12,77,9,11,20,0.26,-2,64,14.06,30,37536.0,8:7,3,14,17,17.65,92,15,15,13,2,0,2,2,1684.0,0:21,0,0,0,38.0,0:0,900000
8470619,Brian,Boyle,1984-12-18,C,L,2011-12,82,11,15,26,0.32,2,165,6.67,59,74975.0,15:14,629,586,1215,51.77,236,83,25,15,10,0,1,1,4136.0,0:50,0,1,1,9804.0,1:59,1700000
8470621,Corey,Perry,1985-05-16,RW,R,2011-12,80,37,23,60,0.75,-7,277,13.36,127,102621.0,21:22,19,29,48,39.58,69,45,35,50,-15,14,9,23,17152.0,3:34,1,1,2,6154.0,1:16,5325000
8470622,Patrick,Eaves,1984-05-01,RW,R,2011-12,10,0,1,1,0.1,0,24,0.0,2,6628.0,11:2,2,3,5,40.0,21,7,2,1,1,0,0,0,101.0,0:10,0,0,0,1450.0,2:25,1200000
8470626,Loui,Eriksson,1985-07-17,LW,L,2011-12,82,26,45,71,0.87,18,187,13.9,12,97228.0,19:45,7,9,16,43.75,20,40,50,43,7,5,7,12,13035.0,2:38,2,1,3,8769.0,1:46,4250000
8470630,Kevin,Klein,1984-12-13,D,R,2011-12,66,4,17,21,0.32,-8,91,4.4,4,78967.0,19:56,0,0,0,0.0,84,151,25,50,-25,0,1,1,1097.0,0:16,0,1,1,9143.0,2:18,1350000
8470636,Josh,Hennessy,1985-02-07,C,L,2011-12,3,0,0,0,0.0,1,2,0.0,2,1219.0,6:46,8,5,13,61.54,2,0,0,0,0,0,0,0,0.0,0:0,0,0,0,20.0,0:6,600000
8470638,Patrice,Bergeron,1985-07-24,C,R,2011-12,81,22,42,64,0.79,36,191,11.52,20,90307.0,18:34,973,668,1641,59.29,73,67,55,25,30,5,9,14,12247.0,2:31,2,1,3,8802.0,1:48,5000000
8470640,Matt,Carle,1984-09-25,D,L,2011-12,82,4,34,38,0.46,4,132,3.03,36,113261.0,23:1,0,0,0,0.0,55,164,18,55,-37,3,9,12,12983.0,2:38,0,0,0,8491.0,1:43,3437500
8470642,Shea,Weber,1985-08-14,D,R,2011-12,78,19,30,49,0.63,21,230,8.26,46,122434.0,26:9,0,0,0,0.0,177,140,51,46,5,10,12,22,16507.0,3:31,2,0,2,10609.0,2:16,7500000
8470644,Colin,McDonald,1984-09-30,RW,R,2011-12,5,0,0,0,0.0,0,6,0.0,0,2541.0,8:28,0,0,0,0.0,8,0,1,0,1,0,0,0,166.0,0:33,0,0,0,0.0,0:0,525000
8470647,B.J.,Crombeen,1985-07-10,RW,R,2011-12,40,1,2,3,0.08,-2,50,2.0,71,19927.0,8:18,3,9,12,25.0,22,2,3,2,1,0,0,0,60.0,0:1,0,0,0,44.0,0:1,1000000
8470649,Patrick,O'Sullivan,1985-02-01,C,L,2011-12,23,2,2,4,0.17,-4,34,5.88,2,15248.0,11:2,5,4,9,55.56,7,4,6,2,4,0,1,1,2624.0,1:54,0,0,0,9.0,0:0,625000
8470654,Maxim,Lapierre,1985-03-29,C,R,2011-12,82,9,10,19,0.23,-3,103,8.74,130,55232.0,11:13,251,231,482,52.07,244,24,17,9,8,0,0,0,371.0,0:4,0,0,0,5580.0,1:8,1000000
8470655,David,Backes,1984-05-01,RW,R,2011-12,82,24,30,54,0.66,15,234,10.26,101,98390.0,19:59,658,695,1353,48.63,226,72,50,22,28,8,9,17,11826.0,2:24,2,1,3,8841.0,1:47,4500000
8470661,Jean-Francois,Jacques,1985-04-29,LW,L,2011-12,6,0,0,0,0.0,2,7,0.0,12,2384.0,6:37,0,0,0,0.0,6,0,0,0,0,0,0,0,0.0,0:0,0,0,0,0.0,0:0,650000
8470662,Colin,Fraser,1985-01-28,C,L,2011-12,67,2,6,8,0.12,-2,54,3.7,67,39135.0,9:44,175,195,370,47.3,149,25,16,12,4,0,0,0,447.0,0:6,0,0,0,4736.0,1:10,825000
8470666,Daniel,Carcillo,1985-01-28,LW,L,2011-12,28,2,9,11,0.39,10,27,7.41,82,19152.0,11:24,2,2,4,50.0,76,9,8,2,6,0,0,0,577.0,0:20,0,0,0,0.0,0:0,775000
8470667,Clarke,MacArthur,1985-04-06,LW,L,2011-12,73,20,23,43,0.59,3,148,13.51,37,69397.0,15:50,5,6,11,45.45,60,21,17,34,-17,3,6,9,8773.0,2:0,0,0,0,22.0,0:0,3250000
8470672,Ryan,O'Byrne,1984-07-19,D,R,2011-12,74,1,6,7,0.09,-5,42,2.38,57,83714.0,18:51,0,0,0,0.0,180,141,13,24,-11,0,0,0,127.0,0:1,0,0,0,12801.0,2:52,1800000
8470678,Alexandre,Picard,1985-07-05,D,L,2011-12,17,0,4,4,0.24,4,10,0.0,4,13405.0,13:8,0,0,0,0.0,12,14,4,3,1,0,0,0,458.0,0:26,0,0,0,231.0,0:13,600000
8470687,Zack,Stortini,1985-09-11,RW,R,2011-12,1,0,0,0,0.0,0,1,0.0,7,293.0,4:53,0,0,0,0.0,1,0,0,0,0,0,0,0,0.0,0:0,0,0,0,0.0,0:0,550000
8470699,Jan,Hejda,1978-06-18,D,L,2011-12,81,5,14,19,0.23,-17,78,6.41,24,100518.0,20:40,1,0,1,100.0,142,134,27,44,-17,0,0,0,370.0,0:4,0,0,0,14824.0,3:3,3250000
8470700,Byron,Bitz,1984-07-21,RW,R,2011-12,10,1,3,4,0.4,2,6,16.67,14,6299.0,10:29,0,3,3,0.0,20,7,5,1,4,0,0,0,37.0,0:3,0,0,0,3.0,0:0,700000
8470713,Paul,Bissonnette,1985-03-11,LW,L,2011-12,31,1,0,1,0.03,-4,15,6.67,41,11299.0,6:4,0,1,1,0.0,70,1,2,4,-2,0,0,0,19.0,0:0,0,0,0,0.0,0:0,612500
8470714,Corey,Potter,1984-01-05,D,R,2011-12,62,4,17,21,0.34,-16,98,4.08,24,74205.0,19:56,0,0,0,0.0,90,79,31,40,-9,1,10,11,9204.0,2:28,0,0,0,3201.0,0:51,525000
8470719,Alexandre,Bolduc,1985-06-26,C,L,2011-12,2,0,0,0,0.0,-1,1,0.0,2,859.0,7:9,1,0,1,100.0,1,0,0,0,0,0,0,0,0.0,0:0,0,0,0,0.0,0:0,575000
8470724,Kyle,Quincey,1985-08-12,D,L,2011-12,72,7,19,26,0.36,-1,168,4.17,89,94434.0,21:51,0,1,1,0.0,101,94,24,35,-11,4,6,10,10159.0,2:21,0,2,2,9937.0,2:18,3125000
8470729,Tyson,Strachan,1984-10-30,D,R,2011-12,15,1,2,3,0.2,1,14,7.14,5,12912.0,14:20,0,0,0,0.0,31,21,3,3,0,0,0,0,111.0,0:7,0,0,0,187.0,0:12,750000
8470740,Lee,Stempniak,1983-02-04,RW,R,2011-12,61,14,14,28,0.46,-2,130,10.77,16,59398.0,16:13,7,19,26,26.92,55,22,35,27,8,2,3,5,6794.0,1:51,0,0,0,5184.0,1:24,1900000
8470755,Brad,Richardson,1985-02-04,C,L,2011-12,59,5,3,8,0.14,-6,98,5.1,30,45527.0,12:51,33,23,56,58.93,65,15,20,13,7,0,0,0,842.0,0:14,1,0,1,2717.0,0:46,1175000
8470760,Marc,Methot,1985-06-21,D,L,2011-12,46,1,6,7,0.15,-11,42,2.38,24,55344.0,20:3,0,0,0,0.0,106,52,10,13,-3,0,0,0,177.0,0:3,0,0,0,6344.0,2:17,3000000
8470774,Bruno,Gervais,1984-10-03,D,R,2011-12,50,6,7,13,0.26,-4,57,10.53,8,42802.0,14:16,0,0,0,0.0,42,63,17,14,3,1,1,2,2116.0,0:42,0,0,0,2381.0,0:47,525000
8470775,Nate,Thompson,1984-10-05,C,L,2011-12,68,9,6,15,0.22,-23,85,10.59,21,60477.0,14:49,293,299,592,49.49,107,56,29,14,15,0,0,0,580.0,0:8,0,0,0,11014.0,2:41,900000
8470778,Drew,Miller,1984-02-17,LW,L,2011-12,80,14,11,25,0.31,6,131,10.69,20,61794.0,12:52,5,20,25,20.0,79,66,26,9,17,0,0,0,450.0,0:5,0,0,0,9726.0,2:1,837500
8470794,Joe,Pavelski,1984-07-11,C,R,2011-12,82,31,30,61,0.74,18,269,11.52,31,101419.0,20:36,507,357,864,58.68,50,84,73,61,12,8,10,18,15759.0,3:12,1,0,1,7774.0,1:34,4000000
8470798,Dylan,Reese,1984-08-29,D,R,2011-12,28,1,6,7,0.25,0,26,3.85,11,28703.0,17:5,0,0,0,0.0,22,25,12,12,0,0,0,0,173.0,0:6,0,0,0,1228.0,0:43,635250
8470803,Kyle,Brodziak,1984-05-25,C,R,2011-12,82,22,22,44,0.54,-15,160,13.75,66,93801.0,19:3,707,722,1429,49.48,81,62,70,27,43,5,6,11,8257.0,1:40,0,0,0,11945.0,2:25,1150000
8470816,Jay,Rosehill,1985-07-16,LW,L,2011-12,31,0,0,0,0.0,-4,15,0.0,60,10990.0,5:54,1,3,4,25.0,53,5,3,6,-3,0,0,0,22.0,0:0,0,0,0,0.0,0:0,600000
8470828,Toby,Enstrom,1984-11-05,D,L,2011-12,62,6,27,33,0.53,6,94,6.38,38,88703.0,23:50,0,0,0,0.0,24,84,8,29,-21,2,9,11,12214.0,3:17,0,0,0,4389.0,1:10,3750000
8470834,Dustin,Byfuglien,1985-03-27,D,R,2011-12,66,12,41,53,0.8,-8,223,5.38,72,95496.0,24:6,0,0,0,0.0,112,57,49,55,-6,4,15,19,13827.0,3:29,0,1,1,1689.0,0:25,5200000
8470839,Shane,O'Brien,1983-08-09,D,L,2011-12,76,3,17,20,0.26,2,114,2.63,105,87642.0,19:13,0,0,0,0.0,138,86,28,33,-5,1,1,2,1970.0,0:25,0,1,1,7828.0,1:43,1100000
8470852,Matt,Moulson,1983-11-01,LW,L,2011-12,82,36,33,69,0.84,1,219,16.44,6,94968.0,19:18,2,2,4,50.0,33,40,57,32,25,14,10,24,15431.0,3:8,0,0,0,174.0,0:2,3133333
8470854,Tanner,Glass,1983-11-29,LW,L,2011-12,78,5,11,16,0.21,-12,86,5.81,73,62796.0,13:25,29,44,73,39.73,246,51,9,20,-11,0,0,0,477.0,0:6,0,0,0,8362.0,1:47,750000
8470871,Chris,Porter,1984-05-29,LW,L,2011-12,47,4,3,7,0.15,-1,61,6.56,11,29308.0,10:23,8,11,19,42.11,124,4,4,5,-1,0,0,0,131.0,0:2,0,0,0,615.0,0:13,600000
8470886,Clayton,Stoner,1985-02-19,D,L,2011-12,51,1,4,5,0.1,3,47,2.13,62,53839.0,17:35,0,0,0,0.0,72,80,14,23,-9,0,0,0,61.0,0:1,0,0,0,5097.0,1:39,550000
8470920,David,Clarkson,1984-03-31,RW,R,2011-12,80,30,16,46,0.57,-8,228,13.16,138,78524.0,16:21,102,141,243,41.98,169,19,32,16,16,8,8,16,14659.0,3:3,0,0,0,84.0,0:1,2666667
8470966,Mark,Giordano,1983-10-03,D,L,2011-12,61,9,18,27,0.44,0,125,7.2,75,84254.0,23:1,0,0,0,0.0,84,127,26,51,-25,5,5,10,12318.0,3:21,0,1,1,8077.0,2:12,4020000
8471185,Curtis,Glencross,1982-12-28,LW,L,2011-12,67,26,22,48,0.72,-13,110,23.64,62,72455.0,18:1,41,41,82,50.0,81,49,39,46,-7,8,5,13,8249.0,2:3,1,1,2,8906.0,2:12,2550000
8471187,Brett,Lebda,1982-01-15,D,L,2011-12,30,1,3,4,0.13,-1,36,2.78,14,29658.0,16:28,0,0,0,0.0,21,21,7,9,-2,0,0,0,1540.0,0:51,0,0,0,1220.0,0:40,700000
8471208,Dustin,Penner,1982-09-28,RW,L,2011-12,65,7,10,17,0.26,-7,119,5.88,43,55851.0,14:19,14,18,32,43.75,90,16,27,38,-11,1,0,1,6048.0,1:33,0,0,0,159.0,0:2,4250000
8471214,Alex,Ovechkin,1985-09-17,LW,R,2011-12,78,38,27,65,0.83,-8,303,12.54,26,92665.0,19:48,6,9,15,40.0,215,42,34,51,-17,13,10,23,17006.0,3:38,0,0,0,121.0,0:1,9538462
8471215,Evgeni,Malkin,1986-07-31,C,L,2011-12,75,50,59,109,1.45,18,339,14.75,70,94606.0,21:1,575,635,1210,47.52,29,41,52,73,-21,12,22,34,19616.0,4:21,0,0,0,185.0,0:2,8700000
8471216,Cam,Barker,1986-04-04,D,L,2011-12,25,2,0,2,0.08,0,35,5.71,23,27541.0,18:21,0,0,0,0.0,36,19,2,18,-16,1,0,1,3481.0,2:19,0,0,0,555.0,0:22,3083333
8471217,Andrew,Ladd,1985-12-12,LW,L,2011-12,82,28,22,50,0.61,-8,265,10.57,64,96264.0,19:33,32,27,59,54.24,76,25,40,43,-3,4,8,12,12861.0,2:36,0,0,0,7578.0,1:32,4400000
8471218,Blake,Wheeler,1986-08-31,RW,R,2011-12,80,17,47,64,0.8,3,208,8.17,55,91562.0,19:4,4,6,10,40.0,113,46,50,33,17,6,9,15,12650.0,2:38,0,0,0,861.0,0:10,2550000
8471220,Rostislav,Olesz,1985-10-10,LW,L,2011-12,6,0,0,0,0.0,-1,6,0.0,6,3278.0,9:6,0,2,2,0.0,7,1,0,1,-1,0,0,0,4.0,0:0,0,0,0,0.0,0:0,3125000
8471222,Ladislav,Smid,1986-02-01,D,L,2011-12,78,5,10,15,0.19,4,47,10.64,44,97832.0,20:54,0,0,0,0.0,186,184,31,47,-16,0,0,0,281.0,0:3,0,1,1,15780.0,3:22,2250000
8471226,Drew,Stafford,1985-10-30,RW,R,2011-12,80,20,30,50,0.62,5,226,8.85,46,84710.0,17:38,45,41,86,52.33,102,22,40,40,0,3,4,7,10827.0,2:15,1,0,1,4783.0,0:59,4000000
8471228,Alexander,Radulov,1986-07-05,RW,L,2011-12,9,3,4,7,0.78,3,21,14.29,4,10448.0,19:20,0,0,0,0.0,5,5,5,4,1,0,1,1,878.0,1:37,0,0,0,7.0,0:0,984200
8471229,Petteri,Nokelainen,1986-01-16,C,R,2011-12,56,3,4,7,0.12,-6,37,8.11,37,29572.0,8:48,165,144,309,53.4,46,10,6,6,0,0,0,0,562.0,0:10,0,0,0,4490.0,1:20,550000
8471231,Kyle,Chipchura,1986-02-19,C,L,2011-12,53,3,13,16,0.3,2,43,6.98,42,33470.0,10:31,174,190,364,47.8,67,14,13,6,7,0,0,0,165.0,0:3,0,0,0,849.0,0:16,550000
8471232,Lauri,Korpikoski,1986-07-28,LW,L,2011-12,82,17,20,37,0.45,3,146,11.64,14,84318.0,17:8,23,64,87,26.44,91,43,24,24,0,0,2,2,3556.0,0:43,3,0,3,12837.0,2:36,1800000
8471233,Travis,Zajac,1985-05-13,C,R,2011-12,15,2,4,6,0.4,-3,25,8.0,4,15637.0,17:22,118,86,204,57.84,11,3,12,6,6,1,0,1,1056.0,1:10,0,0,0,1183.0,1:18,3887500
8471234,Wojtek,Wolski,1986-02-24,LW,L,2011-12,31,4,8,12,0.39,-5,50,8.0,2,25599.0,13:45,5,5,10,50.0,34,5,10,7,3,0,1,1,2752.0,1:28,0,0,0,1.0,0:0,3800000
8471236,Andrej,Meszaros,1985-10-13,D,L,2011-12,62,7,18,25,0.4,6,114,6.14,38,76872.0,20:39,0,0,0,0.0,144,88,21,30,-9,2,1,3,5208.0,1:24,0,0,0,8973.0,2:24,4000000
8471240,Jeff,Schultz,1986-02-25,D,L,2011-12,54,1,5,6,0.11,-2,22,4.55,12,49545.0,15:17,0,0,0,0.0,49,58,10,33,-23,0,0,0,36.0,0:0,0,0,0,4345.0,1:20,2750000
8471241,Mark,Fistric,1986-06-01,D,L,2011-12,60,0,2,2,0.03,-3,30,0.0,41,59435.0,16:30,1,0,1,100.0,235,105,10,19,-9,0,0,0,58.0,0:0,0,0,0,8000.0,2:13,1000000
8471242,Mike,Green,1985-10-12,D,R,2011-12,32,3,4,7,0.22,5,64,4.69,12,40403.0,21:2,0,0,0,0.0,27,44,23,30,-7,3,1,4,5220.0,2:43,0,0,0,2271.0,1:10,5250000
8471245,Dave,Bolland,1986-06-05,C,R,2011-12,76,19,18,37,0.49,0,126,15.08,47,75247.0,16:30,582,621,1203,48.38,58,38,53,25,28,7,5,12,9062.0,1:59,3,0,3,8057.0,1:46,3375000
8471254,Bryan,Bickell,1986-03-09,LW,L,2011-12,71,9,15,24,0.34,-3,84,10.71,48,51704.0,12:8,0,1,1,0.0,128,23,21,22,-1,0,0,0,2019.0,0:28,0,0,0,11.0,0:0,541667
8471260,Blake,Comeau,1986-02-18,LW,R,2011-12,74,5,10,15,0.2,-11,137,3.65,30,68600.0,15:27,29,62,91,31.87,144,22,37,33,4,0,0,0,2933.0,0:39,0,0,0,5704.0,1:17,2500000
8471261,Dane,Byers,1986-02-21,LW,L,2011-12,8,0,0,0,0.0,0,8,0.0,29,3882.0,8:5,0,0,0,0.0,4,4,2,0,2,0,0,0,0.0,0:0,0,0,0,438.0,0:54,550000
8471266,David,Booth,1984-11-24,LW,L,2011-12,62,16,14,30,0.48,-5,159,10.06,34,55541.0,14:55,9,9,18,50.0,81,13,20,25,-5,3,5,8,6587.0,1:46,0,0,0,112.0,0:1,4250000
8471269,Nicklas,Grossmann,1985-01-22,D,L,2011-12,74,0,11,11,0.15,5,56,0.0,36,83541.0,18:48,0,0,0,0.0,164,152,8,32,-24,0,0,0,363.0,0:4,0,0,0,9856.0,2:13,1625000
8471273,Brandon,Dubinsky,1986-04-29,C,L,2011-12,77,10,24,34,0.44,16,140,7.14,110,75181.0,16:16,205,190,395,51.9,207,36,37,21,16,0,2,2,8219.0,1:46,1,2,3,5778.0,1:15,4200000
8471274,Alex,Goligoski,1985-07-30,D,L,2011-12,71,9,21,30,0.42,0,140,6.43,16,97006.0,22:46,0,0,0,0.0,49,93,19,46,-27,2,7,9,13425.0,3:9,0,1,1,5457.0,1:16,1833333
8471276,David,Krejci,1986-04-28,C,R,2011-12,79,23,39,62,0.78,-5,145,15.86,36,87326.0,18:25,544,501,1045,52.06,69,46,43,34,9,2,9,11,11567.0,2:26,0,0,0,3425.0,0:43,3750000
8471279,Sami,Lepisto,1984-10-17,D,L,2011-12,26,1,2,3,0.12,3,19,5.26,4,16482.0,10:33,0,0,0,0.0,24,9,8,8,0,0,0,0,274.0,0:10,0,0,0,101.0,0:3,700000
8471283,Brandon,Prust,1984-03-16,LW,L,2011-12,82,5,12,17,0.21,-1,68,7.35,156,58766.0,11:56,3,2,5,60.0,144,51,15,23,-8,0,0,0,329.0,0:4,2,0,2,8211.0,1:40,800000
8471284,Andrej,Sekera,1986-06-08,D,L,2011-12,69,3,10,13,0.19,3,88,3.41,18,81155.0,19:36,0,1,1,0.0,56,93,25,30,-5,1,0,1,3582.0,0:51,0,0,0,6724.0,1:37,2750000
8471296,Alexei,Emelin,1986-04-25,D,L,2011-12,67,3,4,7,0.1,-18,62,4.84,30,69526.0,17:17,0,0,0,0.0,236,88,13,46,-33,0,0,0,691.0,0:10,1,1,2,5247.0,1:18,984200
8471299,Peter,Regin,1986-04-16,C,L,2011-12,10,2,2,4,0.4,3,15,13.33,2,8456.0,14:5,29,30,59,49.15,6,3,1,2,-1,0,0,0,568.0,0:56,0,0,0,489.0,0:48,1000000
8471303,Alexander,Edler,1986-04-21,D,L,2011-12,82,11,38,49,0.6,0,228,4.82,34,117414.0,23:51,0,3,3,0.0,143,145,32,51,-19,5,17,22,16948.0,3:26,1,0,1,11136.0,2:15,3250000
8471309,Johan,Franzen,1979-12-23,RW,L,2011-12,77,29,27,56,0.73,23,211,13.74,40,81809.0,17:42,79,100,179,44.13,60,30,30,35,-5,11,2,13,13614.0,2:56,0,0,0,152.0,0:1,3954545
8471311,Tyler,Kennedy,1986-07-15,C,R,2011-12,60,11,22,33,0.55,10,195,5.64,29,51735.0,14:22,42,47,89,47.19,70,10,19,11,8,0,3,3,5046.0,1:24,0,0,0,55.0,0:0,2000000
8471314,Mike,Lundin,1984-09-24,D,L,2011-12,17,0,2,2,0.12,-1,9,0.0,4,20611.0,20:12,0,0,0,0.0,3,35,0,4,-4,0,0,0,595.0,0:35,0,0,0,2564.0,2:30,1000000
8471321,Brett,Carson,1985-11-29,D,R,2011-12,2,0,0,0,0.0,-2,1,0.0,0,1363.0,11:21,0,0,0,0.0,0,1,0,0,0,0,0,0,0.0,0:0,0,0,0,33.0,0:16,575000
8471323,Ryan,Jones,1984-06-14,LW,L,2011-12,79,17,16,33,0.42,-7,137,12.41,42,73117.0,15:25,3,12,15,20.0,119,61,46,47,-1,3,3,6,4030.0,0:51,2,1,3,11700.0,2:28,1500000
8471331,Kevin,Porter,1986-03-12,C,L,2011-12,35,4,3,7,0.2,-2,32,12.5,17,19283.0,9:10,14,32,46,30.43,36,8,13,6,7,0,0,0,1016.0,0:29,0,0,0,613.0,0:17,850000
8471338,Torrey,Mitchell,1985-01-30,C,R,2011-12,76,9,10,19,0.25,-6,100,9.0,29,56706.0,12:26,36,47,83,43.37,94,33,33,27,6,0,0,0,684.0,0:9,0,0,0,2824.0,0:37,1366667
8471339,Ryan,Callahan,1985-03-21,RW,R,2011-12,76,29,25,54,0.71,-8,235,12.34,61,95929.0,21:2,10,10,20,50.0,271,88,51,16,35,13,4,17,16895.0,3:42,1,2,3,8276.0,1:48,4275000
8471346,Kris,Versteeg,1986-05-13,RW,R,2011-12,71,23,31,54,0.76,4,181,12.71,49,84816.0,19:54,21,44,65,32.31,52,19,62,36,26,8,10,18,14383.0,3:22,1,0,1,2749.0,0:38,3083333
8471348,Nikita,Nikitin,1986-06-16,D,L,2011-12,61,7,25,32,0.52,-10,103,6.8,18,84901.0,23:11,0,0,0,0.0,47,114,24,30,-6,3,6,9,10191.0,2:47,0,1,1,10037.0,2:44,600000
8471362,Mikhail,Grabovski,1984-01-31,C,L,2011-12,74,23,28,51,0.69,0,163,14.11,51,78178.0,17:36,466,439,905,51.49,56,32,49,45,4,5,5,10,9303.0,2:5,0,0,0,1273.0,0:17,2900000
8471371,Mike,Brown,1985-06-24,RW,R,2011-12,50,2,2,4,0.08,-8,56,3.57,74,27830.0,9:16,0,1,1,0.0,120,24,10,9,1,0,0,0,92.0,0:1,0,1,1,1897.0,0:37,736667
8471385,Adam,Pardy,1984-03-29,D,L,2011-12,36,0,3,3,0.08,-5,29,0.0,16,35574.0,16:28,0,0,0,0.0,39,49,9,9,0,0,0,0,194.0,0:5,0,0,0,1777.0,0:49,2000000
8471388,Patrick,Kaleta,1986-06-08,RW,R,2011-12,63,5,5,10,0.16,-5,69,7.25,116,49725.0,13:9,10,9,19,52.63,139,46,19,17,2,0,0,0,180.0,0:2,0,0,0,7263.0,1:55,907500
8471390,Mike,Santorelli,1985-12-14,C,R,2011-12,60,9,2,11,0.18,-10,117,7.69,18,44654.0,12:24,176,213,389,45.24,49,17,15,10,5,2,1,3,3945.0,1:5,0,0,0,127.0,0:2,1600000
8471392,Roman,Polak,1986-04-28,D,R,2011-12,77,0,11,11,0.14,6,88,0.0,57,87163.0,18:51,0,0,0,0.0,173,141,15,21,-6,0,0,0,371.0,0:4,0,0,0,10891.0,2:21,2750000
8471409,Andrew,Gordon,1985-12-13,RW,R,2011-12,37,2,3,5,0.14,-10,38,5.26,6,24098.0,10:51,0,5,5,0.0,49,17,8,7,1,0,0,0,203.0,0:5,0,0,0,4592.0,2:4,537500
8471426,Troy,Brouwer,1985-08-17,RW,R,2011-12,82,18,15,33,0.4,-15,133,13.53,61,84508.0,17:10,38,45,83,45.78,247,60,39,22,17,3,2,5,10514.0,2:8,0,1,1,7457.0,1:30,2350000
8471428,Pierre-Luc,Letourneau-Leblond,1985-06-04,RW,L,2011-12,3,0,0,0,0.0,1,3,0.0,10,874.0,4:51,0,0,0,0.0,2,0,0,1,-1,0,0,0,9.0,0:3,0,0,0,0.0,0:0,525000
8471436,Matt,Hunwick,1985-05-21,D,L,2011-12,33,3,3,6,0.18,-3,40,7.5,8,35756.0,18:3,0,1,1,0.0,24,30,11,19,-8,0,0,0,2118.0,1:4,0,0,0,2213.0,1:7,1550000
8471476,Daniel,Winnik,1985-03-06,LW,L,2011-12,84,8,15,23,0.27,-11,184,4.35,52,84133.0,16:41,33,33,66,50.0,95,50,55,24,31,0,0,0,1591.0,0:18,1,1,2,12337.0,2:26,950000
8471482,Grant,Clitsome,1985-04-14,D,L,2011-12,63,4,13,17,0.27,-9,87,4.6,32,64272.0,17:0,0,1,1,0.0,85,61,15,30,-15,1,4,5,7131.0,1:53,0,1,1,3002.0,0:47,1250000
8471483,Kyle,Wilson,1984-12-15,C,R,2011-12,5,0,0,0,0.0,-1,2,0.0,0,2443.0,8:8,0,1,1,0.0,7,1,1,3,-2,0,0,0,0.0,0:0,0,0,0,55.0,0:11,550000
8471490,Adam,Cracknell,1985-07-15,RW,R,2011-12,2,1,0,1,0.5,1,1,100.0,0,917.0,7:38,0,1,1,0.0,1,3,1,0,1,0,0,0,0.0,0:0,0,0,0,73.0,0:36,575000
8471498,Jannik,Hansen,1986-03-15,RW,R,2011-12,82,16,23,39,0.48,18,137,11.68,34,73294.0,14:53,12,17,29,41.38,118,24,39,23,16,0,0,0,701.0,0:8,1,2,3,10560.0,2:8,1350000
8471504,Rene,Bourque,1981-12-10,RW,L,2011-12,76,18,6,24,0.32,-19,158,11.39,68,81290.0,17:49,12,8,20,60.0,86,25,32,27,5,3,3,6,11125.0,2:26,1,0,1,8414.0,1:50,3333333
8471514,Rich,Peverley,1982-07-08,C,R,2011-12,57,11,31,42,0.74,20,112,9.82,22,57776.0,16:53,203,129,332,61.14,23,13,20,22,-2,1,10,11,9375.0,2:44,0,2,2,5702.0,1:40,1325000
8471521,Brad,Staubitz,1984-07-28,RW,R,2011-12,62,1,0,1,0.02,-5,27,3.7,121,24260.0,6:31,3,3,6,50.0,96,20,7,5,2,0,0,0,31.0,0:0,0,0,0,43.0,0:0,575000
8471636,Tim,Sestito,1984-08-28,LW,L,2011-12,18,0,0,0,0.0,-5,6,0.0,7,8912.0,8:15,31,44,75,41.33,28,5,1,3,-2,0,0,0,46.0,0:2,0,0,0,154.0,0:8,525000
8471657,Cody,McLeod,1984-06-26,LW,L,2011-12,75,6,5,11,0.15,0,62,9.68,164,32373.0,7:11,2,1,3,66.67,123,13,12,3,9,0,0,0,138.0,0:1,0,0,0,198.0,0:2,1033333
8471663,Mike,Blunden,1986-12-15,RW,R,2011-12,39,2,2,4,0.1,-1,34,5.88,27,21909.0,9:21,2,3,5,40.0,104,15,8,2,6,0,0,0,105.0,0:2,0,0,0,695.0,0:17,615000
8471664,Mason,Raymond,1985-09-17,LW,L,2011-12,55,10,10,20,0.36,4,125,8.0,18,51435.0,15:35,7,18,25,28.0,32,13,20,12,8,1,0,1,3776.0,1:8,1,0,1,2979.0,0:54,2550000
8471669,Paul,Stastny,1985-12-27,C,L,2011-12,79,21,32,53,0.67,-8,190,11.05,34,89265.0,18:49,789,635,1424,55.41,40,49,59,24,35,7,12,19,11154.0,2:21,0,0,0,2924.0,0:37,6600000
8471670,Guillaume,Latendresse,1987-05-24,LW,L,2011-12,16,5,4,9,0.56,6,36,13.89,20,14583.0,15:11,2,2,4,50.0,37,3,12,6,6,1,0,1,2453.0,2:33,0,0,0,0.0,0:0,2500000
8471675,Sidney,Crosby,1987-08-07,C,L,2011-12,22,8,29,37,1.68,15,75,10.67,14,24383.0,18:28,227,226,453,50.11,11,7,10,15,-5,2,9,11,5124.0,3:52,0,0,0,166.0,0:7,8700000
8471676,Bobby,Ryan,1987-03-17,RW,R,2011-12,82,31,26,57,0.7,1,204,15.2,53,90288.0,18:21,20,49,69,28.99,113,24,35,49,-14,3,8,11,10613.0,2:9,2,0,2,3508.0,0:42,5100000
8471677,Jack,Johnson,1987-01-13,D,L,2011-12,82,12,26,38,0.46,-7,176,6.82,39,116949.0,23:46,0,0,0,0.0,107,129,21,44,-23,5,12,17,19798.0,4:1,0,0,0,9336.0,1:53,4357143
8471678,Benoit,Pouliot,1986-09-29,LW,L,2011-12,74,16,16,32,0.43,18,107,14.95,38,54214.0,12:12,8,10,18,44.44,97,14,37,8,29,1,1,2,4761.0,1:4,0,0,0,38.0,0:0,1100000
8471680,Gilbert,Brule,1987-01-01,C,R,2011-12,33,5,9,14,0.42,7,56,8.93,11,22897.0,11:33,8,13,21,38.1,55,13,10,10,0,1,0,1,2164.0,1:5,0,0,0,0.0,0:0,1850000
8471681,Jack,Skille,1987-05-19,RW,R,2011-12,46,4,6,10,0.22,-9,76,5.26,28,33026.0,11:57,8,8,16,50.0,99,16,10,6,4,0,0,0,667.0,0:14,1,0,1,931.0,0:20,825000
8471682,Devin,Setoguchi,1987-01-01,RW,R,2011-12,69,19,17,36,0.52,-17,174,10.92,28,72844.0,17:35,3,8,11,27.27,73,23,31,23,8,7,6,13,11566.0,2:47,0,0,0,15.0,0:0,3000000
8471683,Brian,Lee,1987-03-26,D,R,2011-12,55,1,15,16,0.29,-8,32,3.12,35,51264.0,15:32,0,0,0,0.0,127,62,9,25,-16,0,0,0,878.0,0:15,0,0,0,4851.0,1:28,875000
8471685,Anze,Kopitar,1987-08-24,C,L,2011-12,82,25,51,76,0.93,12,230,10.87,20,104987.0,21:20,763,655,1418,53.81,72,53,76,56,20,8,18,26,16708.0,3:23,2,2,4,11037.0,2:14,6800000
8471686,Marc,Staal,1987-01-13,D,L,2011-12,46,2,3,5,0.11,-7,61,3.28,16,54902.0,19:53,0,0,0,0.0,55,68,14,19,-5,1,1,2,1331.0,0:28,0,1,1,4779.0,1:43,3975000
8471689,Ryan,O'Marra,1987-06-09,C,R,2011-12,9,0,1,1,0.11,-1,7,0.0,4,5010.0,9:16,36,29,65,55.38,19,7,2,2,0,0,0,0,26.0,0:2,0,0,0,273.0,0:30,735000
8471691,Martin,Hanzal,1987-02-20,C,L,2011-12,64,8,26,34,0.53,12,145,5.52,63,70827.0,18:26,571,526,1097,52.05,239,32,41,22,19,3,8,11,11306.0,2:56,0,0,0,5888.0,1:32,1800000
8471693,Jakub,Kindl,1987-02-10,D,L,2011-12,55,1,12,13,0.24,7,69,1.45,25,46377.0,14:3,0,0,0,0.0,61,32,15,19,-4,0,1,1,2067.0,0:37,0,0,0,894.0,0:16,883333
8471694,Kenndal,McArdle,1987-01-04,LW,L,2011-12,9,0,0,0,0.0,-3,3,0.0,4,3299.0,6:6,0,0,0,0.0,10,4,3,3,0,0,0,0,5.0,0:0,0,0,0,0.0,0:0,600000
8471697,Niclas,Bergfors,1987-03-07,RW,R,2011-12,11,1,1,2,0.18,-2,11,9.09,2,5328.0,8:4,0,0,0,0.0,0,5,4,2,2,0,0,0,397.0,0:36,0,0,0,0.0,0:0,575000
8471698,T.J.,Oshie,1986-12-23,RW,R,2011-12,80,19,35,54,0.68,15,188,10.11,50,93741.0,19:31,24,29,53,45.28,130,45,61,14,47,3,13,16,11918.0,2:28,1,1,2,8681.0,1:48,2350000
8471699,Andrew,Cogliano,1987-06-14,LW,L,2011-12,82,13,13,26,0.32,-4,115,11.3,15,72353.0,14:42,162,224,386,41.97,88,43,32,32,0,2,1,3,2756.0,0:33,0,0,0,7894.0,1:36,2390000
8471701,Joe,Finley,1987-06-29,D,L,2011-12,5,0,0,0,0.0,-3,1,0.0,12,2338.0,7:47,0,0,0,0.0,3,0,0,1,-1,0,0,0,0.0,0:0,0,0,0,10.0,0:2,533333
8471702,Matt,Niskanen,1986-12-06,D,R,2011-12,75,4,17,21,0.28,9,118,3.39,47,80725.0,17:56,0,0,0,0.0,105,69,13,20,-7,3,5,8,9971.0,2:12,0,0,0,2189.0,0:29,1500000
8471703,Steve,Downie,1987-04-03,RW,R,2011-12,75,14,27,41,0.55,-6,140,10.0,137,71692.0,15:55,40,47,87,45.98,105,25,49,32,17,2,4,6,8695.0,1:55,0,0,0,39.0,0:0,1850000
8471705,Brendan,Mikkelson,1987-06-22,D,L,2011-12,41,1,2,3,0.07,-4,45,2.22,13,35425.0,14:24,0,0,0,0.0,42,44,4,15,-11,0,1,1,3342.0,1:21,0,0,0,332.0,0:8,721875
8471707,James,Neal,1987-09-03,LW,L,2011-12,80,40,41,81,1.01,6,329,12.16,87,91845.0,19:8,4,11,15,26.67,108,15,30,26,4,18,12,30,18856.0,3:55,0,0,0,88.0,0:1,2875000
8471709,Marc-Edouard,Vlasic,1987-03-30,D,L,2011-12,82,4,19,23,0.28,11,119,3.36,40,113935.0,23:9,0,0,0,0.0,45,171,18,44,-26,0,1,1,2735.0,0:33,0,1,1,10461.0,2:7,3100000
8471710,Taylor,Chorney,1987-04-27,D,L,2011-12,5,0,0,0,0.0,-1,2,0.0,0,4243.0,14:8,0,0,0,0.0,0,4,3,3,0,0,0,0,386.0,1:17,0,0,0,86.0,0:17,735000
8471714,Michael,Sauer,1987-08-07,D,R,2011-12,19,1,2,3,0.16,9,14,7.14,21,21355.0,18:43,0,0,0,0.0,21,31,11,5,6,0,0,0,336.0,0:17,0,0,0,2082.0,1:49,1250000
8471716,Justin,Abdelkader,1987-02-25,LW,L,2011-12,81,8,14,22,0.27,4,121,6.61,62,59847.0,12:18,239,213,452,52.88,148,42,16,14,2,0,0,0,632.0,0:7,0,0,0,6894.0,1:25,787500
8471717,Adam,McQuaid,1986-10-12,D,R,2011-12,72,2,8,10,0.14,16,63,3.17,99,64594.0,14:57,0,0,0,0.0,104,101,9,18,-9,0,0,0,216.0,0:3,0,0,0,4476.0,1:2,575000
8471719,Matt,Kassian,1986-10-28,LW,L,2011-12,24,2,0,2,0.08,-2,13,15.38,55,7986.0,5:32,0,0,0,0.0,32,5,1,2,-1,0,0,0,14.0,0:0,0,0,0,0.0,0:0,512500
8471724,Kris,Letang,1987-04-24,D,R,2011-12,51,10,32,42,0.82,21,142,7.04,34,76006.0,24:50,0,0,0,0.0,83,86,28,34,-6,4,11,15,12544.0,4:5,1,1,2,5082.0,1:39,3500000
8471729,Kris,Russell,1987-05-02,D,L,2011-12,55,6,6,12,0.22,12,56,10.71,25,56143.0,17:0,0,0,0,0.0,61,78,16,13,3,0,1,1,6083.0,1:50,0,0,0,1078.0,0:19,1300000
8471735,Keith,Yandle,1986-09-09,D,L,2011-12,82,11,32,43,0.52,5,196,5.61,51,109903.0,22:20,0,0,0,0.0,31,77,24,75,-51,0,11,11,16976.0,3:27,0,0,0,815.0,0:9,5250000
8471742,Cody,Franson,1987-08-08,D,R,2011-12,57,5,16,21,0.37,-1,65,7.69,22,55371.0,16:11,0,0,0,0.0,102,53,20,45,-25,2,5,7,5215.0,1:31,0,0,0,199.0,0:3,800000
8471743,Vladimir,Sobotka,1987-07-02,LW,L,2011-12,73,5,15,20,0.27,12,117,4.27,42,69394.0,15:50,281,220,501,56.09,152,29,29,11,18,0,1,1,2824.0,0:38,1,0,1,8428.0,1:55,1300000
8471752,Marc-Andre,Gragnani,1987-03-11,D,L,2011-12,58,2,13,15,0.26,6,47,4.26,26,56179.0,16:8,1,0,1,100.0,19,41,10,33,-23,1,6,7,8346.0,2:23,0,0,0,506.0,0:8,550000
8471760,Cody,Bass,1987-01-07,C,R,2011-12,14,0,1,1,0.07,0,13,0.0,32,7633.0,9:5,5,3,8,62.5,22,7,4,4,0,0,0,0,70.0,0:5,0,0,0,714.0,0:51,600000
8471761,Chris,Butler,1986-10-27,D,L,2011-12,68,2,13,15,0.22,-9,62,3.23,34,88160.0,21:36,0,0,0,0.0,70,115,17,50,-33,0,3,3,2978.0,0:43,0,0,0,9118.0,2:14,1250000
8471762,Chris,VandeVelde,1987-03-15,C,L,2011-12,5,1,0,1,0.2,2,1,100.0,2,2958.0,9:51,18,22,40,45.0,4,3,2,1,1,0,0,0,0.0,0:0,0,0,0,569.0,1:53,745000
8471766,Jared,Boll,1986-05-13,RW,R,2011-12,54,2,1,3,0.06,-8,35,5.71,126,26303.0,8:7,3,2,5,60.0,96,10,7,3,4,0,0,0,221.0,0:4,0,0,0,0.0,0:0,725000
8471767,Blair,Jones,1986-09-27,C,R,2011-12,43,3,5,8,0.19,-1,58,5.17,18,29305.0,11:21,128,174,302,42.38,49,29,18,13,5,0,1,1,1993.0,0:46,0,0,0,1991.0,0:46,525000
8471768,Tom,Pyatt,1987-02-14,LW,L,2011-12,74,12,7,19,0.26,-19,95,12.63,8,65687.0,14:47,128,153,281,45.55,40,52,17,13,4,1,0,1,1677.0,0:22,0,0,0,9749.0,2:11,525000
8471769,Niklas,Hjalmarsson,1987-06-06,D,L,2011-12,69,1,14,15,0.22,9,65,1.54,14,83544.0,20:10,0,0,0,0.0,42,142,30,51,-21,0,0,0,400.0,0:5,0,1,1,9814.0,2:22,3500000
8471794,Darren,Helm,1987-01-21,LW,L,2011-12,68,9,17,26,0.38,5,124,7.26,12,59211.0,14:30,403,374,777,51.87,97,27,27,18,9,0,0,0,737.0,0:10,0,0,0,9367.0,2:17,912500
8471804,Nathan,Gerbe,1987-07-24,C,L,2011-12,62,6,19,25,0.4,2,137,4.38,32,52852.0,14:12,7,12,19,36.84,53,13,18,17,1,0,1,1,1328.0,0:21,0,1,1,1596.0,0:25,1450000
8471807,Tom,Wandell,1987-01-29,C,L,2011-12,72,6,9,15,0.21,-5,103,5.83,16,42066.0,9:44,141,183,324,43.52,52,30,37,15,22,0,0,0,2127.0,0:29,0,0,0,653.0,0:9,775000
8471810,Derek,Joslin,1987-03-17,D,L,2011-12,44,2,2,4,0.09,-15,36,5.56,35,27941.0,10:35,1,0,1,100.0,47,30,6,4,2,0,1,1,1495.0,0:33,0,0,0,1391.0,0:31,700000
8471811,Cal,O'Reilly,1986-09-30,C,L,2011-12,33,2,5,7,0.21,-11,17,11.76,4,25267.0,12:45,120,148,268,44.78,5,10,10,6,4,1,1,2,2824.0,1:25,0,0,0,450.0,0:13,1050000
8471816,Mark,Fayne,1987-05-15,D,R,2011-12,82,4,13,17,0.21,-4,94,4.26,26,99332.0,20:11,0,0,0,0.0,84,88,20,35,-15,0,2,2,7435.0,1:30,0,1,1,7063.0,1:26,542500
8471817,Ryan,Reaves,1987-01-20,RW,R,2011-12,60,3,1,4,0.07,0,32,9.38,124,23511.0,6:31,1,1,2,50.0,171,7,11,3,8,0,0,0,115.0,0:1,0,0,0,51.0,0:0,525000
8471840,Brett,Sutter,1987-06-02,LW,L,2011-12,15,0,3,3,0.2,-1,11,0.0,11,6816.0,7:34,14,7,21,66.67,23,1,3,3,0,0,0,0,27.0,0:1,0,0,0,246.0,0:16,525000
8471842,Tim,Kennedy,1986-04-30,LW,L,2011-12,27,1,1,2,0.07,-11,22,4.55,4,18036.0,11:8,64,77,141,45.39,48,11,9,7,2,0,0,0,710.0,0:26,0,0,0,268.0,0:9,550000
8471851,Matt,D'Agostini,1986-10-23,RW,R,2011-12,55,9,9,18,0.33,12,101,8.91,27,46264.0,14:1,8,21,29,27.59,48,18,19,8,11,3,0,3,5822.0,1:45,0,0,0,65.0,0:1,1650000
8471856,Joe,Vitale,1985-08-20,C,R,2011-12,68,4,10,14,0.21,-5,70,5.71,56,45610.0,11:10,403,320,723,55.74,106,36,17,8,9,0,0,0,200.0,0:2,0,1,1,2760.0,0:40,512500
8471859,Sergei,Kostitsyn,1987-03-20,LW,L,2011-12,75,17,26,43,0.57,8,97,17.53,34,74108.0,16:28,0,6,6,0.0,44,27,31,30,1,1,8,9,5770.0,1:16,1,0,1,4132.0,0:55,2500000
8471862,Colin,Greening,1986-03-09,C,L,2011-12,82,17,20,37,0.45,-4,184,9.24,46,76709.0,15:35,26,36,62,41.94,189,48,31,27,4,4,4,8,8679.0,1:45,0,0,0,799.0,0:9,816666
8471873,Anton,Stralman,1986-08-01,D,R,2011-12,53,2,16,18,0.34,9,55,3.64,20,54376.0,17:5,0,0,0,0.0,76,71,11,12,-1,0,4,4,3853.0,1:12,0,0,0,1924.0,0:36,900000
8471887,Patric,Hornqvist,1987-01-01,RW,R,2011-12,76,27,16,43,0.57,9,230,11.74,28,69910.0,15:19,6,3,9,66.67,62,28,28,12,16,8,2,10,11667.0,2:33,0,0,0,30.0,0:0,3083333
8471916,Mike,Angelidis,1985-06-27,LW,L,2011-12,6,1,0,1,0.17,-1,8,12.5,5,2339.0,6:29,4,3,7,57.14,6,2,3,1,2,0,0,0,0.0,0:0,0,0,0,0.0,0:0,525000
8471956,Andrew,Desjardins,1986-07-27,LW,L,2011-12,76,4,13,17,0.22,4,80,5.0,47,43692.0,9:34,192,170,362,53.04,93,49,37,25,12,0,0,0,130.0,0:1,0,1,1,3838.0,0:50,540000
8471958,Dan,Girardi,1984-04-29,D,R,2011-12,82,5,24,29,0.35,13,122,4.1,20,129140.0,26:14,0,0,0,0.0,211,185,37,61,-24,1,9,10,8670.0,1:45,0,1,1,16258.0,3:18,3325000
8471976,David,Desharnais,1986-09-14,C,L,2011-12,81,16,44,60,0.74,10,98,16.33,24,89410.0,18:23,678,693,1371,49.45,33,48,36,24,12,3,17,20,15994.0,3:17,0,0,0,2230.0,0:27,850000
8471978,Brett,Festerling,1986-03-03,D,L,2011-12,5,0,0,0,0.0,-1,2,0.0,2,3935.0,13:7,0,0,0,0.0,7,3,0,2,-2,0,0,0,0.0,0:0,0,0,0,312.0,1:2,577500
8472368,Chris,Conner,1983-12-23,RW,L,2011-12,8,1,2,3,0.38,2,10,10.0,0,5070.0,10:33,0,0,0,0.0,4,3,4,0,4,0,0,0,0.0,0:0,0,0,0,731.0,1:31,550000
8472382,Andy,Greene,1982-10-30,D,L,2011-12,56,1,15,16,0.29,3,53,1.89,16,65538.0,19:30,0,0,0,0.0,35,96,15,15,0,0,1,1,1479.0,0:26,0,0,0,6066.0,1:48,3000000
8472394,Peter,Harrold,1983-06-08,D,R,2011-12,11,0,2,2,0.18,0,11,0.0,0,9638.0,14:36,0,0,0,0.0,3,11,1,2,-1,0,1,1,498.0,0:45,0,0,0,133.0,0:12,550000
8472410,Stephen,Gionta,1983-10-09,RW,R,2011-12,1,1,0,1,1.0,1,2,50.0,0,637.0,10:37,5,3,8,62.5,1,1,0,0,0,0,0,0,0.0,0:0,0,0,0,0.0,0:0,512500
8472424,Ryan,Hamilton,1985-04-15,LW,L,2011-12,2,0,1,1,0.5,-1,1,0.0,2,1576.0,13:8,0,0,0,0.0,5,0,2,0,2,0,0,0,0.0,0:0,0,0,0,0.0,0:0,525000
8473412,Bryan,Little,1987-11-12,C,R,2011-12,74,24,22,46,0.62,-11,162,14.81,26,89766.0,20:13,733,746,1479,49.56,44,13,44,21,23,6,7,13,12260.0,2:45,0,1,1,6705.0,1:30,2383333
8473419,Brad,Marchand,1988-05-11,LW,L,2011-12,76,28,27,55,0.72,31,167,16.77,87,80359.0,17:37,5,4,9,55.56,72,21,40,41,-1,5,1,6,9852.0,2:9,1,2,3,6348.0,1:23,2500000
8473422,Nick,Foligno,1987-10-31,LW,L,2011-12,82,15,32,47,0.57,2,153,9.8,124,72053.0,14:38,62,87,149,41.61,196,30,35,26,9,1,3,4,6515.0,1:19,0,0,0,820.0,0:10,1200000
8473426,Mike,Weber,1987-12-16,D,L,2011-12,51,1,4,5,0.1,-19,51,1.96,64,56841.0,18:34,0,0,0,0.0,123,90,14,34,-20,0,0,0,205.0,0:4,0,0,0,5384.0,1:45,950000
8473432,Derek,Dorsett,1986-12-20,RW,R,2011-12,77,12,8,20,0.26,-11,137,8.76,235,67884.0,14:41,14,14,28,50.0,199,40,36,12,24,2,1,3,3653.0,0:47,1,0,1,8381.0,1:48,562500
8473446,Erik,Johnson,1988-03-21,D,R,2011-12,73,4,22,26,0.36,-7,155,2.58,26,91284.0,20:50,0,0,0,0.0,123,94,35,44,-9,1,11,12,10150.0,2:19,0,0,0,6892.0,1:34,2600000
8473449,Kyle,Okposo,1988-04-16,RW,R,2011-12,79,24,21,45,0.57,-15,152,15.79,46,80898.0,17:4,68,74,142,47.89,51,33,62,30,32,3,3,6,7957.0,1:40,0,0,0,458.0,0:5,2800000
8473453,Trevor,Lewis,1987-01-08,C,R,2011-12,72,3,4,7,0.1,-3,103,2.91,26,57183.0,13:14,87,112,199,43.72,117,25,25,20,5,0,0,0,1102.0,0:15,0,0,0,7477.0,1:43,725000
8473465,Jamie,McGinn,1988-08-05,LW,L,2011-12,78,20,17,37,0.47,-3,159,12.58,37,62931.0,13:26,6,1,7,85.71,159,37,29,25,4,6,2,8,3477.0,0:44,0,0,0,1058.0,0:13,680000
8473466,Ryan,White,1988-03-17,C,R,2011-12,20,0,3,3,0.15,-7,12,0.0,61,17420.0,14:31,29,30,59,49.15,61,17,5,4,1,0,0,0,148.0,0:7,0,1,1,2550.0,2:7,625000
8473473,Milan,Lucic,1988-06-07,LW,L,2011-12,81,26,35,61,0.75,7,149,17.45,135,82761.0,17:1,14,16,30,46.67,201,26,25,46,-21,7,4,11,10829.0,2:13,0,0,0,124.0,0:1,4083333
8473482,Jiri,Tlusty,1988-03-16,LW,L,2011-12,79,17,19,36,0.46,1,136,12.5,26,70654.0,14:54,3,8,11,27.27,83,57,31,20,11,2,4,6,4054.0,0:51,0,1,1,4627.0,0:58,525000
8473484,Kaspars,Daugavins,1988-05-18,LW,L,2011-12,65,5,6,11,0.17,-2,77,6.49,12,44192.0,11:19,23,37,60,38.33,58,33,27,24,3,0,1,1,506.0,0:7,0,1,1,7694.0,1:58,600000
8473485,Chris,Stewart,1987-10-30,RW,R,2011-12,79,15,15,30,0.38,1,166,9.04,109,73178.0,15:26,3,10,13,23.08,112,21,17,24,-7,2,2,4,7362.0,1:33,0,0,0,410.0,0:5,2875000
8473492,Matt,Beleskey,1988-06-07,LW,L,2011-12,70,4,11,15,0.21,-2,75,5.33,72,43113.0,10:15,11,15,26,42.31,104,20,10,10,0,0,1,1,1088.0,0:15,0,0,0,128.0,0:1,737500
8473493,Ben,Maxwell,1988-03-30,C,L,2011-12,15,1,5,6,0.4,4,10,10.0,2,6060.0,6:44,26,33,59,44.07,11,6,0,1,-1,0,0,0,64.0,0:4,0,0,0,119.0,0:7,715000
8473504,Cal,Clutterbuck,1987-11-18,RW,R,2011-12,74,15,12,27,0.36,-4,161,9.32,103,72623.0,16:21,5,10,15,33.33,288,31,28,21,7,3,4,7,9394.0,2:6,4,0,4,6598.0,1:29,1400000
8473507,Jeff,Petry,1987-12-09,D,R,2011-12,73,2,23,25,0.34,-7,111,1.8,26,95311.0,21:45,0,0,0,0.0,126,126,36,89,-53,1,5,6,5606.0,1:16,0,0,0,10902.0,2:29,850000
8473512,Claude,Giroux,1988-01-12,C,R,2011-12,77,28,65,93,1.21,6,242,11.57,29,99534.0,21:32,828,715,1543,53.66,70,44,50,44,6,6,32,38,18081.0,3:54,0,2,2,10346.0,2:14,3750000
8473526,Peter,Mueller,1988-04-14,C,R,2011-12,32,7,9,16,0.5,-3,82,8.54,8,28133.0,14:39,6,4,10,60.0,14,10,10,12,-2,1,4,5,2966.0,1:32,0,0,0,50.0,0:1,2000000
8473533,Jordan,Staal,1988-09-10,C,L,2011-12,62,25,25,50,0.81,11,149,16.78,34,74606.0,20:3,591,567,1158,51.04,101,23,39,26,13,5,2,7,7405.0,1:59,3,2,5,9808.0,2:38,4000000
8473534,Patrik,Berglund,1988-06-02,C,L,2011-12,82,19,19,38,0.46,4,188,10.11,30,88378.0,17:57,567,601,1168,48.54,97,36,39,24,15,0,4,4,11649.0,2:22,2,0,2,7531.0,1:31,2250000
8473537,Viktor,Stalberg,1986-01-17,LW,L,2011-12,79,22,21,43,0.54,6,215,10.23,34,66693.0,14:4,5,6,11,45.45,91,24,51,21,30,0,0,0,2145.0,0:27,0,0,0,139.0,0:1,875000
8473542,Tom,Sestito,1987-09-28,LW,L,2011-12,14,0,1,1,0.07,-3,4,0.0,83,5791.0,6:53,2,2,4,50.0,37,2,0,0,0,0,0,0,38.0,0:2,0,0,0,0.0,0:0,550000
8473544,Derick,Brassard,1987-09-22,C,L,2011-12,74,14,27,41,0.55,-20,125,11.2,42,72535.0,16:20,278,339,617,45.06,137,16,35,28,7,5,10,15,13581.0,3:3,0,0,0,546.0,0:7,3200000
8473546,Michael,Grabner,1987-10-05,RW,L,2011-12,78,20,12,32,0.41,-18,174,11.49,12,72746.0,15:32,3,2,5,60.0,16,30,94,45,49,1,1,2,3694.0,0:47,1,0,1,7900.0,1:41,3000000
8473548,Phil,Kessel,1987-10-02,RW,R,2011-12,82,37,45,82,1.0,-10,295,12.54,20,98671.0,20:3,9,19,28,32.14,12,21,39,82,-43,10,13,23,16453.0,3:20,0,0,0,438.0,0:5,5400000
8473558,Cory,Emmerton,1988-06-01,C,L,2011-12,71,6,4,10,0.14,1,63,9.52,14,34512.0,8:6,151,162,313,48.24,37,31,16,7,9,0,1,1,335.0,0:4,0,0,0,2189.0,0:30,533333
8473562,John,McCarthy,1986-08-09,C,L,2011-12,10,0,0,0,0.0,-2,14,0.0,10,5661.0,9:26,18,25,43,41.86,10,1,2,1,1,0,0,0,40.0,0:4,0,0,0,0.0,0:0,525000
8473563,Nicklas,Backstrom,1987-11-23,C,L,2011-12,42,14,30,44,1.05,-4,95,14.74,24,48294.0,19:9,353,338,691,51.09,31,25,28,18,10,3,16,19,8410.0,3:20,0,0,0,2535.0,1:0,6700000
8473564,Michael,Frolik,1988-02-17,RW,L,2011-12,63,5,10,15,0.24,-10,117,4.27,22,48661.0,12:52,16,32,48,33.33,56,32,41,6,35,0,0,0,681.0,0:10,0,1,1,3973.0,1:3,2333333
8473565,Brian,Strait,1988-01-04,D,L,2011-12,9,0,1,1,0.11,-2,4,0.0,4,6959.0,12:53,0,0,0,0.0,12,12,0,5,-5,0,0,0,0.0,0:0,0,0,0,215.0,0:23,601667
8473571,Jamie,McBain,1988-02-25,D,R,2011-12,76,8,19,27,0.36,-7,127,6.3,4,90273.0,19:47,0,0,0,0.0,15,106,30,40,-10,5,6,11,11750.0,2:34,0,0,0,2972.0,0:39,685000
8473573,Artem,Anisimov,1988-05-24,C,L,2011-12,79,16,20,36,0.46,12,132,12.12,34,73003.0,15:24,161,184,345,46.67,75,46,37,14,23,4,0,4,7653.0,1:36,1,0,1,4986.0,1:3,1875000
8473574,Shawn,Matthias,1988-02-19,LW,L,2011-12,79,10,14,24,0.3,-2,133,7.52,49,65458.0,13:48,295,302,597,49.41,60,38,25,13,12,1,1,2,2830.0,0:35,0,0,0,5297.0,1:7,851625
8473579,Nikolay,Kulemin,1986-07-14,LW,L,2011-12,70,7,21,28,0.4,2,107,6.54,6,63943.0,15:13,32,46,78,41.03,97,43,34,23,11,1,4,5,3625.0,0:51,0,1,1,5122.0,1:13,2350000
8473584,Andrew,MacDonald,1986-09-07,D,L,2011-12,75,5,14,19,0.25,-5,71,7.04,26,105187.0,23:22,0,0,0,0.0,48,185,50,56,-6,1,1,2,6086.0,1:21,0,0,0,9894.0,2:11,550000
8473588,Erik,Condra,1986-08-06,RW,R,2011-12,81,8,17,25,0.31,11,140,5.71,30,68840.0,14:9,11,16,27,40.74,16,69,48,23,25,0,0,0,396.0,0:4,2,2,4,13457.0,2:46,625000
8473589,Chris,Summers,1988-02-05,D,L,2011-12,21,0,3,3,0.14,-4,10,0.0,11,15689.0,12:27,0,0,0,0.0,50,19,2,2,0,0,0,0,0.0,0:0,0,0,0,1492.0,1:11,850000
8473600,Benn,Ferriero,1987-04-29,RW,R,2011-12,35,7,1,8,0.23,0,68,10.29,8,25304.0,12:2,3,9,12,25.0,43,13,9,3,6,0,0,0,659.0,0:18,0,0,0,32.0,0:0,605000
8473604,Jonathan,Toews,1988-04-29,C,L,2011-12,59,29,28,57,0.97,17,185,15.68,28,73786.0,20:50,675,462,1137,59.37,32,14,82,25,57,5,7,12,11609.0,3:16,1,2,3,6636.0,1:52,6300000
8473608,Blake,Geoffrion,1988-02-03,C,L,2011-12,35,2,3,5,0.14,0,29,6.9,27,23185.0,11:2,68,77,145,46.9,40,13,13,9,4,0,0,0,558.0,0:15,0,0,0,1540.0,0:44,850000
8473610,Bobby,Sanguinetti,1988-02-29,D,R,2011-12,3,0,0,0,0.0,0,5,0.0,0,2149.0,11:56,0,0,0,0.0,1,2,0,1,-1,0,0,0,511.0,2:50,0,0,0,2.0,0:0,600000
8473618,Mathieu,Perreault,1988-01-05,C,L,2011-12,64,16,14,30,0.47,9,60,26.67,24,46182.0,12:1,229,222,451,50.78,49,29,33,12,21,2,0,2,3862.0,1:0,0,0,0,79.0,0:1,525000
8473646,Ryan,Carter,1983-08-03,LW,L,2011-12,72,4,4,8,0.11,-13,50,8.0,90,44727.0,10:21,215,217,432,49.77,114,25,19,9,10,0,0,0,261.0,0:3,0,0,0,3872.0,0:53,750000
8473673,David,Schlemko,1987-05-07,D,L,2011-12,46,1,10,11,0.24,7,58,1.72,10,50665.0,18:21,0,0,0,0.0,52,88,5,20,-15,0,0,0,1005.0,0:21,0,0,0,5568.0,2:1,550000
8473682,Andrew,Ebbett,1983-01-02,C,L,2011-12,18,5,1,6,0.33,2,27,18.52,6,10350.0,9:35,15,13,28,53.57,15,9,4,3,1,1,0,1,829.0,0:46,0,0,0,389.0,0:21,525000
8473700,Ryan,Wilson,1987-02-03,D,L,2011-12,59,1,20,21,0.36,11,63,1.59,33,66319.0,18:44,0,1,1,0.0,97,70,33,28,5,0,4,4,2151.0,0:36,0,0,0,4626.0,1:18,1275000
8473712,Frazer,McLaren,1987-10-29,LW,L,2011-12,7,0,0,0,0.0,0,2,0.0,9,2049.0,4:52,0,0,0,0.0,6,2,2,0,2,0,0,0,0.0,0:0,0,0,0,0.0,0:0,575000
8473722,John,Scott,1982-09-26,LW,L,2011-12,35,0,1,1,0.03,-1,9,0.0,53,14071.0,6:42,0,0,0,0.0,39,10,8,10,-2,0,0,0,16.0,0:0,0,0,0,338.0,0:9,512500
8473908,Kevin,Westgarth,1984-02-07,RW,R,2011-12,25,1,1,2,0.08,-3,13,7.69,39,7892.0,5:15,0,1,1,0.0,31,6,1,7,-6,0,0,0,20.0,0:0,0,0,0,0.0,0:0,525000
8473914,Mark,Letestu,1985-02-04,C,R,2011-12,62,11,14,25,0.4,-9,114,9.65,8,58208.0,15:38,375,347,722,51.94,60,19,32,8,24,4,4,8,9654.0,2:35,0,0,0,2994.0,0:48,625000
8473921,Joe,Piskula,1984-07-05,D,L,2011-12,5,0,0,0,0.0,-5,2,0.0,2,3269.0,10:53,0,0,0,0.0,6,5,0,1,-1,0,0,0,0.0,0:0,0,0,0,22.0,0:4,525000
8473927,Brad,Mills,1983-05-03,C,R,2011-12,27,0,1,1,0.04,-10,18,0.0,32,11627.0,7:10,77,49,126,61.11,36,3,4,0,4,0,0,0,39.0,0:1,0,0,0,1258.0,0:46,525000
8473932,Darroll,Powe,1985-06-22,C,L,2011-12,82,6,7,13,0.16,-20,109,5.5,57,68800.0,13:59,46,59,105,43.81,151,91,22,11,11,0,0,0,311.0,0:3,0,0,0,12067.0,2:27,1066667
8473933,Ben,Lovejoy,1984-02-20,D,R,2011-12,34,1,4,5,0.15,3,48,2.08,13,27030.0,13:15,0,0,0,0.0,30,37,1,8,-7,0,0,0,78.0,0:2,0,0,0,1075.0,0:31,525000
8473942,Trevor,Smith,1985-02-08,C,L,2011-12,16,2,3,5,0.31,2,17,11.76,4,11967.0,12:27,34,49,83,40.96,19,7,3,3,0,0,0,0,531.0,0:33,0,1,1,892.0,0:55,525000
8473953,Derek,Smith,1984-10-13,D,L,2011-12,47,2,9,11,0.23,-1,44,4.55,12,44939.0,15:56,0,0,0,0.0,27,55,14,21,-7,0,4,4,2843.0,1:0,0,0,0,909.0,0:19,700000
8473962,Teddy,Purcell,1985-09-08,LW,R,2011-12,81,24,41,65,0.8,9,152,15.79,16,78402.0,16:7,3,14,17,17.65,17,11,34,36,-2,8,11,19,12413.0,2:33,0,0,0,210.0,0:2,2362500
8473970,Rob,Klinkhammer,1986-08-12,LW,L,2011-12,15,0,2,2,0.13,0,26,0.0,2,10299.0,11:26,2,1,3,66.67,47,3,7,3,4,0,0,0,34.0,0:2,0,0,0,1056.0,1:10,525000
8473991,Karl,Alzner,1988-09-24,D,L,2011-12,82,1,16,17,0.21,12,56,1.79,29,102701.0,20:52,0,0,0,0.0,74,139,18,48,-30,0,1,1,289.0,0:3,0,0,0,13466.0,2:44,1285000
8473992,Justin,Falk,1988-10-11,D,L,2011-12,47,1,8,9,0.19,-13,46,2.17,54,54969.0,19:29,0,0,0,0.0,78,78,12,20,-8,1,0,1,658.0,0:14,0,0,0,6554.0,2:19,605000
8473994,Jamie,Benn,1989-07-18,LW,L,2011-12,71,26,37,63,0.89,15,203,12.81,55,76999.0,18:4,347,404,751,46.21,136,52,56,51,5,2,8,10,9775.0,2:17,1,0,1,2969.0,0:41,630000
8473999,Nick,Palmieri,1989-07-12,RW,R,2011-12,38,4,3,7,0.18,-10,55,7.27,14,24130.0,10:35,2,9,11,18.18,39,7,5,9,-4,0,0,0,1438.0,0:37,0,0,0,80.0,0:2,536667
8474000,Steven,Kampfer,1988-09-24,D,R,2011-12,23,2,3,5,0.22,-1,20,10.0,6,20563.0,14:54,0,0,0,0.0,19,31,3,6,-3,0,0,0,1206.0,0:52,0,0,0,642.0,0:27,635000
8474001,TJ,Galiardi,1988-04-22,LW,L,2011-12,69,9,6,15,0.22,-8,113,7.96,53,54021.0,13:2,75,92,167,44.91,110,22,47,16,31,0,0,0,2500.0,0:36,1,0,1,3950.0,0:57,700000
8474009,Nick,Bonino,1988-04-20,C,L,2011-12,50,5,13,18,0.36,1,63,7.94,8,37431.0,12:28,195,259,454,42.95,18,39,28,9,19,0,1,1,2242.0,0:44,0,0,0,190.0,0:3,693000
8474013,Ian,Cole,1989-02-21,D,L,2011-12,26,1,5,6,0.23,7,18,5.56,22,24820.0,15:54,0,0,0,0.0,16,27,5,8,-3,0,0,0,485.0,0:18,0,0,0,709.0,0:27,875000
8474024,Jim,O'Brien,1989-01-29,C,R,2011-12,28,3,3,6,0.21,6,37,8.11,4,19749.0,11:45,121,135,256,47.27,28,9,14,6,8,0,0,0,84.0,0:3,0,0,0,3298.0,1:57,620833
8474025,Eric,Tangradi,1989-02-10,LW,L,2011-12,24,0,2,2,0.08,-4,20,0.0,16,12873.0,8:56,0,2,2,0.0,42,7,5,2,3,0,0,0,1052.0,0:43,0,0,0,0.0,0:0,708333
8474027,Justin,Braun,1987-02-10,D,R,2011-12,66,2,9,11,0.17,-2,113,1.77,23,65525.0,16:32,0,0,0,0.0,46,66,16,31,-15,1,2,3,4370.0,1:6,0,0,0,4018.0,1:0,662500
8474030,Aaron,Palushaj,1989-09-07,RW,R,2011-12,38,1,4,5,0.13,1,37,2.7,8,17251.0,7:33,0,4,4,0.0,28,11,9,5,4,0,0,0,97.0,0:2,0,0,0,52.0,0:1,737500
8474031,Kevin,Shattenkirk,1989-01-29,D,R,2011-12,81,9,34,43,0.53,20,178,5.06,60,104981.0,21:36,1,3,4,25.0,72,103,40,42,-2,5,13,18,13917.0,2:51,0,1,1,9353.0,1:55,875000
8474034,Patrick,Maroon,1988-04-23,LW,L,2011-12,2,0,0,0,0.0,0,1,0.0,2,1505.0,12:32,0,0,0,0.0,4,1,1,0,1,0,0,0,0.0,0:0,0,0,0,0.0,0:0,550000
8474035,Bill,Sweatt,1988-09-21,LW,L,2011-12,2,0,0,0,0.0,0,2,0.0,0,641.0,5:20,0,0,0,0.0,1,2,0,0,0,0,0,0,0.0,0:0,0,0,0,32.0,0:16,900000
8474037,James,van Riemsdyk,1989-05-04,LW,L,2011-12,43,11,13,24,0.56,-1,121,9.09,24,39142.0,15:10,2,3,5,40.0,37,18,17,8,9,2,3,5,7186.0,2:47,0,0,0,78.0,0:1,875000
8474038,Paul,Byron,1989-04-27,LW,L,2011-12,22,3,2,5,0.23,3,13,23.08,2,13504.0,10:13,8,14,22,36.36,26,2,8,9,-1,0,0,0,215.0,0:9,0,0,0,41.0,0:1,555000
8474040,Sam,Gagner,1989-08-10,C,R,2011-12,75,18,29,47,0.63,5,149,12.08,36,77322.0,17:10,334,367,701,47.65,21,23,27,36,-9,6,6,12,11092.0,2:27,0,0,0,212.0,0:2,2275000
8474042,Cody,Almond,1989-07-24,C,L,2011-12,10,1,0,1,0.1,-5,7,14.29,15,6128.0,10:12,25,33,58,43.1,15,8,3,2,1,0,0,0,45.0,0:4,0,0,0,627.0,1:2,585000
8474045,Zach,Hamill,1988-09-23,C,R,2011-12,16,0,2,2,0.12,3,13,0.0,4,10549.0,10:59,15,16,31,48.39,13,4,6,2,4,0,0,0,452.0,0:28,0,0,0,332.0,0:20,816667
8474048,Keith,Aulie,1989-06-11,D,L,2011-12,36,0,3,3,0.08,-7,18,0.0,29,29017.0,13:26,0,0,0,0.0,78,38,4,18,-14,0,0,0,12.0,0:0,0,0,0,2004.0,0:55,558333
8474049,Akim,Aliu,1989-04-24,RW,R,2011-12,2,2,1,3,1.5,3,3,66.67,12,1324.0,11:2,0,0,0,0.0,6,0,0,1,-1,0,0,0,42.0,0:21,0,0,0,0.0,0:0,713333
8474050,Brett,MacLean,1988-12-24,LW,R,2011-12,5,0,2,2,0.4,1,6,0.0,2,2545.0,8:29,0,0,0,0.0,3,1,2,0,2,0,1,1,132.0,0:26,0,0,0,26.0,0:5,735000
8474053,Logan,Couture,1989-03-28,C,L,2011-12,80,31,34,65,0.81,2,245,12.65,16,89102.0,18:33,468,442,910,51.43,42,76,61,36,25,11,15,26,12961.0,2:42,2,0,2,5272.0,1:5,816667
8474056,P.K.,Subban,1989-05-13,D,R,2011-12,81,7,29,36,0.44,9,205,3.41,119,118108.0,24:18,0,0,0,0.0,105,113,26,88,-62,5,9,14,16984.0,3:29,0,1,1,12702.0,2:36,875000
8474062,Riley,Nash,1989-05-09,C,R,2011-12,5,0,1,1,0.2,1,2,0.0,2,3172.0,10:34,11,24,35,31.43,1,1,7,0,7,0,0,0,476.0,1:35,0,0,0,0.0,0:0,704166
8474068,Kyle,Turris,1989-08-14,C,R,2011-12,55,12,17,29,0.53,10,142,8.45,31,55618.0,16:51,338,385,723,46.75,23,14,21,18,3,1,4,5,5967.0,1:48,0,0,0,346.0,0:6,1400000
8474074,Paul,Postma,1989-02-22,D,R,2011-12,3,0,0,0,0.0,0,3,0.0,0,1532.0,8:30,0,0,0,0.0,1,1,0,0,0,0,0,0,0.0,0:0,0,0,0,0.0,0:0,670833
8474089,Brad,Malone,1989-05-20,C,L,2011-12,9,0,2,2,0.22,1,6,0.0,0,5423.0,10:2,1,7,8,12.5,13,1,7,1,6,0,0,0,27.0,0:3,0,0,0,0.0,0:0,700000
8474090,Brendan,Smith,1989-02-08,D,L,2011-12,14,1,6,7,0.5,3,13,7.69,13,13130.0,15:37,0,0,0,0.0,17,8,5,4,1,0,1,1,1476.0,1:45,0,0,0,57.0,0:4,875000
8474091,Brandon,Sutter,1989-02-14,C,R,2011-12,82,17,15,32,0.39,-3,171,9.94,21,85598.0,17:23,654,641,1295,50.5,53,85,61,30,31,2,1,3,2201.0,0:26,3,0,3,11497.0,2:20,2066667
8474094,Matt,Halischuk,1988-06-01,RW,R,2011-12,73,15,13,28,0.38,9,96,15.62,27,49311.0,11:15,11,19,30,36.67,41,33,21,19,2,0,0,0,367.0,0:5,0,0,0,5609.0,1:16,712500
8474095,Dana,Tyrell,1989-04-23,C,L,2011-12,26,0,5,5,0.19,-5,23,0.0,6,16403.0,10:30,0,3,3,0.0,20,15,11,0,11,0,0,0,50.0,0:1,0,0,0,2430.0,1:33,683333
8474096,Nick,Spaling,1988-09-19,C,L,2011-12,77,10,12,22,0.29,-7,107,9.35,18,72579.0,15:42,448,446,894,50.11,43,38,45,17,28,0,0,0,790.0,0:10,0,1,1,9038.0,1:57,1050000
8474100,Dwight,King,1989-07-05,LW,L,2011-12,27,5,9,14,0.52,3,42,11.9,10,23716.0,14:38,2,1,3,66.67,37,5,6,6,0,0,2,2,2905.0,1:47,0,0,0,60.0,0:2,566667
8474102,David,Perron,1988-05-28,LW,R,2011-12,57,21,21,42,0.74,19,114,18.42,28,62540.0,18:17,2,8,10,20.0,32,13,29,9,20,5,5,10,9092.0,2:39,1,1,2,2515.0,0:44,2150000
8474113,TJ,Brennan,1989-04-03,D,L,2011-12,11,1,0,1,0.09,0,14,7.14,6,9320.0,14:7,0,0,0,0.0,20,6,1,2,-1,0,0,0,454.0,0:41,0,0,0,248.0,0:22,645833
8474121,Colton,Gillies,1989-02-12,C,L,2011-12,75,2,6,8,0.11,-9,48,4.17,35,45394.0,10:5,7,10,17,41.18,161,46,31,14,17,0,0,0,264.0,0:3,0,0,0,3265.0,0:43,625000
8474125,Carl,Gunnarsson,1986-11-09,D,L,2011-12,76,4,15,19,0.25,-9,89,4.49,20,98966.0,21:42,0,1,1,0.0,114,152,34,65,-31,0,6,6,5543.0,1:12,0,0,0,12030.0,2:38,1325000
8474130,Corey,Tropp,1989-07-25,RW,R,2011-12,34,3,5,8,0.24,0,32,9.38,20,20577.0,10:5,0,5,5,0.0,47,20,6,7,-1,0,0,0,70.0,0:2,0,0,0,225.0,0:6,586667
8474134,Yannick,Weber,1988-09-23,D,R,2011-12,60,4,14,18,0.3,-7,88,4.55,30,56228.0,15:37,0,0,0,0.0,49,47,18,43,-25,4,4,8,10179.0,2:49,0,0,0,3162.0,0:52,850000
8474137,Drayson,Bowman,1989-03-08,LW,L,2011-12,37,6,7,13,0.35,2,70,8.57,4,29643.0,13:21,0,0,0,0.0,54,10,10,8,2,0,1,1,1981.0,0:53,0,0,0,204.0,0:5,658333
8474138,Dustin,Jeffrey,1988-02-27,LW,L,2011-12,26,4,2,6,0.23,-4,33,12.12,2,18888.0,12:6,109,116,225,48.44,19,8,6,5,1,0,0,0,857.0,0:32,1,0,1,950.0,0:36,575000
8474141,Patrick,Kane,1988-11-19,RW,L,2011-12,82,23,43,66,0.8,7,253,9.09,40,99372.0,20:11,240,329,569,42.18,19,27,77,32,45,4,8,12,17046.0,3:27,0,0,0,363.0,0:4,6300000
8474145,Robert,Bortuzzo,1989-03-18,D,R,2011-12,6,0,0,0,0.0,1,3,0.0,2,3924.0,10:54,0,0,0,0.0,9,1,0,0,0,0,0,0,0.0,0:0,0,0,0,223.0,0:37,535000
8474149,Evgenii,Dadonov,1989-03-12,RW,L,2011-12,15,2,1,3,0.2,-4,21,9.52,2,9044.0,10:2,0,6,6,0.0,13,1,6,1,5,0,0,0,272.0,0:18,0,0,0,58.0,0:3,654167
8474150,Mikael,Backlund,1989-03-17,C,L,2011-12,41,4,7,11,0.27,-13,85,4.71,16,37843.0,15:23,225,271,496,45.36,25,19,29,17,12,2,1,3,2797.0,1:8,0,0,0,2387.0,0:58,845833
8474151,Ryan,McDonagh,1989-06-13,D,L,2011-12,82,7,25,32,0.39,25,123,5.69,44,121721.0,24:44,1,1,2,50.0,118,182,46,53,-7,0,2,2,3082.0,0:37,0,0,0,15067.0,3:3,875000
8474153,Michal,Repik,1988-12-31,RW,R,2011-12,17,2,3,5,0.29,-3,35,5.71,6,10567.0,10:21,3,2,5,60.0,24,1,8,2,6,1,2,3,716.0,0:42,0,0,0,0.0,0:0,629167
8474157,Max,Pacioretty,1988-11-20,LW,L,2011-12,79,33,32,65,0.82,2,286,11.54,56,86556.0,18:15,1,4,5,20.0,104,39,33,36,-3,4,9,13,15010.0,3:10,0,0,0,430.0,0:5,1625000
8474161,Jakub,Voracek,1989-08-15,RW,L,2011-12,78,18,31,49,0.63,11,190,9.47,32,76243.0,16:17,7,16,23,30.43,44,18,35,38,-3,0,11,11,15748.0,3:21,0,0,0,2584.0,0:33,2250000
8474163,Kevin,Marshall,1989-03-10,D,L,2011-12,10,0,0,0,0.0,-1,6,0.0,8,5256.0,8:45,0,0,0,0.0,8,4,2,1,1,0,0,0,0.0,0:0,0,0,0,53.0,0:5,666667
8474164,Jonathon,Blum,1989-01-30,D,R,2011-12,33,3,4,7,0.21,-14,25,12.0,6,35518.0,17:56,0,0,0,0.0,17,71,8,17,-9,0,0,0,2367.0,1:11,0,0,0,3220.0,1:37,816667
8474166,Alec,Martinez,1987-07-26,D,L,2011-12,51,6,6,12,0.24,-1,78,7.69,8,45043.0,14:43,0,1,1,0.0,51,48,1,11,-10,3,4,7,5452.0,1:46,0,0,0,372.0,0:7,737500
8474168,Joakim,Andersson,1989-02-05,C,L,2011-12,5,0,0,0,0.0,1,3,0.0,0,2000.0,6:40,5,1,6,83.33,5,1,0,0,0,0,0,0,0.0,0:0,0,0,0,0.0,0:0,612500
8474176,Carl,Hagelin,1988-08-23,LW,L,2011-12,64,14,24,38,0.59,21,131,10.69,24,57778.0,15:2,1,5,6,16.67,78,23,31,18,13,0,0,0,1337.0,0:20,2,0,2,1633.0,0:25,637500
8474184,Keaton,Ellerby,1988-11-05,D,L,2011-12,40,0,5,5,0.12,-3,45,0.0,10,36931.0,15:23,0,0,0,0.0,80,75,1,13,-12,0,0,0,224.0,0:5,0,0,0,2116.0,0:52,787500
8474189,Lars,Eller,1989-05-08,C,L,2011-12,79,16,12,28,0.35,-5,129,12.4,66,72575.0,15:18,319,366,685,46.57,72,55,42,31,11,2,1,3,3139.0,0:39,2,1,3,8041.0,1:41,845833
8474190,Wayne,Simmonds,1988-08-26,RW,R,2011-12,82,28,21,49,0.6,-1,197,14.21,114,78278.0,15:54,7,10,17,41.18,140,34,30,25,5,11,5,16,15841.0,3:13,0,0,0,193.0,0:2,1750000
8474192,Matt,Frattin,1988-01-03,RW,R,2011-12,56,8,7,15,0.27,-4,92,8.7,25,44235.0,13:9,2,6,8,25.0,81,12,22,15,7,0,1,1,2172.0,0:38,0,0,0,47.0,0:0,875000
8474201,Pierre-Cedric,Labrie,1986-12-06,LW,L,2011-12,14,0,2,2,0.14,-2,5,0.0,15,4956.0,5:54,3,2,5,60.0,36,5,4,2,2,0,0,0,0.0,0:0,0,0,0,0.0,0:0,525000
8474218,Jason,Demers,1988-06-09,D,R,2011-12,57,4,9,13,0.23,-8,73,5.48,22,57605.0,16:50,0,0,0,0.0,60,58,11,27,-16,2,3,5,6837.0,1:59,0,0,0,613.0,0:10,1250000
8474230,Micheal,Haley,1986-03-30,C,L,2011-12,14,0,0,0,0.0,-1,13,0.0,57,6674.0,7:56,1,1,2,50.0,31,2,2,1,1,0,0,0,83.0,0:5,0,0,0,148.0,0:10,550000
8474250,Zack,Smith,1988-04-05,LW,L,2011-12,81,14,12,26,0.32,4,134,10.45,98,68397.0,14:4,484,506,990,48.89,168,43,50,29,21,1,0,1,1128.0,0:13,2,1,3,10749.0,2:12,700000
8474291,Jay,Beagle,1985-10-16,C,R,2011-12,41,4,1,5,0.12,-2,49,8.16,23,29165.0,11:51,124,91,215,57.67,66,23,10,6,4,0,0,0,133.0,0:3,0,0,0,2601.0,1:3,512500
8474498,Jesse,Winchester,1983-10-04,C,R,2011-12,32,2,6,8,0.25,2,52,3.85,22,20423.0,10:38,126,109,235,53.62,51,9,13,6,7,0,0,0,44.0,0:1,1,0,1,4289.0,2:14,750000
8474518,Davis,Drewiske,1984-11-22,D,L,2011-12,9,2,0,2,0.22,0,11,18.18,2,6785.0,12:33,0,0,0,0.0,5,5,1,2,-1,0,0,0,40.0,0:4,0,0,0,246.0,0:27,616667
8474519,Jack,Hillen,1986-01-24,D,L,2011-12,55,2,4,6,0.11,6,51,3.92,20,46409.0,14:3,0,0,0,0.0,42,65,2,15,-13,0,0,0,81.0,0:1,0,0,0,2794.0,0:50,650000
8474520,Jason,Garrison,1984-11-13,D,L,2011-12,77,16,17,33,0.43,6,168,9.52,32,109490.0,23:41,1,1,2,50.0,127,124,20,30,-10,9,3,12,11661.0,2:31,0,1,1,11902.0,2:34,675000
8474535,Chris,Mueller,1986-03-06,C,R,2011-12,4,0,0,0,0.0,-1,4,0.0,0,2195.0,9:8,15,12,27,55.56,1,2,1,0,1,0,0,0,0.0,0:0,0,0,0,53.0,0:13,550000
8474551,Ville,Leino,1983-10-06,LW,L,2011-12,71,8,17,25,0.35,-2,78,10.26,16,67834.0,15:55,95,135,230,41.3,41,28,30,24,6,1,0,1,4466.0,1:2,0,0,0,252.0,0:3,4500000
8474552,Fabian,Brunnstrom,1985-02-06,LW,L,2011-12,5,0,1,1,0.2,-2,6,0.0,4,2719.0,9:3,0,0,0,0.0,4,1,3,1,2,0,0,0,39.0,0:7,0,0,0,0.0,0:0,600000
8474563,Drew,Doughty,1989-12-08,D,R,2011-12,77,10,26,36,0.47,-2,168,5.95,69,115035.0,24:53,0,0,0,0.0,124,70,26,65,-39,3,10,13,17146.0,3:42,0,0,0,10550.0,2:17,7000000
8474564,Steven,Stamkos,1990-02-07,C,R,2011-12,82,60,37,97,1.18,7,303,19.8,66,108340.0,22:1,558,669,1227,45.48,109,37,42,45,-3,12,13,25,18698.0,3:48,0,0,0,2726.0,0:33,7500000
8474565,Alex,Pietrangelo,1990-01-18,D,R,2011-12,81,12,39,51,0.63,16,202,5.94,36,120194.0,24:43,0,0,0,0.0,90,133,47,37,10,6,18,24,13983.0,2:52,0,1,1,15589.0,3:12,816667
8474566,Nikita,Filatov,1990-05-25,LW,R,2011-12,9,0,1,1,0.11,1,6,0.0,4,5302.0,9:49,0,1,1,0.0,8,1,1,7,-6,0,0,0,589.0,1:5,0,0,0,0.0,0:0,845833
8474567,Zach,Bogosian,1990-07-15,D,R,2011-12,65,5,25,30,0.46,-3,150,3.33,71,90933.0,23:18,0,0,0,0.0,117,109,17,41,-24,1,6,7,9607.0,2:27,0,0,0,11692.0,2:59,2500000
8474568,Luke,Schenn,1989-11-02,D,R,2011-12,79,2,20,22,0.28,-6,81,2.47,62,76007.0,16:2,0,0,0,0.0,270,115,28,58,-30,0,1,1,309.0,0:3,0,1,1,6340.0,1:20,3600000
8474569,Colin,Wilson,1989-10-20,C,L,2011-12,68,15,20,35,0.51,5,114,13.16,21,65811.0,16:7,39,38,77,50.65,43,21,30,35,-5,5,7,12,9509.0,2:19,0,0,0,27.0,0:0,875000
8474570,Cody,Hodgson,1990-02-18,C,R,2011-12,83,19,22,41,0.49,1,154,12.34,10,68836.0,13:49,329,381,710,46.34,37,29,34,26,8,7,7,14,9728.0,1:57,0,0,0,1102.0,0:13,816667
8474571,Mikkel,Boedker,1989-12-16,LW,L,2011-12,82,11,13,24,0.29,-2,86,12.79,12,67094.0,13:38,1,1,2,50.0,108,21,29,14,15,0,1,1,5196.0,1:3,0,0,0,1748.0,0:21,1100000
8474573,Josh,Bailey,1989-10-02,RW,L,2011-12,80,13,19,32,0.4,-10,104,12.5,32,73057.0,15:13,323,413,736,43.89,64,35,62,39,23,1,3,4,5803.0,1:12,3,0,3,7557.0,1:34,1050000
8474574,Tyler,Myers,1990-02-01,D,R,2011-12,55,8,15,23,0.42,5,84,9.52,33,74217.0,22:29,0,0,0,0.0,78,70,26,44,-18,3,4,7,7999.0,2:25,0,0,0,6977.0,2:6,875000
8474575,Colten,Teubert,1990-03-08,D,R,2011-12,24,0,1,1,0.04,-5,13,0.0,25,18204.0,12:38,0,0,0,0.0,68,28,1,9,-8,0,0,0,9.0,0:0,0,0,0,493.0,0:20,816667
8474576,Zach,Boychuk,1989-10-04,LW,L,2011-12,16,0,2,2,0.12,-3,10,0.0,0,8563.0,8:55,2,2,4,50.0,16,2,2,2,0,0,0,0,777.0,0:48,0,0,0,0.0,0:0,845833
8474577,Joe,Colborne,1990-01-30,C,L,2011-12,10,1,4,5,0.5,2,7,14.29,4,8213.0,13:41,28,50,78,35.9,20,8,4,5,-1,0,0,0,382.0,0:38,0,0,0,5.0,0:0,875000
8474578,Erik,Karlsson,1990-05-31,D,R,2011-12,81,19,59,78,0.96,16,261,7.28,42,123040.0,25:19,0,1,1,0.0,60,65,67,84,-17,3,25,28,18931.0,3:53,0,0,0,2728.0,0:33,875000
8474579,Luca,Sbisa,1990-01-30,D,L,2011-12,80,5,19,24,0.3,-5,88,5.68,66,86061.0,17:55,0,0,0,0.0,186,99,22,37,-15,0,3,3,3274.0,0:40,0,0,0,8011.0,1:40,2175000
8474581,Jake,Gardiner,1990-07-04,D,L,2011-12,75,7,23,30,0.4,-2,79,8.86,18,97131.0,21:35,0,0,0,0.0,52,90,34,73,-39,1,6,7,8899.0,1:58,0,0,0,7886.0,1:45,875000
8474582,Mattias,Tedenby,1990-02-21,RW,L,2011-12,43,1,5,6,0.14,-15,46,2.17,16,27737.0,10:45,1,2,3,33.33,25,1,11,8,3,0,0,0,744.0,0:17,0,0,0,416.0,0:9,875000
8474584,Michael,Del Zotto,1990-06-24,D,L,2011-12,77,10,31,41,0.53,20,113,8.85,36,103664.0,22:26,0,0,0,0.0,156,95,28,35,-7,1,13,14,19352.0,4:11,1,2,3,6453.0,1:23,875000
8474586,Jordan,Eberle,1990-05-15,C,R,2011-12,78,34,42,76,0.97,4,180,18.89,10,82355.0,17:35,12,15,27,44.44,45,24,40,47,-7,10,10,20,14093.0,3:0,0,0,0,837.0,0:10,875000
8474587,Greg,Nemisz,1990-06-05,RW,R,2011-12,9,0,0,0,0.0,1,2,0.0,0,4163.0,7:42,19,29,48,39.58,3,1,0,2,-2,0,0,0,29.0,0:3,0,0,0,0.0,0:0,845833
8474589,Tyler,Ennis,1989-10-06,LW,L,2011-12,48,15,19,34,0.71,11,82,18.29,14,46551.0,16:9,145,171,316,45.89,26,18,19,22,-3,2,2,4,5595.0,1:56,0,0,0,113.0,0:2,875000
8474590,John,Carlson,1990-01-10,D,R,2011-12,82,9,23,32,0.39,-15,152,5.92,22,107543.0,21:51,0,1,1,0.0,83,153,31,92,-61,4,3,7,7050.0,1:25,0,1,1,12131.0,2:27,845833
8474594,Slava,Voynov,1990-01-15,D,R,2011-12,54,8,12,20,0.37,12,86,9.3,12,60052.0,18:32,0,0,0,0.0,74,47,11,30,-19,3,3,6,8021.0,2:28,0,0,0,315.0,0:5,762500
8474600,Roman,Josi,1990-06-01,D,L,2011-12,52,5,11,16,0.31,1,64,7.81,14,57379.0,18:23,0,0,0,0.0,33,98,16,16,0,1,3,4,4200.0,1:20,0,0,0,3129.0,1:0,875000
8474604,Aaron,Ness,1990-05-18,D,L,2011-12,9,0,0,0,0.0,0,6,0.0,2,9146.0,16:56,0,0,0,0.0,2,17,2,3,-1,0,0,0,33.0,0:3,0,0,0,146.0,0:16,791667
8474606,Colby,Robak,1990-04-24,D,L,2011-12,3,0,0,0,0.0,1,1,0.0,0,2262.0,12:34,0,0,0,0.0,1,2,1,1,0,0,0,0,70.0,0:23,0,0,0,0.0,0:0,791667
8474609,Luke,Adam,1990-06-18,C,L,2011-12,52,10,10,20,0.38,-6,89,11.24,14,38694.0,12:24,114,145,259,44.02,26,15,24,16,8,0,3,3,5099.0,1:38,0,0,0,21.0,0:0,737500
8474610,Zac,Dalpe,1989-11-01,C,R,2011-12,16,1,2,3,0.19,-3,20,5.0,4,9201.0,9:35,5,6,11,45.45,16,4,5,3,2,0,0,0,897.0,0:56,0,0,0,20.0,0:1,704167
8474612,Travis,Hamonic,1990-08-16,D,R,2011-12,73,2,22,24,0.33,6,124,1.61,73,98231.0,22:25,0,0,0,0.0,170,157,37,52,-15,1,5,6,4629.0,1:3,0,0,0,10038.0,2:17,875000
8474613,Derek,Stepan,1990-06-18,C,R,2011-12,82,17,34,51,0.62,14,169,10.06,22,93212.0,18:56,386,481,867,44.52,137,44,51,25,26,4,12,16,15277.0,3:6,0,0,0,6339.0,1:17,820833
8474616,Patrice,Cormier,1990-06-14,C,L,2011-12,9,0,0,0,0.0,1,8,0.0,0,3437.0,6:21,22,8,30,73.33,12,0,0,1,-1,0,0,0,0.0,0:0,0,0,0,0.0,0:0,575000
8474618,Marco,Scandella,1990-02-23,D,L,2011-12,63,3,9,12,0.19,-22,77,3.9,19,82337.0,21:46,0,0,0,0.0,46,106,24,35,-11,1,5,6,6679.0,1:46,0,0,0,9129.0,2:24,643333
8474625,Jimmy,Hayes,1989-11-21,RW,R,2011-12,31,5,4,9,0.29,-3,41,12.2,16,19058.0,10:14,5,5,10,50.0,50,6,11,0,11,1,1,2,1204.0,0:38,0,0,0,41.0,0:1,654167
8474628,Michael,Stone,1990-06-07,D,R,2011-12,13,1,2,3,0.23,7,13,7.69,2,10829.0,13:53,0,0,0,0.0,16,18,1,2,-1,0,0,0,159.0,0:12,0,0,0,589.0,0:45,591667
8474634,Evgeny,Grachev,1990-02-21,C,R,2011-12,26,1,3,4,0.15,-4,14,7.14,2,14561.0,9:20,1,4,5,20.0,23,10,10,2,8,0,0,0,174.0,0:6,0,0,0,318.0,0:12,675000
8474641,Adam,Henrique,1990-02-06,C,L,2011-12,74,16,35,51,0.69,8,130,12.31,7,80631.0,18:9,501,525,1026,48.83,83,57,49,25,24,0,8,8,7300.0,1:38,4,3,7,7926.0,1:47,575000
8474642,Lance,Bouma,1990-03-25,LW,L,2011-12,27,1,2,3,0.11,-5,26,3.85,11,16464.0,10:9,11,11,22,50.0,45,26,8,6,2,0,0,0,219.0,0:8,0,0,0,813.0,0:30,563333
8474646,Brandon,McMillan,1990-03-22,LW,L,2011-12,25,0,4,4,0.16,-10,26,0.0,20,16824.0,11:12,23,44,67,34.33,21,13,2,1,1,0,0,0,77.0,0:3,0,0,0,3728.0,2:29,687500
8474649,Tomas,Kundratek,1989-12-26,D,R,2011-12,5,0,0,0,0.0,0,2,0.0,2,2925.0,9:45,0,0,0,0.0,3,4,1,2,-1,0,0,0,19.0,0:3,0,0,0,18.0,0:3,579167
8474659,Matt,Donovan,1990-05-09,D,L,2011-12,3,0,0,0,0.0,-3,6,0.0,0,3343.0,18:34,0,0,0,0.0,3,4,0,2,-2,0,0,0,201.0,1:7,0,0,0,55.0,0:18,875000
8474666,David,Ullstrom,1989-04-22,LW,L,2011-12,29,4,4,8,0.28,-2,40,10.0,6,19097.0,10:58,6,4,10,60.0,32,8,9,4,5,1,0,1,1625.0,0:56,0,0,0,87.0,0:3,637500
8474668,Dale,Weise,1988-08-05,RW,R,2011-12,68,4,4,8,0.12,-1,48,8.33,81,33290.0,8:9,0,4,4,0.0,118,23,14,8,6,0,0,0,207.0,0:3,0,0,0,144.0,0:2,605000
8474673,TJ,Brodie,1990-06-07,D,L,2011-12,54,2,12,14,0.26,3,44,4.55,14,53392.0,16:28,0,0,0,0.0,43,38,25,43,-18,1,5,6,5639.0,1:44,0,0,0,143.0,0:2,566667
8474679,Gustav,Nyquist,1989-09-01,RW,L,2011-12,18,1,6,7,0.39,2,19,5.26,2,11443.0,10:35,0,0,0,0.0,4,0,9,5,4,0,0,0,286.0,0:15,0,0,0,4.0,0:0,762500
8474681,Andrei,Loktionov,1990-05-30,C,L,2011-12,39,3,4,7,0.18,-4,60,5.0,2,29319.0,12:31,64,85,149,42.95,7,6,14,22,-8,1,0,1,1668.0,0:42,0,0,0,52.0,0:1,604167
8474685,Matt,Calvert,1989-12-24,LW,L,2011-12,13,0,3,3,0.23,-5,4,0.0,16,7120.0,9:7,0,0,0,0.0,8,1,3,2,1,0,0,0,53.0,0:4,0,0,0,0.0,0:0,712500
8474693,Tomas,Kubalik,1990-05-01,RW,R,2011-12,8,1,1,2,0.25,-3,8,12.5,6,6382.0,13:17,0,0,0,0.0,6,5,0,4,-4,0,0,0,737.0,1:32,0,0,0,0.0,0:0,613333
8474697,Mark,Borowiecki,1989-07-12,D,L,2011-12,2,0,0,0,0.0,-1,1,0.0,2,1499.0,12:29,0,0,0,0.0,4,0,0,1,-1,0,0,0,33.0,0:16,0,0,0,13.0,0:6,610000
8474707,Philip,Larsen,1989-12-07,D,R,2011-12,55,3,8,11,0.2,11,69,4.35,16,59253.0,17:57,0,0,0,0.0,89,73,10,32,-22,1,0,1,4216.0,1:16,0,0,0,1480.0,0:26,635000
8474709,Matt,Martin,1989-05-08,LW,L,2011-12,80,7,7,14,0.18,-17,130,5.38,121,58357.0,12:9,10,13,23,43.48,374,41,36,21,15,0,0,0,1841.0,0:23,0,2,2,6099.0,1:16,631667
8474715,Cam,Atkinson,1989-06-05,RW,R,2011-12,27,7,7,14,0.52,1,66,10.61,14,24928.0,15:23,0,1,1,0.0,23,17,15,9,6,1,1,2,4495.0,2:46,0,0,0,107.0,0:3,775000
8474716,Jared,Spurgeon,1989-11-29,D,R,2011-12,70,3,20,23,0.33,-4,92,3.26,6,90717.0,21:35,0,0,0,0.0,36,95,18,22,-4,2,10,12,11496.0,2:44,0,0,0,7152.0,1:42,526667
8474719,Teemu,Hartikainen,1990-05-03,C,L,2011-12,17,2,3,5,0.29,1,24,8.33,6,13272.0,13:0,4,8,12,33.33,36,11,4,5,-1,0,0,0,19.0,0:1,0,0,0,0.0,0:0,875000
8474727,Ben,Smith,1988-07-11,RW,R,2011-12,13,2,0,2,0.15,-5,18,11.11,0,7654.0,9:48,7,7,14,50.0,6,5,3,1,2,0,0,0,59.0,0:4,0,0,0,237.0,0:18,592500
8474736,Zac,Rinaldo,1990-06-15,C,L,2011-12,66,2,7,9,0.14,-1,54,3.7,232,29621.0,7:28,6,3,9,66.67,175,19,4,9,-5,0,0,0,233.0,0:3,0,0,0,16.0,0:0,540000
8474739,Tommy,Wingels,1988-04-12,C,R,2011-12,33,3,6,9,0.27,-1,71,4.23,18,27221.0,13:44,7,10,17,41.18,102,23,14,16,-2,0,1,1,1587.0,0:48,0,0,0,102.0,0:3,687500
8474772,Stu,Bickel,1986-10-02,D,R,2011-12,51,0,9,9,0.18,2,22,0.0,108,31945.0,10:26,1,0,1,100.0,68,52,5,8,-3,0,0,0,23.0,0:0,0,1,1,907.0,0:17,600000
8474774,Dalton,Prout,1990-03-13,D,R,2011-12,5,0,0,0,0.0,1,2,0.0,0,3538.0,11:47,0,0,0,0.0,5,3,1,1,0,0,0,0,30.0,0:6,0,0,0,67.0,0:13,666667
8474818,Jordie,Benn,1987-07-26,D,L,2011-12,3,0,2,2,0.67,1,1,0.0,0,2512.0,13:57,0,0,0,0.0,3,2,0,0,0,0,0,0,162.0,0:54,0,0,0,135.0,0:45,550000
8475060,Matt,Taormina,1986-10-20,D,L,2011-12,30,1,6,7,0.23,6,33,3.03,4,29762.0,16:32,0,0,0,0.0,18,36,6,8,-2,0,1,1,976.0,0:32,0,0,0,1169.0,0:38,550000
8475098,Tyler,Bozak,1986-03-19,C,R,2011-12,73,18,29,47,0.64,-7,109,16.51,22,82528.0,18:50,631,567,1198,52.67,117,34,40,26,14,4,8,12,12212.0,2:47,0,1,1,3003.0,0:41,1500000
8475148,Tim,Erixon,1991-02-24,D,L,2011-12,18,0,2,2,0.11,-2,9,0.0,8,14037.0,12:59,0,0,0,0.0,15,15,1,3,-2,0,0,0,751.0,0:41,0,0,0,298.0,0:16,900000
8475149,Marcus,Johansson,1990-10-06,LW,L,2011-12,80,14,32,46,0.57,-5,90,15.56,8,80657.0,16:48,307,403,710,43.24,61,28,39,47,-8,1,7,8,10991.0,2:17,0,0,0,2596.0,0:32,900000
8475150,Jordan,Caron,1990-11-02,RW,L,2011-12,48,7,8,15,0.31,0,57,12.28,14,33201.0,11:31,1,1,2,50.0,64,15,6,5,1,0,0,0,1115.0,0:23,0,0,0,875.0,0:18,886667
8475151,Kyle,Palmieri,1991-02-01,RW,R,2011-12,18,4,3,7,0.39,3,34,11.76,6,12442.0,11:31,2,0,2,100.0,20,6,1,7,-6,0,0,0,1017.0,0:56,0,0,0,50.0,0:2,900000
8475153,Dylan,Olsen,1991-01-03,D,L,2011-12,28,0,1,1,0.04,-5,16,0.0,6,21886.0,13:1,0,0,0,0.0,43,23,6,17,-11,0,0,0,34.0,0:1,0,0,0,1441.0,0:51,738333
8475154,Carter,Ashton,1991-04-01,RW,L,2011-12,15,0,0,0,0.0,-10,22,0.0,13,9375.0,10:25,1,1,2,50.0,32,2,4,4,0,0,0,0,45.0,0:3,0,0,0,0.0,0:0,840000
8475155,Simon,Despres,1991-07-27,D,L,2011-12,18,1,3,4,0.22,5,22,4.55,10,15358.0,14:13,0,0,0,0.0,19,17,5,7,-2,1,0,1,1191.0,1:6,0,0,0,646.0,0:35,840000
8475158,Ryan,O'Reilly,1991-02-07,C,L,2011-12,81,18,37,55,0.68,-1,189,9.52,12,94918.0,19:31,762,681,1443,52.81,62,50,101,34,67,4,11,15,11495.0,2:21,0,0,0,5687.0,1:10,880000
8475159,Carl,Klingberg,1991-01-28,LW,R,2011-12,6,0,0,0,0.0,-1,7,0.0,4,1979.0,5:29,0,0,0,0.0,1,0,1,0,1,0,0,0,0.0,0:0,0,0,0,0.0,0:0,760000
8475160,Kyle,Clifford,1991-01-13,LW,L,2011-12,81,5,7,12,0.15,-5,88,5.68,123,45719.0,9:24,1,7,8,12.5,179,9,8,21,-13,0,0,0,908.0,0:11,0,0,0,1085.0,0:13,710000
8475162,Mat,Clark,1990-10-17,D,R,2011-12,2,0,0,0,0.0,-2,2,0.0,0,1323.0,11:1,0,0,0,0.0,2,2,0,0,0,0,0,0,0.0,0:0,0,0,0,0.0,0:0,750000
8475165,Anton,Lander,1991-04-24,C,L,2011-12,56,2,4,6,0.11,-8,54,3.7,12,35664.0,10:36,149,195,344,43.31,32,12,15,14,1,0,0,0,347.0,0:6,1,0,1,5425.0,1:36,880000
8475166,John,Tavares,1990-09-20,C,L,2011-12,82,31,50,81,0.99,-6,286,10.84,26,101196.0,20:34,814,772,1586,51.32,27,23,99,65,34,7,18,25,15608.0,3:10,0,0,0,471.0,0:5,900000
8475167,Victor,Hedman,1990-12-18,D,L,2011-12,61,5,18,23,0.38,-9,82,6.1,65,84544.0,23:5,0,0,0,0.0,96,127,33,35,-2,0,4,4,4181.0,1:8,0,1,1,10656.0,2:54,900000
8475168,Matt,Duchene,1991-01-16,C,L,2011-12,58,14,14,28,0.48,-11,132,10.61,8,56684.0,16:17,200,191,391,51.15,43,41,31,21,10,5,4,9,8380.0,2:24,0,0,0,150.0,0:2,900000
8475169,Evander,Kane,1991-08-02,LW,L,2011-12,74,30,27,57,0.77,11,287,10.45,53,77776.0,17:31,15,29,44,34.09,173,31,35,18,17,6,3,9,9741.0,2:11,0,0,0,207.0,0:2,900000
8475170,Brayden,Schenn,1991-08-22,C,L,2011-12,54,12,6,18,0.33,-7,97,12.37,34,45763.0,14:7,201,235,436,46.1,136,26,11,15,-4,4,1,5,5468.0,1:41,0,0,0,331.0,0:6,870000
8475171,Oliver,Ekman-Larsson,1991-07-17,D,L,2011-12,82,13,19,32,0.39,0,147,8.84,32,108780.0,22:6,0,0,0,0.0,140,92,30,38,-8,2,6,8,10212.0,2:4,1,0,1,7040.0,1:25,900000
8475172,Nazem,Kadri,1990-10-06,C,L,2011-12,21,5,2,7,0.33,2,28,17.86,8,17841.0,14:9,4,11,15,26.67,25,5,8,9,-1,1,0,1,2023.0,1:36,0,0,0,14.0,0:0,870000
8475174,Jared,Cowen,1991-01-25,D,L,2011-12,82,5,12,17,0.21,-4,58,8.62,56,92952.0,18:53,0,0,0,0.0,217,74,28,38,-10,0,1,1,2958.0,0:36,0,1,1,15431.0,3:8,870000
8475175,Magnus,Paajarvi,1991-04-12,LW,L,2011-12,41,2,6,8,0.2,-7,79,2.53,4,32415.0,13:10,2,5,7,28.57,18,8,12,18,-6,0,2,2,2540.0,1:1,0,0,0,502.0,0:12,900000
8475176,Ryan,Ellis,1991-01-03,D,R,2011-12,32,3,8,11,0.34,5,34,8.82,4,28469.0,14:49,0,0,0,0.0,30,37,7,8,-1,2,2,4,3354.0,1:44,0,0,0,160.0,0:5,840000
8475177,Calvin,de Haan,1991-05-09,D,L,2011-12,1,0,0,0,0.0,1,2,0.0,0,781.0,13:1,0,0,0,0.0,2,0,0,0,0,0,0,0,0.0,0:0,0,0,0,106.0,1:46,870000
8475178,Zack,Kassian,1991-01-24,RW,R,2011-12,44,4,6,10,0.23,-2,54,7.41,51,29818.0,11:17,11,12,23,47.83,79,2,10,8,2,0,1,1,1408.0,0:32,0,0,0,7.0,0:0,870000
8475179,Dmitry,Kulikov,1990-10-29,D,L,2011-12,58,4,24,28,0.48,-5,104,3.85,36,76058.0,21:51,0,0,0,0.0,104,74,25,44,-19,2,8,10,9904.0,2:50,0,0,0,3628.0,1:2,900000
8475180,Peter,Holland,1991-01-14,C,L,2011-12,4,1,0,1,0.25,0,1,100.0,2,1849.0,7:42,7,11,18,38.89,4,1,0,0,0,0,0,0,50.0,0:12,0,0,0,0.0,0:0,870000
8475181,Nick,Leddy,1991-03-20,D,L,2011-12,82,3,34,37,0.45,-12,94,3.19,10,108646.0,22:4,0,0,0,0.0,67,78,30,41,-11,0,11,11,10396.0,2:6,0,0,0,6377.0,1:17,900000
8475182,David,Rundblad,1990-10-08,D,R,2011-12,30,1,6,7,0.23,-12,34,2.94,6,27017.0,15:0,0,0,0,0.0,34,28,6,19,-13,0,2,2,4051.0,2:15,0,0,0,62.0,0:2,900000
8475183,Louis,Leblanc,1991-01-26,C,R,2011-12,42,5,5,10,0.24,3,58,8.62,28,28219.0,11:11,28,36,64,43.75,68,18,15,9,6,0,0,0,998.0,0:23,0,0,0,239.0,0:5,870000
8475185,Jacob,Josefson,1991-03-02,C,L,2011-12,41,2,7,9,0.22,10,37,5.41,6,29763.0,12:5,181,173,354,51.13,16,13,13,9,4,0,0,0,409.0,0:9,0,0,0,2832.0,1:9,900000
8475186,John,Moore,1990-11-19,D,L,2011-12,67,2,5,7,0.1,-23,64,3.12,8,63603.0,15:49,0,0,0,0.0,47,70,4,13,-9,0,0,0,263.0,0:3,0,1,1,5365.0,1:20,840000
8475188,Brayden,McNabb,1991-01-21,D,L,2011-12,25,1,7,8,0.32,-1,23,4.35,15,26758.0,17:50,0,0,0,0.0,49,30,16,9,7,1,0,1,708.0,0:28,0,0,0,1993.0,1:19,715000
8475191,Reilly,Smith,1991-04-01,RW,L,2011-12,3,0,0,0,0.0,-3,2,0.0,2,1512.0,8:24,1,0,1,100.0,0,0,0,0,0,0,0,0,163.0,0:54,0,0,0,24.0,0:8,900000
8475197,Tyson,Barrie,1991-07-26,D,R,2011-12,10,0,0,0,0.0,-2,15,0.0,0,10588.0,17:38,0,0,0,0.0,9,10,4,5,-1,0,0,0,700.0,1:10,0,0,0,9.0,0:0,715000
8475200,Dmitry,Orlov,1991-07-23,D,L,2011-12,60,3,16,19,0.32,1,51,5.88,18,60749.0,16:52,0,1,1,0.0,99,54,23,48,-25,0,2,2,2670.0,0:44,0,0,0,2000.0,0:33,690000
8475204,Brandon,Pirri,1991-04-10,RW,L,2011-12,5,0,2,2,0.4,2,5,0.0,0,4055.0,13:31,26,28,54,48.15,5,2,5,2,3,0,0,0,196.0,0:39,0,0,0,59.0,0:11,618333
8475206,Stefan,Elliott,1991-01-30,D,R,2011-12,39,4,9,13,0.33,2,84,4.76,8,40112.0,17:8,0,0,0,0.0,3,31,7,14,-7,0,2,2,5470.0,2:20,0,0,0,166.0,0:4,843333
8475214,Jeremy,Morin,1991-04-16,LW,R,2011-12,3,0,0,0,0.0,-1,2,0.0,0,1595.0,8:51,0,0,0,0.0,4,0,0,0,0,0,0,0,18.0,0:6,0,0,0,0.0,0:0,735000
8475218,Mattias,Ekholm,1990-05-24,D,L,2011-12,2,0,0,0,0.0,-1,1,0.0,0,1490.0,12:25,0,0,0,0.0,0,3,0,1,-1,0,0,0,67.0,0:33,0,0,0,31.0,0:15,900000
8475220,Marcus,Foligno,1991-08-10,LW,L,2011-12,14,6,7,13,0.93,6,23,26.09,9,13285.0,15:48,0,3,3,0.0,44,11,7,2,5,2,1,3,1076.0,1:16,0,0,0,28.0,0:2,826667
8475225,Craig,Smith,1989-09-05,RW,R,2011-12,72,14,22,36,0.5,-9,172,8.14,30,61290.0,14:11,173,220,393,44.02,44,17,32,26,6,6,7,13,9246.0,2:8,0,0,0,94.0,0:1,715000
8475231,Casey,Cizikas,1991-02-27,C,L,2011-12,15,0,4,4,0.27,1,12,0.0,6,9541.0,10:36,47,68,115,40.87,26,9,1,1,0,0,0,0,77.0,0:5,0,0,0,164.0,0:10,793333
8475233,David,Savard,1990-10-22,D,R,2011-12,31,2,8,10,0.32,0,34,5.88,16,30829.0,16:34,0,0,0,0.0,30,15,5,10,-5,1,3,4,4303.0,2:18,0,0,0,340.0,0:10,740167
8475236,Cody,Eakin,1991-05-24,C,L,2011-12,30,4,4,8,0.27,2,31,12.9,4,16698.0,9:16,21,19,40,52.5,15,7,6,5,1,0,0,0,631.0,0:21,0,0,0,41.0,0:1,571667
8475248,Alexander,Urbom,1990-12-20,D,L,2011-12,5,1,0,1,0.2,1,3,33.33,9,4079.0,13:35,0,0,0,0.0,5,2,0,4,-4,0,0,0,8.0,0:1,0,0,0,172.0,0:34,563333
8475254,Gabriel,Dumont,1990-10-06,C,R,2011-12,3,0,0,0,0.0,-1,1,0.0,0,1541.0,8:33,3,15,18,16.67,7,1,1,1,0,0,0,0,0.0,0:0,0,0,0,104.0,0:34,571667
8475264,Roman,Horak,1991-05-21,C,L,2011-12,61,3,8,11,0.18,3,53,5.66,14,37322.0,10:11,183,258,441,41.5,28,20,14,11,3,0,0,0,1604.0,0:26,0,0,0,653.0,0:10,613333
8475266,Tomas,Vincour,1990-11-19,C,R,2011-12,47,4,6,10,0.21,-2,65,6.15,2,29129.0,10:19,1,8,9,11.11,52,16,19,8,11,0,0,0,1075.0,0:22,0,0,0,26.0,0:0,621667
8475268,Gabriel,Bourque,1990-09-23,LW,L,2011-12,43,7,12,19,0.44,-2,59,11.86,6,32995.0,12:47,0,1,1,0.0,66,19,20,9,11,0,0,0,196.0,0:4,0,0,0,287.0,0:6,618333
8475283,Lane,MacDermid,1989-08-25,LW,L,2011-12,5,0,0,0,0.0,-2,6,0.0,5,2671.0,8:54,0,0,0,0.0,10,3,1,0,1,0,0,0,17.0,0:3,0,0,0,23.0,0:4,576667
8475323,Marcus,Kruger,1990-05-27,C,L,2011-12,71,9,17,26,0.37,11,89,10.11,22,65602.0,15:23,284,335,619,45.88,26,36,25,22,3,0,3,3,6168.0,1:26,0,0,0,5710.0,1:20,735000
8475325,Jordan,Nolan,1989-06-23,C,L,2011-12,26,2,2,4,0.15,2,19,10.53,28,14583.0,9:20,1,0,1,100.0,59,4,3,4,-1,0,0,0,431.0,0:16,0,0,0,62.0,0:2,531667
8475430,Brandon,Manning,1990-06-04,D,L,2011-12,4,0,0,0,0.0,1,6,0.0,0,3294.0,13:43,0,0,0,0.0,6,2,2,1,1,0,0,0,0.0,0:0,0,0,0,4.0,0:1,715000
8475455,Brenden,Dillon,1990-11-13,D,L,2011-12,1,0,0,0,0.0,0,6,0.0,0,1199.0,19:59,0,0,0,0.0,4,3,0,1,-1,0,0,0,127.0,2:7,0,0,0,161.0,2:41,743333
8475602,Casey,Wellman,1987-10-18,C,R,2011-12,14,2,5,7,0.5,-4,25,8.0,0,10698.0,12:44,6,3,9,66.67,6,7,5,7,-2,0,1,1,1168.0,1:23,0,0,0,0.0,0:0,850500
8475603,Ben,Holmstrom,1987-04-09,C,R,2011-12,5,0,0,0,0.0,0,3,0.0,2,2016.0,6:43,15,15,30,50.0,8,4,0,1,-1,0,0,0,0.0,0:0,0,0,0,195.0,0:39,600000
8475613,Nate,Prosser,1986-05-07,D,R,2011-12,51,1,11,12,0.24,-17,32,3.12,57,58897.0,19:14,0,0,0,0.0,34,124,12,13,-1,0,3,3,2683.0,0:52,0,0,0,6361.0,2:4,715000
8475619,Aaron,Volpatti,1985-05-30,LW,L,2011-12,23,1,0,1,0.04,-2,17,5.88,37,12377.0,8:58,4,0,4,100.0,61,8,1,4,-3,0,0,0,115.0,0:5,0,0,0,30.0,0:1,612500
8475637,Bobby,Butler,1987-04-26,RW,R,2011-12,56,6,10,16,0.29,8,86,6.98,12,38565.0,11:28,3,0,3,100.0,34,13,26,18,8,0,0,0,2958.0,0:52,0,0,0,0.0,0:0,1050000
8475650,Brandon,Bollig,1987-01-31,LW,L,2011-12,18,0,0,0,0.0,-2,16,0.0,58,6361.0,5:53,0,0,0,0.0,27,6,0,0,0,0,0,0,20.0,0:1,0,0,0,0.0,0:0,545000
8475671,Matt,Fraser,1990-05-20,RW,L,2011-12,1,0,0,0,0.0,0,1,0.0,0,237.0,3:57,0,0,0,0.0,0,1,0,0,0,0,0,0,0.0,0:0,0,0,0,0.0,0:0,560000
8475690,Christopher,Tanev,1989-12-20,D,R,2011-12,25,0,2,2,0.08,10,15,0.0,2,25086.0,16:43,0,0,0,0.0,10,43,5,8,-3,0,0,0,153.0,0:6,0,0,0,1333.0,0:53,900000
8475692,Mats,Zuccarello,1987-09-01,RW,L,2011-12,10,2,1,3,0.3,0,10,20.0,6,6026.0,10:2,0,0,0,0.0,8,3,2,2,0,1,1,2,1806.0,3:0,0,0,0,38.0,0:3,900000
8475722,Jason,Zucker,1992-01-16,LW,L,2011-12,6,0,2,2,0.33,-2,10,0.0,2,3969.0,11:1,0,0,0,0.0,5,2,2,2,0,0,0,0,107.0,0:17,0,0,0,0.0,0:0,771667
8475753,Justin,Faulk,1992-03-20,D,R,2011-12,66,8,14,22,0.33,-16,101,7.92,29,90463.0,22:50,0,0,0,0.0,113,85,32,20,12,5,7,12,12031.0,3:2,0,0,0,7195.0,1:49,840000
8475757,Brett,Bulmer,1992-04-26,RW,R,2011-12,9,0,3,3,0.33,1,7,0.0,6,5957.0,11:1,0,0,0,0.0,17,2,0,0,0,0,0,0,268.0,0:29,0,0,0,0.0,0:0,810000
8475758,Devante,Smith-Pelly,1992-06-14,RW,R,2011-12,49,7,6,13,0.27,-7,66,10.61,16,35409.0,12:2,6,15,21,28.57,104,9,5,19,-14,1,1,2,2146.0,0:43,1,0,1,3547.0,1:12,720000
8475764,Cam,Fowler,1991-12-05,D,L,2011-12,82,5,24,29,0.35,-28,123,4.07,18,114442.0,23:15,1,0,1,100.0,43,94,23,42,-19,2,9,11,18072.0,3:40,0,0,0,3450.0,0:42,900000
8475768,Jaden,Schwartz,1992-06-25,LW,L,2011-12,7,2,1,3,0.43,1,6,33.33,0,4909.0,11:41,1,1,2,50.0,1,5,1,2,-1,1,0,1,348.0,0:49,0,0,0,0.0,0:0,830000
8475772,Riley,Sheahan,1991-12-07,C,L,2011-12,1,0,0,0,0.0,0,3,0.0,4,363.0,6:3,0,0,0,0.0,1,1,0,0,0,0,0,0,0.0,0:0,0,0,0,0.0,0:0,785000
8475784,Jeff,Skinner,1992-05-16,LW,L,2011-12,64,20,24,44,0.69,-8,210,9.52,56,71519.0,18:37,67,92,159,42.14,44,15,46,40,6,4,9,13,12909.0,3:21,0,0,0,876.0,0:13,900000
8475788,Alexander,Burmistrov,1991-10-21,C,L,2011-12,76,13,15,28,0.37,4,123,10.57,42,75981.0,16:39,248,316,564,43.97,118,15,42,31,11,1,2,3,5599.0,1:13,1,0,1,8152.0,1:47,900000
8475790,Erik,Gudbranson,1992-01-07,D,R,2011-12,72,2,6,8,0.11,-19,76,2.63,78,61335.0,14:11,0,0,0,0.0,154,73,3,17,-14,0,1,1,2157.0,0:29,0,0,0,1321.0,0:18,900000
8475791,Taylor,Hall,1991-11-14,LW,L,2011-12,61,27,26,53,0.87,-3,207,13.04,36,66680.0,18:13,23,34,57,40.35,44,34,35,62,-27,13,8,21,11206.0,3:3,0,0,0,160.0,0:2,900000
8475792,Brett,Connolly,1992-05-02,RW,R,2011-12,68,4,11,15,0.22,-9,94,4.26,30,46803.0,11:28,20,32,52,38.46,58,19,9,21,-12,1,2,3,4899.0,1:12,0,0,0,46.0,0:0,900000
8475793,Ryan,Johansen,1992-07-31,C,R,2011-12,67,9,12,21,0.31,-2,99,9.09,24,51196.0,12:44,97,118,215,45.12,68,24,20,11,9,3,1,4,6733.0,1:40,0,0,0,202.0,0:3,870000
8475794,Tyler,Seguin,1992-01-31,C,R,2011-12,81,29,38,67,0.83,34,242,11.98,30,82324.0,16:56,46,60,106,43.4,26,17,30,42,-12,5,10,15,11962.0,2:27,0,0,0,114.0,0:1,900000
8475799,Nino,Niederreiter,1992-09-08,RW,L,2011-12,55,1,0,1,0.02,-29,74,1.35,12,33381.0,10:6,0,2,2,0.0,129,14,21,13,8,0,0,0,1323.0,0:24,0,0,0,0.0,0:0,870000
8476116,Ryan,Garbutt,1985-08-12,C,L,2011-12,20,2,1,3,0.15,-1,28,7.14,22,9939.0,8:16,12,15,27,44.44,48,3,1,4,-3,0,0,0,22.0,0:1,0,0,0,136.0,0:6,590000
8476158,Harry,Zolnierczyk,1987-09-01,LW,L,2011-12,37,3,3,6,0.16,-11,49,6.12,35,17104.0,7:42,12,16,28,42.86,67,14,4,3,1,0,0,0,279.0,0:7,0,0,0,572.0,0:15,775000
8476177,Matt,Read,1986-06-14,RW,R,2011-12,79,24,23,47,0.59,13,155,15.48,12,80869.0,17:3,142,204,346,41.04,82,58,36,27,9,4,7,11,11458.0,2:25,2,1,3,12288.0,2:35,900000
8476205,Stephane,Da Costa,1989-07-11,C,R,2011-12,22,3,2,5,0.23,-9,31,9.68,8,16051.0,12:9,65,112,177,36.72,14,13,8,5,3,0,0,0,2107.0,1:35,0,0,0,14.0,0:0,900000
8476206,Andy,Miele,1988-04-15,C,L,2011-12,7,0,0,0,0.0,-3,4,0.0,6,3754.0,8:56,7,21,28,25.0,11,0,0,2,-2,0,0,0,404.0,0:57,0,0,0,5.0,0:0,900000
8476211,Carter,Camper,1988-07-06,C,R,2011-12,3,1,0,1,0.33,1,1,100.0,0,1206.0,6:42,6,8,14,42.86,1,2,0,1,-1,0,0,0,0.0,0:0,0,0,0,0.0,0:0,625000
8476244,Raphael,Diaz,1986-01-09,D,R,2011-12,59,3,13,16,0.27,-7,61,4.92,30,63736.0,18:0,1,1,2,50.0,40,102,13,38,-25,0,4,4,5853.0,1:39,0,2,2,4749.0,1:20,900000
8476381,Andrew,Shaw,1991-07-20,RW,R,2011-12,37,12,11,23,0.62,-1,74,16.22,50,33761.0,15:12,41,47,88,46.59,82,21,16,5,11,0,4,4,3545.0,1:35,0,0,0,597.0,0:16,573333
8476438,Brandon,Saad,1992-10-27,LW,L,2011-12,2,0,0,0,0.0,0,3,0.0,0,1682.0,14:1,0,0,0,0.0,0,1,2,0,2,0,0,0,164.0,1:22,0,0,0,3.0,0:1,795000
8476454,Ryan,Nugent-Hopkins,1993-04-12,C,L,2011-12,62,18,34,52,0.84,-2,134,13.43,16,65493.0,17:36,227,378,605,37.52,38,33,34,32,2,3,20,23,11205.0,3:0,0,0,0,120.0,0:1,925000
8476455,Gabriel,Landeskog,1992-11-23,LW,L,2011-12,82,22,30,52,0.63,20,270,8.15,51,91571.0,18:36,8,28,36,22.22,219,58,58,35,23,6,6,12,10590.0,2:9,0,2,2,6605.0,1:20,925000
8476457,Adam,Larsson,1992-11-12,D,R,2011-12,65,2,16,18,0.28,-7,68,2.94,20,80420.0,20:37,0,0,0,0.0,94,67,12,44,-32,0,4,4,6405.0,1:38,0,1,1,1717.0,0:26,925000
8476459,Mika,Zibanejad,1993-04-18,C,R,2011-12,9,0,1,1,0.11,-3,12,0.0,2,6966.0,12:54,22,28,50,44.0,15,5,4,1,3,0,1,1,567.0,1:3,0,0,0,66.0,0:7,925000
8476460,Mark,Scheifele,1993-03-15,C,R,2011-12,7,1,0,1,0.14,0,5,20.0,0,4597.0,10:56,18,33,51,35.29,3,1,0,2,-2,1,0,1,499.0,1:11,0,0,0,170.0,0:24,925000
8476461,Sean,Couturier,1992-12-07,C,L,2011-12,77,13,14,27,0.35,18,116,11.21,14,65323.0,14:8,378,426,804,47.01,82,33,48,26,22,0,1,1,2072.0,0:26,2,0,2,12461.0,2:41,925000
8476466,Sven,Baertschi,1992-10-05,LW,L,2011-12,5,3,0,3,0.6,2,10,30.0,4,3341.0,11:8,0,0,0,0.0,5,0,3,0,3,0,0,0,173.0,0:34,0,0,0,0.0,0:0,925000
8476792,Torey,Krug,1991-04-12,D,L,2011-12,2,0,1,1,0.5,0,3,0.0,0,2055.0,17:7,0,0,0,0.0,0,4,0,0,0,0,0,0,129.0,1:4,0,0,0,46.0,0:23,916667
8476806,J.T.,Brown,1990-07-02,RW,R,2011-12,5,0,1,1,0.2,2,13,0.0,0,4157.0,13:51,0,0,0,0.0,2,3,1,2,-1,0,0,0,497.0,1:39,0,0,0,0.0,0:0,925000
8448208,Jaromir,Jagr,1972-02-15,RW,L,2012-13,45,16,19,35,0.78,-2,115,13.91,22,49491.0,18:19,0,1,1,0.0,13,10,19,28,-9,6,5,11,8353.0,3:5,0,0,0,94.0,0:2,4500000
8457981,Teemu,Selanne,1970-07-03,RW,R,2012-13,46,12,12,24,0.52,-10,96,12.5,28,43311.0,15:41,85,83,168,50.6,8,10,23,31,-8,3,4,7,6010.0,2:10,0,0,0,53.0,0:1,4500000
8458537,Ray,Whitney,1972-05-08,LW,R,2012-13,32,11,18,29,0.91,1,62,17.74,4,37240.0,19:23,16,35,51,31.37,10,14,29,41,-12,4,8,12,7105.0,3:42,0,0,0,142.0,0:4,4500000
8458951,Sergei,Gonchar,1974-04-13,D,L,2012-13,45,3,24,27,0.6,4,85,3.53,26,64781.0,23:59,0,0,0,0.0,25,65,10,28,-18,2,10,12,10043.0,3:43,0,0,0,6030.0,2:14,5500000
8459444,Todd,Bertuzzi,1975-02-02,RW,L,2012-13,7,2,1,3,0.43,3,10,20.0,2,6518.0,15:31,0,0,0,0.0,6,1,0,4,-4,0,0,0,1361.0,3:14,0,0,0,3.0,0:0,2075000
8459454,Jay,Pandolfo,1974-12-27,LW,L,2012-13,18,0,0,0,0.0,-2,11,0.0,2,9799.0,9:4,2,3,5,40.0,25,8,1,3,-2,0,0,0,0.0,0:0,0,0,0,1321.0,1:13,600000
8459457,Jamie,Langenbrunner,1975-07-24,RW,R,2012-13,4,0,1,1,0.25,1,5,0.0,0,2347.0,9:46,0,4,4,0.0,4,0,0,1,-1,0,0,0,80.0,0:20,0,0,0,298.0,1:14,1250000
8459514,Jamal,Mayers,1974-10-24,RW,R,2012-13,19,0,2,2,0.11,2,10,0.0,16,7946.0,6:58,42,36,78,53.85,26,4,3,2,1,0,0,0,155.0,0:8,0,0,0,232.0,0:12,600000
8459628,Hal,Gill,1975-04-06,D,L,2012-13,32,0,0,0,0.0,-3,8,0.0,12,25699.0,13:23,0,0,0,0.0,28,38,7,12,-5,0,0,0,2.0,0:0,0,0,0,4998.0,2:36,2000000
8459670,Kimmo,Timonen,1975-03-18,D,L,2012-13,45,5,24,29,0.64,3,78,6.41,36,58769.0,21:45,0,0,0,0.0,31,79,13,21,-8,3,14,17,10282.0,3:48,0,0,0,7895.0,2:55,6333333
8460492,Ed,Jovanovski,1976-06-26,D,L,2012-13,6,0,1,1,0.17,-4,6,0.0,0,5639.0,15:39,0,0,0,0.0,3,8,1,6,-5,0,0,0,287.0,0:47,0,0,0,967.0,2:41,4125000
8460496,Ryan,Smyth,1976-02-21,LW,L,2012-13,47,2,11,13,0.28,-5,69,2.9,40,43345.0,15:22,87,115,202,43.07,41,24,15,26,-11,0,1,1,3542.0,1:15,1,0,1,7132.0,2:31,2250000
8460542,Patrik,Elias,1976-04-13,C,L,2012-13,48,14,22,36,0.75,5,118,11.86,22,53912.0,18:43,71,92,163,43.56,20,14,26,21,5,5,9,14,10097.0,3:30,1,0,1,4798.0,1:39,6000000
8460561,Sheldon,Souray,1976-07-13,D,L,2012-13,44,7,10,17,0.39,19,80,8.75,52,55253.0,20:55,1,0,1,100.0,34,58,9,32,-23,2,3,5,4827.0,1:49,0,0,0,6585.0,2:29,3666667
8460621,Daniel,Alfredsson,1972-12-11,RW,R,2012-13,47,10,16,26,0.55,1,101,9.9,33,54566.0,19:20,16,22,38,42.11,28,30,37,36,1,3,8,11,8408.0,2:58,0,1,1,4507.0,1:35,4875000
8460626,Bryce,Salvador,1976-02-11,D,L,2012-13,39,0,2,2,0.05,-12,29,0.0,22,49909.0,21:19,0,0,0,0.0,36,79,11,22,-11,0,0,0,314.0,0:8,0,0,0,8097.0,3:27,3166667
8460719,Steve,Sullivan,1974-07-06,LW,R,2012-13,42,7,10,17,0.4,-12,61,11.48,24,36676.0,14:33,3,3,6,50.0,12,3,15,15,0,4,4,8,7041.0,2:47,0,0,0,55.0,0:1,1850000
8460720,Eric,Boulton,1976-08-17,LW,L,2012-13,15,0,0,0,0.0,-4,5,0.0,36,5106.0,5:40,0,0,0,0.0,23,6,1,1,0,0,0,0,19.0,0:1,0,0,0,44.0,0:2,540000
8462033,Wade,Redden,1977-06-12,D,L,2012-13,29,3,4,7,0.24,-2,28,10.71,11,26228.0,15:4,0,0,0,0.0,16,30,7,5,2,0,1,1,1352.0,0:46,0,0,0,332.0,0:11,6500000
8462038,Shane,Doan,1976-10-10,RW,R,2012-13,48,13,14,27,0.56,6,129,10.08,37,51998.0,18:3,4,11,15,26.67,118,10,23,20,3,0,3,3,7907.0,2:44,0,0,0,568.0,0:11,5300000
8462042,Jarome,Iginla,1977-07-01,RW,R,2012-13,44,14,19,33,0.75,-5,134,10.45,31,49668.0,18:48,123,124,247,49.8,65,13,18,17,1,6,6,12,9002.0,3:24,0,0,0,513.0,0:11,7000000
8462129,Michal,Handzus,1977-03-11,C,L,2012-13,39,2,6,8,0.21,-2,41,4.88,16,30735.0,13:8,236,190,426,55.4,31,30,16,14,2,0,0,0,1248.0,0:32,0,0,0,4133.0,1:45,2500000
8462196,Stephane,Robidas,1977-03-03,D,R,2012-13,48,1,12,13,0.27,2,46,2.17,56,64047.0,22:14,0,0,0,0.0,136,93,9,18,-9,0,4,4,6152.0,2:8,0,0,0,8936.0,3:6,3300000
8462225,Filip,Kuba,1976-12-29,D,L,2012-13,44,1,9,10,0.23,-18,50,2.0,24,56030.0,21:13,0,0,0,0.0,37,69,14,17,-3,0,4,4,4282.0,1:37,0,0,0,6710.0,2:32,4000000
8464956,Chris,Phillips,1978-03-09,D,L,2012-13,48,5,9,14,0.29,-5,89,5.62,43,60608.0,21:2,0,0,0,0.0,93,78,9,20,-11,1,0,1,4389.0,1:31,0,0,0,9011.0,3:7,3083333
8464966,Derek,Morris,1978-08-24,D,R,2012-13,39,0,11,11,0.28,-6,68,0.0,36,50067.0,21:23,0,0,0,0.0,92,69,10,15,-5,0,3,3,2584.0,1:6,0,0,0,5490.0,2:20,2750000
8464967,Marty,Reasoner,1977-02-26,C,L,2012-13,31,0,5,5,0.16,-3,34,0.0,4,20880.0,11:13,157,142,299,52.51,21,14,14,1,13,0,0,0,119.0,0:3,0,0,0,3449.0,1:51,1350000
8464975,Daniel,Briere,1977-10-06,C,R,2012-13,34,6,10,16,0.47,-13,87,6.9,10,32762.0,16:3,62,73,135,45.93,15,6,7,13,-6,3,3,6,5857.0,2:52,0,0,0,61.0,0:1,6500000
8464977,Dainius,Zubrus,1978-06-16,C,L,2012-13,22,2,7,9,0.41,-3,22,9.09,12,22156.0,16:47,11,17,28,39.29,31,9,6,6,0,0,0,0,1439.0,1:5,0,2,2,2341.0,1:46,3400000
8464989,Matt,Cullen,1976-11-02,C,L,2012-13,42,7,20,27,0.64,9,79,8.86,10,40046.0,15:53,245,203,448,54.69,18,18,14,24,-10,0,4,4,4906.0,1:56,0,0,0,3386.0,1:20,3500000
8464994,Steve,Begin,1978-06-14,LW,L,2012-13,36,4,4,8,0.22,-2,31,12.9,22,17266.0,7:59,57,60,117,48.72,62,21,4,7,-3,0,0,0,58.0,0:1,1,0,1,2839.0,1:18,525000
8465009,Zdeno,Chara,1977-03-18,D,L,2012-13,48,7,12,19,0.4,14,119,5.88,70,71816.0,24:56,0,1,1,0.0,101,64,12,34,-22,3,1,4,7081.0,2:27,0,1,1,9217.0,3:12,6916667
8465042,Toni,Lydman,1977-09-25,D,L,2012-13,35,0,6,6,0.17,-1,28,0.0,12,40713.0,19:23,0,0,0,0.0,83,76,6,19,-13,0,0,0,345.0,0:9,0,1,1,4536.0,2:9,3000000
8465050,Eric,Belanger,1977-12-16,C,L,2012-13,26,0,3,3,0.12,-1,31,0.0,10,22034.0,14:7,203,175,378,53.7,19,15,12,9,3,0,0,0,310.0,0:11,0,0,0,4893.0,3:8,1750000
8465058,Michal,Rozsival,1978-09-03,D,R,2012-13,27,0,12,12,0.44,18,13,0.0,14,29341.0,18:6,0,2,2,0.0,44,28,10,13,-3,0,0,0,1610.0,0:59,0,1,1,804.0,0:29,2000000
8465166,Craig,Adams,1977-04-26,RW,R,2012-13,48,3,6,9,0.19,-1,46,6.52,28,32146.0,11:9,51,47,98,52.04,107,37,5,7,-2,0,0,0,88.0,0:1,1,0,1,7654.0,2:39,675000
8465200,Tomas,Kaberle,1978-03-02,D,L,2012-13,10,0,3,3,0.3,4,11,0.0,0,8127.0,13:32,0,0,0,0.0,2,11,1,1,0,0,0,0,1435.0,2:23,0,0,0,39.0,0:3,4250000
8465202,Sami,Salo,1974-09-02,D,R,2012-13,46,2,15,17,0.37,5,48,4.17,16,57919.0,20:59,0,0,0,0.0,40,65,13,16,-3,1,6,7,6619.0,2:23,0,0,0,6862.0,2:29,3750000
8465914,Francis,Bouillon,1975-10-17,D,L,2012-13,48,1,8,9,0.19,4,46,2.17,21,52059.0,18:4,0,0,0,0.0,78,50,9,34,-25,0,0,0,4463.0,1:32,0,0,0,2948.0,1:1,1500000
8465951,Matt,Cooke,1978-09-07,LW,L,2012-13,48,8,13,21,0.44,-2,61,13.11,36,42373.0,14:42,3,11,14,21.43,97,41,11,13,-2,0,0,0,226.0,0:4,0,0,0,6333.0,2:11,1800000
8465978,Shawn,Thornton,1977-07-23,LW,R,2012-13,45,3,4,7,0.16,1,55,5.45,60,21886.0,8:6,7,10,17,41.18,77,13,11,3,8,0,0,0,28.0,0:0,0,0,0,0.0,0:0,1100000
8466138,Joe,Thornton,1979-07-02,C,L,2012-13,48,7,33,40,0.83,6,85,8.24,26,52929.0,18:22,410,291,701,58.49,23,21,37,42,-5,2,19,21,9501.0,3:17,0,0,0,1391.0,0:28,7000000
8466139,Patrick,Marleau,1979-09-15,C,L,2012-13,48,17,14,31,0.65,-2,150,11.33,24,55039.0,19:6,71,79,150,47.33,38,13,25,26,-1,6,8,14,9321.0,3:14,1,0,1,4252.0,1:28,6900000
8466140,Olli,Jokinen,1978-12-05,C,L,2012-13,45,7,7,14,0.31,-19,85,8.24,14,46243.0,17:7,300,330,630,47.62,91,27,14,17,-3,0,1,1,6317.0,2:20,0,0,0,39.0,0:0,4500000
8466142,Eric,Brewer,1979-04-17,D,L,2012-13,48,4,8,12,0.25,3,56,7.14,30,59078.0,20:30,0,0,0,0.0,88,94,13,30,-17,1,0,1,719.0,0:14,0,0,0,5843.0,2:1,3875000
8466148,Marian,Hossa,1979-01-12,RW,L,2012-13,40,17,14,31,0.78,20,116,14.66,16,43299.0,18:2,1,2,3,33.33,12,13,48,14,34,4,2,6,6334.0,2:38,1,1,2,3345.0,1:23,5275000
8466149,Daniel,Cleary,1978-12-18,RW,L,2012-13,48,9,6,15,0.31,-6,93,9.68,40,47357.0,16:26,11,12,23,47.83,56,21,11,19,-8,5,0,5,7241.0,2:30,1,0,1,3308.0,1:8,2800000
8466158,Scott,Hannan,1979-01-23,D,L,2012-13,33,0,1,1,0.03,-14,25,0.0,22,38310.0,19:20,0,0,0,0.0,35,54,9,10,-1,0,0,0,33.0,0:1,0,0,0,4847.0,2:26,1000000
8466160,Brenden,Morrow,1979-01-16,LW,L,2012-13,44,12,13,25,0.57,-3,55,21.82,37,39236.0,14:51,13,11,24,54.17,85,20,11,15,-4,2,2,4,6066.0,2:17,0,0,0,292.0,0:6,4100000
8466215,Joe,Corvo,1977-06-20,D,R,2012-13,40,6,11,17,0.42,-3,71,8.45,14,45022.0,18:45,0,0,0,0.0,27,38,15,20,-5,3,5,8,5429.0,2:15,0,0,0,1734.0,0:43,2000000
8466251,Jason,Chimera,1979-05-02,LW,L,2012-13,47,3,11,14,0.3,-5,92,3.26,48,35743.0,12:40,21,15,36,58.33,73,12,10,20,-10,0,0,0,676.0,0:14,0,0,0,330.0,0:7,1750000
8466285,Brian,Campbell,1979-05-23,D,L,2012-13,48,8,19,27,0.56,-22,70,11.43,12,76080.0,26:25,0,0,0,0.0,14,65,14,27,-13,6,11,17,11091.0,3:51,0,0,0,5608.0,1:56,7142875
8466333,Andrew,Ference,1979-03-17,D,L,2012-13,48,4,9,13,0.27,9,66,6.06,35,56130.0,19:29,0,0,0,0.0,89,60,5,31,-26,0,0,0,448.0,0:9,0,1,1,6420.0,2:13,2250000
8466378,Martin,St. Louis,1975-06-18,RW,L,2012-13,48,17,43,60,1.25,0,112,15.18,14,63312.0,21:59,12,16,28,42.86,23,32,43,40,3,3,17,20,10395.0,3:36,0,0,0,2270.0,0:47,5625000
8466393,Pascal,Dupuis,1979-04-07,RW,L,2012-13,48,20,18,38,0.79,31,140,14.29,26,50420.0,17:30,27,30,57,47.37,83,36,29,13,16,2,1,3,2350.0,0:48,1,0,1,5521.0,1:55,1500000
8466398,Tom,Kostopoulos,1979-01-24,RW,R,2012-13,15,1,0,1,0.07,0,13,7.69,18,8187.0,9:5,3,2,5,60.0,23,3,2,1,1,0,0,0,62.0,0:4,0,0,0,220.0,0:14,600000
8467096,Dan,Boyle,1976-07-12,D,R,2012-13,46,7,13,20,0.43,3,97,7.22,27,62922.0,22:47,0,0,0,0.0,29,81,16,42,-26,5,8,13,9572.0,3:28,0,1,1,3112.0,1:7,6666666
8467329,Vincent,Lecavalier,1980-04-21,C,L,2012-13,39,10,22,32,0.82,-5,86,11.63,29,41846.0,17:52,404,338,742,54.45,74,13,12,7,5,5,4,9,7152.0,3:3,0,0,0,437.0,0:11,7727272
8467330,David,Legwand,1980-08-17,C,L,2012-13,48,12,13,25,0.52,-6,78,15.38,20,53066.0,18:25,362,359,721,50.21,20,20,31,32,-1,2,2,4,5672.0,1:58,0,0,0,3084.0,1:4,4500000
8467331,Brad,Stuart,1979-11-06,D,L,2012-13,48,0,6,6,0.12,4,39,0.0,25,58918.0,20:27,0,0,0,0.0,87,89,15,27,-12,0,0,0,423.0,0:8,0,1,1,7606.0,2:38,3600000
8467332,Bryan,Allen,1980-08-21,D,L,2012-13,41,0,6,6,0.15,1,25,0.0,34,46097.0,18:44,0,0,0,0.0,63,66,4,22,-18,0,0,0,135.0,0:3,0,0,0,4578.0,1:51,3500000
8467334,Manny,Malhotra,1980-05-18,C,L,2012-13,9,0,0,0,0.0,-3,2,0.0,0,6010.0,11:7,64,34,98,65.31,8,4,3,0,3,0,0,0,105.0,0:11,0,0,0,1503.0,2:47,2500000
8467336,Mike,Rupp,1980-01-13,LW,L,2012-13,40,1,3,4,0.1,-2,29,3.45,79,20056.0,8:21,16,11,27,59.26,48,9,6,5,1,0,0,0,18.0,0:0,0,0,0,0.0,0:0,1333333
8467338,Alex,Tanguay,1979-11-21,LW,L,2012-13,40,11,16,27,0.68,-13,44,25.0,22,46462.0,19:21,68,105,173,39.31,24,28,19,33,-14,2,7,9,7242.0,3:1,1,0,1,3154.0,1:18,3500000
8467344,Robyn,Regehr,1980-04-19,D,L,2012-13,41,0,4,4,0.1,-4,27,0.0,23,47776.0,19:25,0,0,0,0.0,100,69,1,21,-20,0,0,0,291.0,0:7,0,0,0,7233.0,2:56,4020000
8467346,Simon,Gagne,1980-02-29,LW,L,2012-13,38,5,11,16,0.42,-1,76,6.58,8,32234.0,14:8,2,0,2,100.0,24,15,17,10,7,2,2,4,3605.0,1:34,0,1,1,850.0,0:22,3500000
8467351,Scott,Gomez,1979-12-23,C,L,2012-13,39,2,13,15,0.38,-10,58,3.45,22,31669.0,13:32,181,143,324,55.86,4,11,20,21,-1,0,8,8,5213.0,2:13,0,0,0,7.0,0:0,7357143
8467365,John,Erskine,1980-06-26,D,L,2012-13,30,3,3,6,0.2,10,32,9.38,34,33232.0,18:27,0,0,0,0.0,91,62,4,28,-24,0,0,0,203.0,0:6,0,0,0,3815.0,2:7,1500000
8467370,Mike,Fisher,1980-06-05,C,R,2012-13,38,10,11,21,0.55,6,68,14.71,27,44373.0,19:27,275,288,563,48.85,67,46,23,13,10,1,5,6,5944.0,2:36,0,0,0,3552.0,1:33,4200000
8467371,Mike,Ribeiro,1980-02-10,C,L,2012-13,48,13,36,49,1.02,-4,63,20.63,53,51360.0,17:50,226,279,505,44.75,55,29,22,22,0,6,21,27,9845.0,3:25,0,0,0,503.0,0:10,5000000
8467389,Brad,Richards,1980-05-02,C,L,2012-13,46,11,23,34,0.74,8,110,10.0,14,51924.0,18:48,391,382,773,50.58,25,43,31,24,7,3,6,9,9050.0,3:16,0,0,0,298.0,0:6,6666666
8467396,Erik,Cole,1978-11-06,LW,L,2012-13,47,9,4,13,0.28,-6,86,10.47,20,46226.0,16:23,22,45,67,32.84,101,27,18,17,1,1,2,3,8275.0,2:56,0,0,0,2388.0,0:50,4500000
8467400,Francois,Beauchemin,1980-06-04,D,L,2012-13,48,6,18,24,0.5,19,74,8.11,22,67559.0,23:27,0,0,0,0.0,81,111,17,35,-18,1,7,8,6229.0,2:9,0,0,0,9199.0,3:11,3500000
8467407,Brian,Gionta,1979-01-18,RW,R,2012-13,48,14,12,26,0.54,3,112,12.5,8,52195.0,18:7,14,28,42,33.33,37,23,23,15,8,5,2,7,8502.0,2:57,0,0,0,2052.0,0:42,5000000
8467412,Alexei,Ponikarovsky,1980-04-09,LW,L,2012-13,42,4,5,9,0.21,-1,51,7.84,14,33160.0,13:9,2,5,7,28.57,81,15,4,7,-3,0,0,0,867.0,0:20,0,0,0,1153.0,0:27,1800000
8467423,Shawn,Horcoff,1978-09-17,C,L,2012-13,31,7,5,12,0.39,8,41,17.07,24,31350.0,16:51,245,255,500,49.0,24,20,6,19,-13,3,1,4,4690.0,2:31,0,0,0,4633.0,2:29,5500000
8467428,Krys,Barch,1980-03-26,RW,L,2012-13,22,0,0,0,0.0,1,4,0.0,44,7727.0,5:51,1,1,2,50.0,25,3,0,2,-2,0,0,0,7.0,0:0,0,0,0,0.0,0:0,750000
8467452,Rob,Scuderi,1978-12-30,D,L,2012-13,48,1,11,12,0.25,-6,33,3.03,4,62759.0,21:47,0,1,1,0.0,30,66,6,41,-35,0,0,0,390.0,0:8,0,1,1,9306.0,3:13,3400000
8467463,Mikael,Samuelsson,1976-12-23,RW,R,2012-13,4,0,1,1,0.25,-3,4,0.0,0,3087.0,12:51,0,0,0,0.0,6,1,1,1,0,0,0,0,538.0,2:14,0,0,0,0.0,0:0,3000000
8467478,Kent,Huskins,1979-05-04,D,L,2012-13,19,0,1,1,0.05,-3,4,0.0,4,17858.0,15:39,0,0,0,0.0,18,37,0,5,-5,0,0,0,133.0,0:7,0,0,0,2345.0,2:3,750000
8467493,Chris,Neil,1979-06-18,RW,R,2012-13,48,4,8,12,0.25,0,87,4.6,144,39925.0,13:51,3,3,6,50.0,206,10,13,9,4,0,3,3,4161.0,1:26,0,0,0,64.0,0:1,2000000
8467496,Andrei,Markov,1978-12-20,D,L,2012-13,48,10,20,30,0.62,-9,79,12.66,14,69493.0,24:7,0,0,0,0.0,22,60,18,50,-32,8,15,23,13734.0,4:46,0,0,0,6446.0,2:14,5750000
8467514,Pavel,Datsyuk,1978-07-20,C,L,2012-13,47,15,34,49,1.04,21,107,14.02,14,56911.0,20:10,488,399,887,55.02,31,30,56,38,18,8,8,16,10029.0,3:33,0,3,3,4056.0,1:26,6700000
8467545,Michael,Ryder,1980-03-31,RW,R,2012-13,46,16,19,35,0.76,2,101,15.84,16,44294.0,16:2,3,6,9,33.33,35,16,19,15,4,8,9,17,8228.0,2:58,0,0,0,120.0,0:2,3500000
8467831,Jeff,Halpern,1976-05-03,C,R,2012-13,46,1,2,3,0.07,-8,26,3.85,10,28109.0,10:11,208,163,371,56.06,56,22,15,4,11,0,0,0,79.0,0:1,0,0,0,5846.0,2:7,700000
8467875,Daniel,Sedin,1980-09-26,LW,L,2012-13,47,12,28,40,0.85,12,138,8.7,18,53640.0,19:1,3,4,7,42.86,15,7,16,21,-5,3,9,12,10353.0,3:40,0,0,0,201.0,0:4,6100000
8467876,Henrik,Sedin,1980-09-26,C,L,2012-13,48,11,34,45,0.94,19,70,15.71,24,55721.0,19:20,440,451,891,49.38,22,9,21,19,2,1,12,13,10256.0,3:33,1,0,1,477.0,0:9,6100000
8467890,Barret,Jackman,1981-03-05,D,L,2012-13,46,3,9,12,0.26,6,39,7.69,39,53327.0,19:19,0,0,0,0.0,70,89,11,12,-1,0,0,0,109.0,0:2,0,0,0,7672.0,2:46,3166667
8467899,Martin,Havlat,1981-04-19,RW,L,2012-13,40,8,10,18,0.45,7,89,8.99,30,38024.0,15:50,1,5,6,16.67,6,13,8,20,-12,1,3,4,5349.0,2:13,0,0,0,524.0,0:13,4250000
8467917,Jordan,Leopold,1980-08-03,D,L,2012-13,39,2,8,10,0.26,-8,60,3.33,14,46970.0,20:4,0,0,0,0.0,39,57,7,14,-7,0,4,4,5108.0,2:10,0,0,0,3319.0,1:25,3000000
8467925,Adam,Hall,1980-08-14,RW,R,2012-13,37,0,4,4,0.11,0,34,0.0,23,23381.0,10:31,141,110,251,56.18,59,26,11,6,5,0,0,0,135.0,0:3,0,0,0,4528.0,2:2,650000
8467931,Matt,Carkner,1980-11-03,D,R,2012-13,22,0,2,2,0.09,-2,19,0.0,46,16620.0,12:35,0,0,0,0.0,27,19,3,7,-4,0,0,0,24.0,0:1,0,0,0,508.0,0:23,1500000
8467967,Chris,Kelly,1980-11-11,C,L,2012-13,34,3,6,9,0.26,-8,40,7.5,16,30538.0,14:58,216,157,373,57.91,43,20,19,9,10,1,0,1,225.0,0:6,0,0,0,4684.0,2:17,3000000
8467977,Brian,McGrattan,1981-09-02,RW,R,2012-13,21,3,0,3,0.14,-4,18,16.67,49,8951.0,7:6,0,1,1,0.0,32,6,3,2,1,0,0,0,14.0,0:0,0,0,0,0.0,0:0,600000
8467988,Ryan,Malone,1979-12-01,LW,L,2012-13,24,6,2,8,0.33,-3,37,16.22,22,22663.0,15:44,9,14,23,39.13,49,9,14,7,7,2,0,2,3733.0,2:35,0,0,0,1128.0,0:47,4500000
8468001,Derek,MacKenzie,1981-06-11,C,L,2012-13,43,3,5,8,0.19,1,33,9.09,36,26674.0,10:20,192,131,323,59.44,122,19,12,5,7,0,0,0,106.0,0:2,0,0,0,3796.0,1:28,1000000
8468064,Martin,Erat,1981-08-29,RW,L,2012-13,45,5,19,24,0.53,-7,69,7.25,30,48388.0,17:55,32,30,62,51.61,48,12,18,35,-17,1,7,8,6424.0,2:22,0,0,0,2484.0,0:55,4500000
8468083,Henrik,Zetterberg,1980-10-09,C,L,2012-13,46,11,37,48,1.04,2,173,6.36,18,56643.0,20:31,263,281,544,48.35,20,10,29,27,2,4,19,23,10554.0,3:49,2,0,2,3741.0,1:21,6083333
8468085,Radim,Vrbata,1981-06-13,RW,R,2012-13,34,12,16,28,0.82,6,106,11.32,14,37351.0,18:18,10,22,32,31.25,26,14,18,11,7,2,10,12,6624.0,3:14,1,0,1,593.0,0:17,3000000
8468095,George,Parros,1979-12-29,RW,R,2012-13,39,1,1,2,0.05,-15,16,6.25,57,15468.0,6:36,0,0,0,0.0,53,13,5,3,2,0,0,0,19.0,0:0,0,0,0,44.0,0:1,937500
8468101,Radek,Martinek,1976-08-31,D,R,2012-13,13,3,0,3,0.23,-2,12,25.0,4,12594.0,16:8,0,0,0,0.0,15,19,2,6,-4,0,0,0,3.0,0:0,0,0,0,468.0,0:36,600000
8468114,Douglas,Murray,1980-03-12,D,L,2012-13,43,1,5,6,0.14,-9,27,3.7,35,45373.0,17:35,0,0,0,0.0,89,98,10,10,0,0,0,0,99.0,0:2,0,0,0,7255.0,2:48,2500000
8468162,Jerred,Smithson,1979-02-04,C,R,2012-13,45,3,3,6,0.13,-4,29,10.34,12,28784.0,10:39,265,213,478,55.44,96,30,8,7,1,0,0,0,108.0,0:2,0,0,0,5876.0,2:10,800000
8468208,Joel,Ward,1980-12-02,RW,R,2012-13,39,8,12,20,0.51,7,52,15.38,12,35401.0,15:7,38,27,65,58.46,37,28,16,7,9,1,2,3,4487.0,1:55,1,0,1,2960.0,1:15,3000000
8468309,Mark,Streit,1977-12-11,D,L,2012-13,48,6,21,27,0.56,-14,83,7.23,22,67240.0,23:20,0,0,0,0.0,34,86,20,37,-17,3,8,11,10818.0,3:45,0,0,0,3859.0,1:20,4100000
8468434,Andy,McDonald,1977-08-25,LW,L,2012-13,37,7,14,21,0.57,-2,86,8.14,16,38304.0,17:15,95,103,198,47.98,10,13,13,18,-5,1,6,7,5604.0,2:31,0,0,0,1246.0,0:33,4700000
8468478,Mike,Weaver,1978-05-02,D,R,2012-13,27,1,8,9,0.33,-3,21,4.76,8,32624.0,20:8,0,0,0,0.0,49,51,4,10,-6,0,0,0,175.0,0:6,0,0,0,5385.0,3:19,1100000
8468482,Dany,Heatley,1981-01-21,LW,L,2012-13,36,11,10,21,0.58,-12,83,13.25,8,40033.0,18:32,12,19,31,38.71,26,22,8,8,0,3,4,7,6561.0,3:2,0,0,0,100.0,0:2,7500000
8468483,Marian,Gaborik,1982-02-14,RW,L,2012-13,47,12,15,27,0.57,-3,151,7.95,14,52225.0,18:31,1,2,3,33.33,21,18,19,18,1,1,8,9,7768.0,2:45,0,0,0,114.0,0:2,7500000
8468484,Rostislav,Klesla,1982-03-21,D,L,2012-13,38,2,6,8,0.21,0,44,4.55,22,40190.0,17:37,0,0,0,0.0,40,60,4,5,-1,0,0,0,69.0,0:1,0,0,0,5350.0,2:20,2975000
8468485,Raffi,Torres,1981-10-08,LW,L,2012-13,39,7,11,18,0.46,0,60,11.67,17,31051.0,13:16,6,7,13,46.15,87,15,12,16,-4,1,0,1,2525.0,1:4,0,0,0,3.0,0:0,1750000
8468486,Scott,Hartnell,1982-04-18,LW,L,2012-13,32,8,3,11,0.34,-5,74,10.81,70,30472.0,15:52,3,1,4,75.0,68,21,11,21,-10,4,1,5,5676.0,2:57,0,0,0,93.0,0:2,4200000
8468493,Ron,Hainsey,1981-03-24,D,L,2012-13,47,0,13,13,0.28,-8,52,0.0,10,64465.0,22:51,0,0,0,0.0,36,123,8,32,-24,0,1,1,1676.0,0:35,0,0,0,8334.0,2:57,4500000
8468498,Brooks,Orpik,1980-09-26,D,L,2012-13,46,0,8,8,0.17,17,32,0.0,32,61519.0,22:17,0,0,0,0.0,119,114,5,19,-14,0,0,0,344.0,0:7,0,0,0,8758.0,3:10,3750000
8468501,Anton,Volchenkov,1982-02-25,D,L,2012-13,37,1,4,5,0.14,-1,38,2.63,37,35637.0,16:3,0,0,0,0.0,51,50,7,10,-3,0,0,0,72.0,0:1,0,0,0,6529.0,2:56,4250000
8468504,Brad,Boyes,1982-04-17,RW,R,2012-13,48,10,25,35,0.73,-6,97,10.31,16,52447.0,18:12,4,12,16,25.0,44,20,19,40,-21,1,12,13,9292.0,3:13,0,0,0,58.0,0:1,1000000
8468505,Steve,Ott,1982-08-19,C,L,2012-13,48,9,15,24,0.5,3,73,12.33,93,53447.0,18:33,298,237,535,55.7,187,21,10,24,-14,2,1,3,7634.0,2:39,0,2,2,5690.0,1:58,2950000
8468508,Justin,Williams,1981-10-04,RW,R,2012-13,48,11,22,33,0.69,15,142,7.75,22,48931.0,16:59,2,4,6,33.33,29,12,15,28,-13,1,5,6,6184.0,2:8,0,0,0,892.0,0:18,3825000
8468509,Niklas,Kronwall,1981-01-12,D,L,2012-13,48,5,24,29,0.6,-5,67,7.46,44,70162.0,24:21,0,0,0,0.0,42,83,11,21,-10,2,14,16,10685.0,3:42,0,0,0,7589.0,2:38,4750000
8468513,Nick,Schultz,1982-08-25,D,L,2012-13,48,1,8,9,0.19,-13,33,3.03,24,53661.0,18:37,0,2,2,0.0,52,107,9,27,-18,0,0,0,159.0,0:3,0,0,0,7148.0,2:28,3500000
8468518,Tomas,Kopecky,1982-02-05,RW,L,2012-13,47,15,12,27,0.57,-8,92,16.3,28,49873.0,17:41,42,44,86,48.84,23,25,24,11,13,4,5,9,5904.0,2:5,1,0,1,5282.0,1:52,3000000
8468520,Kurtis,Foster,1981-11-24,D,R,2012-13,23,1,4,5,0.22,0,21,4.76,25,18066.0,13:5,0,0,0,0.0,16,16,3,3,0,1,0,1,1855.0,1:20,0,0,0,152.0,0:6,950000
8468526,Jarret,Stoll,1982-06-24,C,R,2012-13,48,7,11,18,0.38,1,73,9.59,28,47573.0,16:31,418,328,746,56.03,107,44,8,12,-4,1,4,5,5091.0,1:46,1,1,2,5980.0,2:4,3250000
8468534,Andreas,Lilja,1975-07-13,D,L,2012-13,4,0,0,0,0.0,-1,2,0.0,0,4027.0,16:46,0,0,0,0.0,12,7,1,3,-2,0,0,0,4.0,0:1,0,0,0,404.0,1:41,737500
8468535,Antoine,Vermette,1982-07-20,C,L,2012-13,48,13,8,21,0.44,-3,91,14.29,36,52548.0,18:14,482,357,839,57.45,63,35,24,7,17,3,0,3,7185.0,2:29,0,0,0,5046.0,1:45,3750000
8468542,Paul,Martin,1981-03-05,D,L,2012-13,34,6,17,23,0.68,14,38,15.79,16,51663.0,25:19,0,0,0,0.0,17,50,14,12,2,2,7,9,6502.0,3:11,0,0,0,6409.0,3:8,5000000
8468598,Lubomir,Visnovsky,1976-08-11,D,L,2012-13,35,3,11,14,0.4,12,69,4.35,20,47891.0,22:48,0,0,0,0.0,20,52,13,30,-17,1,7,8,6745.0,3:12,0,0,0,1952.0,0:55,5600000
8468611,Matt,Hendricks,1981-06-17,C,L,2012-13,48,5,3,8,0.17,-6,54,9.26,73,33761.0,11:43,147,112,259,56.76,93,31,15,12,3,0,0,0,182.0,0:3,0,0,0,5012.0,1:44,825000
8468635,Travis,Moen,1982-04-06,LW,L,2012-13,45,2,4,6,0.13,-4,32,6.25,32,31468.0,11:39,4,6,10,40.0,82,22,2,11,-9,0,0,0,441.0,0:9,0,0,0,6071.0,2:14,1850000
8468636,Greg,Zanon,1980-06-05,D,L,2012-13,44,0,6,6,0.14,-16,40,0.0,28,51032.0,19:19,0,0,0,0.0,65,124,14,16,-2,0,0,0,284.0,0:6,0,1,1,7081.0,2:40,2250000
8468639,John-Michael,Liles,1980-11-25,D,L,2012-13,32,2,9,11,0.34,-1,47,4.26,4,36034.0,18:46,0,1,1,0.0,45,52,8,22,-14,0,1,1,4196.0,2:11,0,0,0,1173.0,0:36,3875000
8468674,Deryk,Engelland,1982-04-03,D,R,2012-13,42,0,6,6,0.14,5,31,0.0,54,35078.0,13:55,0,0,0,0.0,70,57,7,16,-9,0,0,0,24.0,0:0,0,0,0,2307.0,0:54,566667
8468695,Matthew,Lombardi,1982-03-18,C,L,2012-13,28,4,4,8,0.29,-2,44,9.09,8,23456.0,13:57,105,131,236,44.49,24,14,7,8,-1,1,1,2,2444.0,1:27,0,0,0,584.0,0:20,3500000
8468700,Paul,Gaustad,1982-02-03,C,L,2012-13,23,2,3,5,0.22,-1,35,5.71,20,21006.0,15:13,268,181,449,59.69,40,19,10,5,5,0,0,0,743.0,0:32,0,0,0,3329.0,2:24,3250000
8468704,Antti,Miettinen,1980-07-03,RW,R,2012-13,22,3,2,5,0.23,-3,26,11.54,2,16697.0,12:38,0,4,4,0.0,29,7,2,2,0,0,0,0,119.0,0:5,0,0,0,538.0,0:24,1300000
8468778,Colton,Orr,1982-03-03,RW,R,2012-13,44,1,3,4,0.09,4,13,7.69,155,16870.0,6:23,0,1,1,0.0,78,17,4,5,-1,0,0,0,107.0,0:2,0,0,0,11.0,0:0,1000000
8469454,Ilya,Kovalchuk,1983-04-15,RW,R,2012-13,37,11,20,31,0.84,-6,123,8.94,18,54917.0,24:44,7,15,22,31.82,13,12,10,41,-31,2,12,14,12138.0,5:28,4,0,4,3788.0,1:42,6666666
8469455,Jason,Spezza,1983-06-13,C,R,2012-13,5,2,3,5,1.0,3,12,16.67,2,5753.0,19:10,68,51,119,57.14,0,2,5,3,2,1,1,2,744.0,2:28,0,0,0,562.0,1:52,7000000
8469457,Stephen,Weiss,1983-04-03,C,L,2012-13,17,1,3,4,0.24,-13,19,5.26,25,18830.0,18:27,141,135,276,51.09,6,10,13,2,11,1,1,2,2519.0,2:28,0,0,0,1791.0,1:45,3100000
8469459,Mikko,Koivu,1983-03-12,C,L,2012-13,48,11,26,37,0.77,2,127,8.66,26,60759.0,21:5,524,447,971,53.96,47,18,26,19,7,0,13,13,10045.0,3:29,0,0,0,4553.0,1:34,6750000
8469460,Mike,Komisarek,1982-01-19,D,R,2012-13,4,0,0,0,0.0,2,1,0.0,2,3683.0,15:20,0,0,0,0.0,11,6,1,1,0,0,0,0,0.0,0:0,0,0,0,577.0,2:24,4300000
8469462,Tuomo,Ruutu,1983-02-16,LW,L,2012-13,17,4,5,9,0.53,-6,30,13.33,8,15544.0,15:14,1,7,8,12.5,51,7,12,8,4,0,0,0,1360.0,1:20,0,0,0,21.0,0:1,4750000
8469465,Dan,Hamhuis,1982-12-13,D,L,2012-13,47,4,20,24,0.51,9,61,6.56,12,65960.0,23:23,0,0,0,0.0,47,63,20,31,-11,0,6,6,6231.0,2:12,1,0,1,8646.0,3:3,4500000
8469466,Ales,Hemsky,1983-08-13,RW,R,2012-13,38,9,11,20,0.53,-6,82,10.98,16,35804.0,15:42,12,12,24,50.0,11,9,16,17,-1,5,4,9,6004.0,2:38,0,0,0,158.0,0:4,5000000
8469467,Chuck,Kobasew,1982-04-17,RW,R,2012-13,37,5,4,9,0.24,6,43,11.63,21,25019.0,11:16,18,31,49,36.73,34,17,14,4,10,0,0,0,324.0,0:8,0,0,0,3945.0,1:46,1250000
8469469,R.J.,Umberger,1982-05-03,C,L,2012-13,48,8,10,18,0.38,3,96,8.33,16,53248.0,18:29,54,54,108,50.0,51,45,22,11,11,2,3,5,7730.0,2:41,0,0,0,2974.0,1:1,4600000
8469470,Carlo,Colaiacovo,1983-01-27,D,L,2012-13,6,0,1,1,0.17,-4,12,0.0,2,6807.0,18:54,0,0,0,0.0,12,10,0,0,0,0,1,1,880.0,2:26,0,0,0,222.0,0:37,2500000
8469473,Marcel,Goc,1983-08-24,C,L,2012-13,42,9,10,19,0.45,-6,92,9.78,8,46039.0,18:16,410,376,786,52.16,73,20,21,11,10,4,2,6,4338.0,1:43,0,0,0,5367.0,2:7,1700000
8469474,Colby,Armstrong,1982-11-23,RW,R,2012-13,37,2,3,5,0.14,1,33,6.06,12,24869.0,11:12,9,12,21,42.86,36,21,10,8,2,0,0,0,145.0,0:3,0,0,0,3991.0,1:47,3000000
8469476,Tim,Gleason,1983-01-29,D,L,2012-13,42,0,9,9,0.21,-3,36,0.0,40,49310.0,19:34,0,0,0,0.0,90,64,10,11,-1,0,1,1,284.0,0:6,0,0,0,7062.0,2:48,4000000
8469483,David,Steckel,1982-03-15,C,L,2012-13,34,1,6,7,0.21,0,23,4.35,4,18901.0,9:15,175,146,321,54.52,41,21,6,5,1,0,0,0,89.0,0:2,0,0,0,2463.0,1:12,1100000
8469485,Derek,Roy,1983-05-04,C,L,2012-13,42,7,21,28,0.67,4,85,8.24,6,46858.0,18:35,295,352,647,45.6,15,30,31,24,7,2,6,8,6476.0,2:34,0,1,1,4276.0,1:41,4000000
8469490,Tim,Jackman,1981-11-14,RW,R,2012-13,42,1,4,5,0.12,-9,42,2.38,76,19151.0,7:35,11,13,24,45.83,98,17,6,7,-1,0,1,1,240.0,0:5,0,0,0,11.0,0:0,612500
8469492,Fedor,Tyutin,1983-07-19,D,L,2012-13,48,4,18,22,0.46,9,56,7.14,28,69395.0,24:5,1,0,1,100.0,58,58,9,19,-10,0,5,5,7977.0,2:46,0,1,1,7311.0,2:32,4500000
8469500,Michael,Cammalleri,1982-06-08,LW,L,2012-13,44,13,19,32,0.73,-15,102,12.75,25,47667.0,18:3,253,243,496,51.01,20,9,22,15,7,5,10,15,7556.0,2:51,0,0,0,1787.0,0:40,6000000
8469501,Chris,Thorburn,1983-06-03,RW,R,2012-13,42,2,2,4,0.1,-5,13,15.38,70,15936.0,6:19,20,26,46,43.48,65,19,3,1,2,0,0,0,61.0,0:1,0,0,0,693.0,0:16,866667
8469506,Jason,Pominville,1982-11-30,RW,R,2012-13,47,14,20,34,0.72,1,118,11.86,8,56907.0,20:10,51,54,105,48.57,21,35,38,13,25,2,7,9,9908.0,3:30,1,0,1,4887.0,1:43,5300000
8469508,Jay,McClement,1983-03-02,C,L,2012-13,48,8,9,17,0.35,0,48,16.67,11,43917.0,15:14,203,190,393,51.65,76,39,30,17,13,0,0,0,180.0,0:3,0,0,0,10559.0,3:39,1500000
8469521,Tomas,Plekanec,1982-10-31,C,L,2012-13,47,14,19,33,0.7,3,133,10.53,24,54175.0,19:12,486,475,961,50.57,26,17,15,22,-7,4,11,15,8380.0,2:58,0,0,0,5922.0,2:6,5000000
8469531,Jay,Harrison,1982-11-03,D,L,2012-13,47,3,7,10,0.21,-10,54,5.56,51,56140.0,19:54,0,0,0,0.0,83,110,12,24,-12,0,1,1,1419.0,0:30,0,0,0,6028.0,2:8,700000
8469534,Aaron,Johnson,1983-04-30,D,L,2012-13,10,0,0,0,0.0,0,8,0.0,10,8922.0,14:52,0,0,0,0.0,18,5,0,7,-7,0,0,0,6.0,0:0,0,0,0,570.0,0:57,650000
8469544,Patrick,Sharp,1981-12-27,LW,R,2012-13,28,6,14,20,0.71,8,88,6.82,14,31632.0,18:49,40,22,62,64.52,26,12,14,14,0,1,6,7,5222.0,3:6,0,0,0,1489.0,0:53,5900000
8469547,Jordin,Tootoo,1983-02-02,RW,R,2012-13,42,3,5,8,0.19,0,45,6.67,78,22889.0,9:4,0,0,0,0.0,68,7,11,8,3,0,1,1,249.0,0:5,0,0,0,0.0,0:0,1900000
8469555,Christian,Ehrhoff,1982-07-06,D,L,2012-13,47,5,17,22,0.47,6,102,4.9,34,71040.0,25:11,0,0,0,0.0,38,81,22,24,-2,1,8,9,9871.0,3:30,0,0,0,5611.0,1:59,4000000
8469581,Kyle,Wellwood,1983-05-16,C,R,2012-13,39,6,9,15,0.38,0,37,16.22,2,30365.0,12:58,43,35,78,55.13,10,10,18,15,3,0,2,2,2214.0,0:56,0,0,0,0.0,0:0,1600000
8469591,Cody,McCormick,1983-04-18,C,R,2012-13,8,0,0,0,0.0,-2,6,0.0,10,3099.0,6:27,12,13,25,48.0,17,5,0,1,-1,0,0,0,2.0,0:0,0,0,0,54.0,0:6,1200000
8469598,Kevin,Bieksa,1981-06-16,D,R,2012-13,36,6,6,12,0.33,6,77,7.79,48,47392.0,21:56,0,0,0,0.0,60,50,21,23,-2,2,1,3,4534.0,2:5,0,0,0,4270.0,1:58,4600000
8469619,Dennis,Seidenberg,1981-07-18,D,L,2012-13,46,4,13,17,0.37,18,83,4.82,10,65668.0,23:47,0,0,0,0.0,115,115,10,16,-6,0,2,2,3004.0,1:5,0,0,0,8759.0,3:10,3250000
8469622,Ryane,Clowe,1982-09-30,LW,L,2012-13,40,3,16,19,0.48,1,87,3.45,93,39919.0,16:37,5,10,15,33.33,99,19,13,26,-13,1,3,4,5703.0,2:22,0,0,0,21.0,0:0,3625000
8469623,Marek,Zidlicky,1977-02-03,D,R,2012-13,48,4,15,19,0.4,-12,101,3.96,38,60464.0,20:59,0,0,0,0.0,52,42,10,31,-21,1,10,11,10425.0,3:37,0,0,0,574.0,0:11,4000000
8469626,Andrew,Alberts,1981-06-30,D,L,2012-13,24,0,1,1,0.04,-7,15,0.0,32,21858.0,15:10,0,0,0,0.0,39,31,5,7,-2,0,0,0,20.0,0:0,0,0,0,1939.0,1:20,1225000
8469638,Jussi,Jokinen,1983-04-01,LW,L,2012-13,43,13,9,22,0.51,-5,74,17.57,24,39813.0,15:25,250,182,432,57.87,17,22,26,14,12,3,4,7,6280.0,2:26,0,0,0,3241.0,1:15,3000000
8469639,Brooks,Laich,1983-06-23,C,L,2012-13,9,1,3,4,0.44,2,10,10.0,6,8930.0,16:32,41,40,81,50.62,14,6,2,5,-3,0,1,1,451.0,0:50,0,0,0,1200.0,2:13,4500000
8469664,David,Moss,1981-12-28,RW,R,2012-13,45,5,15,20,0.44,3,82,6.1,21,41986.0,15:33,9,22,31,29.03,73,34,15,6,9,1,1,2,1110.0,0:24,1,0,1,6079.0,2:15,2100000
8469665,Johnny,Oduya,1981-10-01,D,L,2012-13,48,3,9,12,0.25,12,52,5.77,10,59100.0,20:31,0,0,0,0.0,24,79,19,24,-5,0,1,1,1480.0,0:30,0,1,1,6932.0,2:24,3375000
8469685,Andrew,Murray,1981-11-06,C,L,2012-13,1,0,0,0,0.0,0,2,0.0,0,469.0,7:49,0,0,0,0.0,1,0,0,0,0,0,0,0,0.0,0:0,0,0,0,0.0,0:0,600000
8469707,PA,Parenteau,1983-03-24,RW,R,2012-13,48,18,25,43,0.9,-11,105,17.14,38,55142.0,19:8,1,12,13,7.69,50,14,40,29,11,6,7,13,8301.0,2:52,0,0,0,107.0,0:2,4000000
8469759,Vernon,Fiddler,1980-05-09,C,L,2012-13,46,4,13,17,0.37,3,56,7.14,48,35478.0,12:51,319,300,619,51.53,34,28,18,8,10,1,1,2,1219.0,0:26,0,1,1,6585.0,2:23,1800000
8469760,Zbynek,Michalek,1982-12-23,D,R,2012-13,34,0,2,2,0.06,4,42,0.0,14,43464.0,21:18,0,0,0,0.0,42,87,6,12,-6,0,0,0,367.0,0:10,0,0,0,6039.0,2:57,4000000
8469765,Marc-Andre,Bergeron,1980-10-13,D,L,2012-13,25,1,8,9,0.36,-4,43,2.33,9,20648.0,13:45,0,0,0,0.0,16,19,7,11,-4,0,5,5,4259.0,2:50,0,0,0,132.0,0:5,1000000
8469770,Dennis,Wideman,1983-03-20,D,R,2012-13,46,6,16,22,0.48,-9,94,6.38,12,69067.0,25:1,0,1,1,0.0,40,100,16,37,-21,4,9,13,9636.0,3:29,0,1,1,5991.0,2:10,5250000
8469812,Chad,LaRose,1982-03-27,RW,R,2012-13,35,2,2,4,0.11,-8,65,3.08,29,26980.0,12:50,9,13,22,40.91,59,6,8,6,2,0,0,0,2414.0,1:8,0,0,0,341.0,0:9,1700000
8470018,Matt,Ellis,1981-08-31,LW,L,2012-13,6,0,0,0,0.0,0,8,0.0,0,2231.0,6:11,15,21,36,41.67,0,3,0,2,-2,0,0,0,0.0,0:0,0,0,0,158.0,0:26,525000
8470039,Tomas,Fleischmann,1984-05-16,LW,L,2012-13,48,12,23,35,0.73,-10,121,9.92,16,53954.0,18:44,10,10,20,50.0,29,10,27,26,1,2,11,13,7064.0,2:27,1,0,1,2509.0,0:52,4500000
8470041,Rick,Nash,1984-06-16,LW,L,2012-13,44,21,21,42,0.95,16,176,11.93,26,52722.0,19:58,5,7,12,41.67,46,25,19,32,-13,3,6,9,8343.0,3:9,1,0,1,1380.0,0:31,7800000
8470047,Valtteri,Filppula,1984-03-20,C,L,2012-13,41,9,8,17,0.41,-4,78,11.54,6,43729.0,17:46,179,144,323,55.42,16,12,18,19,-1,3,0,3,6691.0,2:43,0,0,0,1499.0,0:36,3000000
8470054,Keith,Ballard,1982-11-26,D,L,2012-13,36,0,2,2,0.06,-2,35,0.0,29,33415.0,15:28,0,0,0,0.0,45,34,16,13,3,0,0,0,584.0,0:16,0,0,0,2301.0,1:3,3300000
8470061,Derek,Meech,1984-04-21,D,L,2012-13,16,0,1,1,0.06,0,5,0.0,2,14109.0,14:41,0,0,0,0.0,24,12,1,7,-6,0,0,0,347.0,0:21,0,0,0,153.0,0:9,700000
8470063,Adam,Burish,1983-01-06,RW,R,2012-13,46,1,2,3,0.07,-7,39,2.56,25,29172.0,10:34,122,106,228,53.51,65,33,4,10,-6,0,0,0,161.0,0:3,1,0,1,3577.0,1:17,1850000
8470104,Tom,Gilbert,1983-01-10,D,R,2012-13,43,3,10,13,0.3,-11,36,8.33,18,49847.0,19:19,0,0,0,0.0,24,57,9,15,-6,1,3,4,4170.0,1:36,0,0,0,3818.0,1:28,4000000
8470105,Scottie,Upshall,1983-10-07,RW,L,2012-13,27,4,1,5,0.19,-8,54,7.41,25,21869.0,13:29,9,5,14,64.29,38,6,13,8,5,1,0,1,1321.0,0:48,0,0,0,2000.0,1:14,3500000
8470110,Trevor,Daley,1983-10-09,D,L,2012-13,44,4,9,13,0.3,1,58,6.9,14,56528.0,21:24,0,0,0,0.0,27,69,10,20,-10,2,1,3,5792.0,2:11,0,1,1,6826.0,2:35,3300000
8470120,Alexander,Semin,1984-03-03,RW,R,2012-13,44,13,31,44,1.0,14,150,8.67,46,55289.0,20:56,5,16,21,23.81,14,21,46,35,11,4,5,9,9407.0,3:33,0,1,1,2090.0,0:47,7000000
8470121,Matt,Greene,1983-05-13,D,R,2012-13,5,0,1,1,0.2,-1,3,0.0,8,4586.0,15:17,0,0,0,0.0,22,5,0,3,-3,0,0,0,71.0,0:14,0,0,0,639.0,2:7,2950000
8470137,Joni,Pitkanen,1983-09-19,D,L,2012-13,22,1,8,9,0.41,2,34,2.94,12,30119.0,22:49,0,0,0,0.0,16,34,11,12,-1,0,2,2,4209.0,3:11,0,0,0,2265.0,1:42,4500000
8470144,Frans,Nielsen,1984-04-24,C,L,2012-13,48,6,23,29,0.6,-3,93,6.45,12,51889.0,18:1,268,290,558,48.03,23,47,29,24,5,2,8,10,6016.0,2:5,1,0,1,7018.0,2:26,2750000
8470151,Jay,Bouwmeester,1983-09-27,D,L,2012-13,47,7,15,22,0.47,-6,79,8.86,22,69468.0,24:38,0,0,0,0.0,41,61,11,28,-17,1,6,7,5014.0,1:46,0,2,2,8238.0,2:55,6680000
8470153,Pierre-Marc,Bouchard,1984-04-27,C,L,2012-13,43,8,12,20,0.47,3,71,11.27,8,35972.0,13:56,1,6,7,14.29,12,6,10,15,-5,0,2,2,4470.0,1:43,0,0,0,12.0,0:0,4080000
8470156,Joey,Crabb,1983-04-03,RW,R,2012-13,26,2,0,2,0.08,-1,20,10.0,8,14693.0,9:25,7,27,34,20.59,24,17,6,4,2,0,0,0,46.0,0:1,0,0,0,1636.0,1:2,950000
8470159,Boyd,Gordon,1983-10-19,C,R,2012-13,48,4,10,14,0.29,0,59,6.78,8,43232.0,15:0,452,337,789,57.29,22,44,18,7,11,0,2,2,439.0,0:9,0,1,1,8227.0,2:51,1325000
8470162,Matt,Stajan,1983-12-19,C,L,2012-13,43,5,18,23,0.53,7,44,11.36,26,44278.0,17:9,356,414,770,46.23,47,30,24,17,7,0,0,0,648.0,0:15,0,0,0,5072.0,1:57,3500000
8470169,Gregory,Campbell,1983-12-17,C,L,2012-13,48,4,9,13,0.27,2,52,7.69,41,39494.0,13:42,189,212,401,47.13,71,28,15,8,7,0,1,1,1029.0,0:21,1,0,1,6209.0,2:9,1600000
8470171,Max,Talbot,1984-02-11,C,L,2012-13,35,5,5,10,0.29,2,41,12.2,23,32407.0,15:25,92,100,192,47.92,57,27,9,9,0,0,0,0,367.0,0:10,1,0,1,7280.0,3:28,1800000
8470180,Eric,Nystrom,1983-02-14,LW,L,2012-13,48,7,4,11,0.23,-3,49,14.29,61,41328.0,14:21,15,11,26,57.69,122,26,19,12,7,0,0,0,1595.0,0:33,1,0,1,6285.0,2:10,1400000
8470187,Johnny,Boychuk,1984-01-19,D,R,2012-13,44,1,5,6,0.14,5,75,1.33,12,53873.0,20:24,0,0,0,0.0,79,87,4,15,-11,0,0,0,491.0,0:11,0,0,0,6664.0,2:31,3366667
8470189,David,Van Der Gulik,1983-04-20,LW,L,2012-13,9,0,2,2,0.22,2,10,0.0,6,5098.0,9:26,4,4,8,50.0,10,5,3,1,2,0,0,0,26.0,0:2,0,0,0,886.0,1:38,575000
8470192,Steve,Eminger,1983-10-31,D,R,2012-13,35,0,3,3,0.09,9,22,0.0,8,27387.0,13:2,0,0,0,0.0,53,41,4,7,-3,0,0,0,168.0,0:4,0,0,0,1096.0,0:31,750000
8470201,Jiri,Hudler,1984-01-04,RW,L,2012-13,42,10,17,27,0.64,-13,56,17.86,22,43241.0,17:9,10,21,31,32.26,16,5,22,17,5,5,3,8,6590.0,2:36,0,0,0,638.0,0:15,4000000
8470207,Joffrey,Lupul,1983-09-23,LW,R,2012-13,16,11,7,18,1.12,8,42,26.19,12,15478.0,16:7,3,5,8,37.5,31,7,9,5,4,3,0,3,2547.0,2:39,0,0,0,0.0,0:0,4250000
8470222,James,Wisniewski,1984-02-21,D,R,2012-13,30,5,9,14,0.47,-1,62,8.06,15,41095.0,22:49,0,0,0,0.0,53,48,11,15,-4,4,1,5,5906.0,3:16,0,1,1,2718.0,1:30,5500000
8470230,Daniel,Paille,1984-04-15,LW,L,2012-13,46,10,7,17,0.37,3,70,14.29,8,35004.0,12:40,2,8,10,20.0,45,15,25,11,14,0,1,1,90.0,0:1,2,0,2,4919.0,1:46,1300000
8470257,Alexander,Steen,1984-03-01,LW,L,2012-13,40,8,19,27,0.68,5,129,6.2,14,45581.0,18:59,94,110,204,46.08,28,22,13,13,0,3,6,9,6146.0,2:33,0,0,0,3897.0,1:37,3362500
8470265,Anton,Babchuk,1984-05-06,D,R,2012-13,7,0,1,1,0.14,-1,5,0.0,0,4977.0,11:51,0,0,0,0.0,1,9,0,5,-5,0,0,0,203.0,0:29,0,0,0,0.0,0:0,2500000
8470273,Ian,White,1984-06-04,D,R,2012-13,25,2,2,4,0.16,5,27,7.41,4,29375.0,19:35,1,0,1,100.0,14,32,1,8,-7,0,0,0,3845.0,2:33,0,0,0,43.0,0:1,2875000
8470274,Chris,Higgins,1983-06-02,LW,L,2012-13,41,10,5,15,0.37,-4,77,12.99,10,40383.0,16:24,33,58,91,36.26,46,22,36,12,24,0,0,0,1995.0,0:48,0,0,0,4814.0,1:57,1900000
8470280,Ben,Eager,1984-01-22,LW,L,2012-13,14,1,1,2,0.14,-4,14,7.14,25,8114.0,9:39,0,0,0,0.0,40,6,3,2,1,0,0,0,46.0,0:3,0,0,0,18.0,0:1,1100000
8470281,Duncan,Keith,1983-07-16,D,L,2012-13,47,3,24,27,0.57,16,91,3.3,31,67986.0,24:6,0,0,0,0.0,19,66,26,29,-3,2,8,10,7730.0,2:44,0,1,1,6420.0,2:16,5538462
8470283,Tim,Brent,1984-03-10,C,R,2012-13,30,0,3,3,0.1,-3,23,0.0,8,17628.0,9:47,124,116,240,51.67,31,15,3,3,0,0,2,2,3004.0,1:40,0,0,0,1308.0,0:43,750000
8470289,Jim,Slater,1982-12-09,C,L,2012-13,26,1,1,2,0.08,-3,22,4.55,19,16305.0,10:27,145,122,267,54.31,41,12,10,3,7,0,0,0,42.0,0:1,0,0,0,2884.0,1:50,1600000
8470302,Patrick,Dwyer,1983-06-22,RW,R,2012-13,46,8,8,16,0.35,-7,93,8.6,12,42591.0,15:25,17,30,47,36.17,57,28,16,10,6,1,0,1,960.0,0:20,1,0,1,5876.0,2:7,625000
8470309,Ryan,Whitney,1983-02-19,D,L,2012-13,34,4,9,13,0.38,-7,30,13.33,23,37694.0,18:28,0,0,0,0.0,16,55,9,35,-26,0,7,7,5271.0,2:35,0,0,0,730.0,0:21,4000000
8470310,Aaron,Rome,1983-09-27,D,L,2012-13,27,0,5,5,0.19,-2,15,0.0,18,24841.0,15:20,0,0,0,0.0,43,32,2,9,-7,0,0,0,129.0,0:4,0,0,0,2506.0,1:32,1500000
8470318,Jonathan,Ericsson,1984-03-02,D,L,2012-13,45,3,10,13,0.29,6,34,8.82,29,57576.0,21:19,0,0,0,0.0,67,40,8,30,-22,0,0,0,694.0,0:15,0,0,0,8473.0,3:8,3250000
8470324,Josh,Gorges,1984-08-14,D,L,2012-13,48,2,7,9,0.19,4,40,5.0,15,61597.0,21:23,0,0,0,0.0,68,116,8,18,-10,0,0,0,1304.0,0:27,0,0,0,9301.0,3:13,3900000
8470358,Alexandre,Burrows,1981-04-11,RW,L,2012-13,47,13,11,24,0.51,15,140,9.29,54,53318.0,18:54,48,60,108,44.44,52,15,19,15,4,1,2,3,7811.0,2:46,0,0,0,5708.0,2:1,2000000
8470378,Andre,Benoit,1984-01-06,D,L,2012-13,33,3,7,10,0.3,-3,50,6.0,8,32507.0,16:25,0,0,0,0.0,29,54,7,17,-10,1,1,2,3204.0,1:37,0,0,0,1241.0,0:37,650000
8470543,Chris,Kunitz,1979-09-26,LW,L,2012-13,48,22,30,52,1.08,30,113,19.47,39,51904.0,18:1,4,5,9,44.44,104,13,13,17,-4,9,7,16,11016.0,3:49,0,0,0,405.0,0:8,3725000
8470595,Eric,Staal,1984-10-29,C,L,2012-13,48,18,35,53,1.1,5,152,11.84,54,60468.0,20:59,527,487,1014,51.97,35,24,48,24,24,3,6,9,10249.0,3:33,1,0,1,3464.0,1:12,8250000
8470596,Nathan,Horton,1985-05-29,RW,R,2012-13,43,13,9,22,0.51,1,114,11.4,22,43487.0,16:51,5,5,10,50.0,41,10,9,13,-4,0,1,1,5314.0,2:3,0,0,0,229.0,0:5,4000000
8470598,Thomas,Vanek,1984-01-19,LW,R,2012-13,38,20,21,41,1.08,-1,119,16.81,20,41965.0,18:24,8,4,12,66.67,13,4,34,30,4,9,5,14,7576.0,3:19,1,0,1,462.0,0:12,7142857
8470599,Milan,Michalek,1984-12-07,LW,L,2012-13,23,4,10,14,0.61,8,58,6.9,17,25104.0,18:11,2,2,4,50.0,6,13,9,6,3,0,2,2,3574.0,2:35,0,1,1,1778.0,1:17,4333333
8470600,Ryan,Suter,1985-01-21,D,L,2012-13,48,4,28,32,0.67,2,91,4.4,24,78565.0,27:16,0,0,0,0.0,33,74,9,19,-10,3,12,15,10886.0,3:46,0,0,0,6134.0,2:7,7538462
8470601,Braydon,Coburn,1985-02-27,D,L,2012-13,33,1,4,5,0.15,-10,38,2.63,41,44780.0,22:36,0,0,0,0.0,76,61,12,31,-19,0,0,0,773.0,0:23,0,0,0,6869.0,3:28,4500000
8470602,Dion,Phaneuf,1985-04-10,D,L,2012-13,48,9,19,28,0.58,-4,88,10.23,65,72513.0,25:10,0,0,0,0.0,131,91,15,53,-38,3,13,16,9822.0,3:24,0,0,0,8967.0,3:6,6500000
8470604,Jeff,Carter,1985-01-01,C,R,2012-13,48,26,7,33,0.69,0,133,19.55,16,50625.0,17:34,202,182,384,52.6,25,23,23,31,-8,8,2,10,7689.0,2:40,0,0,0,3503.0,1:12,5272727
8470606,Dustin,Brown,1984-11-04,RW,R,2012-13,46,18,11,29,0.63,6,142,12.68,22,53824.0,19:30,15,26,41,36.59,156,8,17,27,-10,8,5,13,7790.0,2:49,0,0,0,3537.0,1:16,3175000
8470607,Brent,Seabrook,1985-04-20,D,R,2012-13,47,8,12,20,0.43,12,65,12.31,23,62037.0,21:59,0,0,0,0.0,106,103,15,40,-25,3,4,7,6614.0,2:20,0,0,0,5989.0,2:7,5800000
8470609,Steve,Bernier,1985-03-31,RW,R,2012-13,47,8,7,15,0.32,-7,88,9.09,17,38810.0,13:45,5,5,10,50.0,64,15,11,13,-2,2,2,4,5508.0,1:57,0,0,0,115.0,0:2,775000
8470610,Zach,Parise,1984-07-28,LW,L,2012-13,48,18,20,38,0.79,2,182,9.89,16,59520.0,20:40,3,6,9,33.33,59,41,24,16,8,7,6,13,9879.0,3:25,0,0,0,4189.0,1:27,7538462
8470611,Eric,Fehr,1985-09-07,C,R,2012-13,41,9,8,17,0.41,14,72,12.5,10,32893.0,13:22,0,4,4,0.0,36,22,23,9,14,2,1,3,2021.0,0:49,1,0,1,1792.0,0:43,600000
8470612,Ryan,Getzlaf,1985-05-10,C,R,2012-13,44,15,34,49,1.11,14,99,15.15,41,53311.0,20:11,355,384,739,48.04,89,42,27,31,-4,4,11,15,7330.0,2:46,3,0,3,3946.0,1:29,5325000
8470613,Brent,Burns,1985-03-09,D,R,2012-13,30,9,11,20,0.67,0,81,11.11,20,29307.0,16:16,4,9,13,30.77,54,13,5,19,-14,2,1,3,3436.0,1:54,0,0,0,34.0,0:1,5760000
8470614,Mark,Stuart,1984-04-27,D,L,2012-13,42,2,2,4,0.1,5,40,5.0,53,42093.0,16:42,0,0,0,0.0,111,81,5,16,-11,0,0,0,44.0,0:1,0,0,0,5846.0,2:19,1700000
8470616,Ryan,Kesler,1984-08-31,C,R,2012-13,17,4,9,13,0.76,-5,36,11.11,12,19330.0,18:57,174,129,303,57.43,30,13,9,12,-3,2,3,5,3358.0,3:17,0,0,0,1889.0,1:51,5000000
8470617,Mike,Richards,1985-02-11,C,L,2012-13,48,12,20,32,0.67,-8,82,14.63,42,47096.0,16:21,216,225,441,48.98,58,19,21,19,2,6,9,15,7550.0,2:37,0,0,0,3734.0,1:17,5750000
8470619,Brian,Boyle,1984-12-18,C,L,2012-13,38,2,3,5,0.13,-13,56,3.57,29,32413.0,14:12,215,166,381,56.43,145,30,12,7,5,0,1,1,1296.0,0:34,0,0,0,4298.0,1:53,1700000
8470621,Corey,Perry,1985-05-16,RW,R,2012-13,44,15,21,36,0.82,10,128,11.72,72,50344.0,19:4,6,23,29,20.69,49,18,18,21,-3,5,5,10,7445.0,2:49,0,1,1,2429.0,0:55,5325000
8470622,Patrick,Eaves,1984-05-01,RW,R,2012-13,34,2,6,8,0.24,-1,42,4.76,4,21588.0,10:34,7,4,11,63.64,40,11,7,4,3,0,1,1,551.0,0:16,0,0,0,1864.0,0:54,1200000
8470626,Loui,Eriksson,1985-07-17,LW,L,2012-13,48,12,17,29,0.6,-9,104,11.54,8,57945.0,20:7,9,25,34,26.47,6,18,29,21,8,2,8,10,9351.0,3:14,1,0,1,4699.0,1:37,4250000
8470630,Kevin,Klein,1984-12-13,D,R,2012-13,47,3,11,14,0.3,-1,54,5.56,9,57580.0,20:25,0,0,0,0.0,66,89,23,32,-9,0,0,0,463.0,0:9,0,0,0,7721.0,2:44,1350000
8470638,Patrice,Bergeron,1985-07-24,C,R,2012-13,42,10,22,32,0.76,24,125,8.0,18,48622.0,19:17,549,335,884,62.1,28,25,23,28,-5,2,2,4,5469.0,2:10,0,1,1,5577.0,2:12,5000000
8470640,Matt,Carle,1984-09-25,D,L,2012-13,48,5,17,22,0.46,1,66,7.58,4,68394.0,23:44,0,0,0,0.0,32,87,22,34,-12,2,3,5,7364.0,2:33,0,0,0,7511.0,2:36,5500000
8470642,Shea,Weber,1985-08-14,D,R,2012-13,48,9,19,28,0.58,-2,124,7.26,48,74654.0,25:55,0,0,0,0.0,112,90,14,36,-22,3,9,12,10608.0,3:41,0,0,0,5548.0,1:55,7857143
8470644,Colin,McDonald,1984-09-30,RW,R,2012-13,45,7,10,17,0.38,-1,82,8.54,32,30709.0,11:22,4,4,8,50.0,120,9,6,13,-7,1,0,1,160.0,0:3,0,0,0,534.0,0:11,700000
8470647,B.J.,Crombeen,1985-07-10,RW,R,2012-13,44,1,7,8,0.18,4,50,2.0,112,29258.0,11:4,4,16,20,20.0,44,15,11,7,4,0,0,0,44.0,0:1,0,0,0,4556.0,1:43,1000000
8470654,Maxim,Lapierre,1985-03-29,C,R,2012-13,48,4,6,10,0.21,-6,54,7.41,45,36275.0,12:35,274,268,542,50.55,116,18,14,13,1,0,0,0,253.0,0:5,0,0,0,4718.0,1:38,1000000
8470655,David,Backes,1984-05-01,RW,R,2012-13,48,6,22,28,0.58,5,100,6.0,62,56480.0,19:36,477,435,912,52.3,158,41,30,10,20,1,4,5,6417.0,2:13,0,1,1,5064.0,1:45,4500000
8470662,Colin,Fraser,1985-01-28,C,L,2012-13,34,2,5,7,0.21,-4,19,10.53,25,19116.0,9:22,78,90,168,46.43,71,11,7,1,6,0,0,0,237.0,0:6,0,0,0,1231.0,0:36,825000
8470666,Daniel,Carcillo,1985-01-28,LW,L,2012-13,23,2,1,3,0.13,1,23,8.7,11,12414.0,8:59,0,1,1,0.0,37,6,6,2,4,0,0,0,52.0,0:2,0,0,0,17.0,0:0,825000
8470667,Clarke,MacArthur,1985-04-06,LW,L,2012-13,40,8,12,20,0.5,3,62,12.9,26,35782.0,14:54,5,1,6,83.33,44,15,15,29,-14,2,2,4,3943.0,1:38,0,0,0,70.0,0:1,3250000
8470672,Ryan,O'Byrne,1984-07-19,D,R,2012-13,42,2,4,6,0.14,-4,26,7.69,60,46699.0,18:31,0,0,0,0.0,104,69,10,20,-10,0,0,0,156.0,0:3,0,0,0,6501.0,2:34,1800000
8470699,Jan,Hejda,1978-06-18,D,L,2012-13,46,1,9,10,0.22,-3,50,2.0,28,54370.0,19:41,0,1,1,0.0,96,102,18,29,-11,0,0,0,160.0,0:3,0,0,0,8011.0,2:54,3250000
8470713,Paul,Bissonnette,1985-03-11,LW,L,2012-13,28,0,6,6,0.21,2,13,0.0,36,9113.0,5:25,0,0,0,0.0,36,8,1,1,0,0,0,0,2.0,0:0,0,0,0,0.0,0:0,737500
8470714,Corey,Potter,1984-01-05,D,R,2012-13,33,3,1,4,0.12,8,36,8.33,6,34559.0,17:27,0,0,0,0.0,50,36,8,20,-12,0,1,1,2182.0,1:6,0,0,0,3303.0,1:40,775000
8470719,Alexandre,Bolduc,1985-06-26,C,L,2012-13,14,0,0,0,0.0,-4,17,0.0,2,6406.0,7:37,7,14,21,33.33,21,3,2,1,1,0,0,0,29.0,0:2,0,0,0,0.0,0:0,650000
8470724,Kyle,Quincey,1985-08-12,D,L,2012-13,36,1,2,3,0.08,7,36,2.78,18,41520.0,19:13,0,0,0,0.0,29,46,6,18,-12,0,1,1,2718.0,1:15,0,0,0,4771.0,2:12,3775000
8470729,Tyson,Strachan,1984-10-30,D,R,2012-13,38,0,4,4,0.11,-13,42,0.0,40,43227.0,18:57,0,0,0,0.0,110,62,11,8,3,0,0,0,245.0,0:6,0,0,0,4313.0,1:53,600000
8470740,Lee,Stempniak,1983-02-04,RW,R,2012-13,47,9,23,32,0.68,2,113,7.96,12,50495.0,17:54,3,20,23,13.04,47,17,32,24,8,4,2,6,4769.0,1:41,0,4,4,5411.0,1:55,2500000
8470750,John,Mitchell,1985-01-22,C,L,2012-13,47,10,10,20,0.43,5,72,13.89,18,47234.0,16:44,171,173,344,49.71,99,43,28,21,7,1,2,3,5159.0,1:49,0,0,0,3342.0,1:11,1100000
8470755,Brad,Richardson,1985-02-04,C,L,2012-13,16,1,5,6,0.38,2,27,3.7,10,10463.0,10:53,27,29,56,48.21,22,3,6,3,3,0,0,0,216.0,0:13,0,0,0,331.0,0:20,1175000
8470760,Marc,Methot,1985-06-21,D,L,2012-13,47,2,9,11,0.23,2,53,3.77,31,62683.0,22:13,0,0,0,0.0,130,81,7,20,-13,0,1,1,489.0,0:10,0,0,0,8910.0,3:9,3000000
8470774,Bruno,Gervais,1984-10-03,D,R,2012-13,37,1,5,6,0.16,-17,49,2.04,10,38024.0,17:7,0,0,0,0.0,25,41,7,22,-15,0,0,0,563.0,0:15,0,0,0,2026.0,0:54,825000
8470775,Nate,Thompson,1984-10-05,C,L,2012-13,45,7,8,15,0.33,-2,58,12.07,17,38711.0,14:20,310,295,605,51.24,85,31,21,12,9,0,0,0,278.0,0:6,0,0,0,6539.0,2:25,900000
8470778,Drew,Miller,1984-02-17,LW,L,2012-13,44,4,4,8,0.18,-8,54,7.41,2,36477.0,13:49,1,3,4,25.0,81,41,12,8,4,1,0,1,422.0,0:9,0,0,0,6136.0,2:19,837500
8470794,Joe,Pavelski,1984-07-11,C,R,2012-13,48,16,15,31,0.65,2,130,12.31,10,54460.0,18:54,342,318,660,51.82,48,44,38,28,10,5,6,11,8651.0,3:0,0,1,1,4508.0,1:33,4000000
8470798,Dylan,Reese,1984-08-29,D,R,2012-13,3,0,0,0,0.0,0,1,0.0,0,2747.0,15:15,0,0,0,0.0,0,4,1,0,1,0,0,0,184.0,1:1,0,0,0,74.0,0:24,600000
8470803,Kyle,Brodziak,1984-05-25,C,R,2012-13,48,8,4,12,0.25,-18,88,9.09,20,49982.0,17:21,377,386,763,49.41,54,18,22,22,0,1,1,2,3660.0,1:16,1,0,1,5503.0,1:54,2833333
8470816,Jay,Rosehill,1985-07-16,LW,L,2012-13,11,1,0,1,0.09,-4,7,14.29,64,4483.0,6:47,0,0,0,0.0,18,5,1,2,-1,0,0,0,15.0,0:1,0,0,0,0.0,0:0,550000
8470828,Toby,Enstrom,1984-11-05,D,L,2012-13,22,4,11,15,0.68,-8,21,19.05,8,29732.0,22:31,0,0,0,0.0,9,38,2,8,-6,1,6,7,4848.0,3:40,0,1,1,2212.0,1:40,3750000
8470834,Dustin,Byfuglien,1985-03-27,D,R,2012-13,43,8,20,28,0.65,-1,142,5.63,34,62960.0,24:24,0,0,0,0.0,80,47,26,50,-24,4,6,10,9247.0,3:35,0,0,0,1322.0,0:30,5200000
8470839,Shane,O'Brien,1983-08-09,D,L,2012-13,28,0,4,4,0.14,0,28,0.0,60,26045.0,15:30,0,0,0,0.0,42,36,9,11,-2,0,0,0,468.0,0:16,0,0,0,268.0,0:9,2000000
8470852,Matt,Moulson,1983-11-01,LW,L,2012-13,47,15,29,44,0.94,-3,154,9.74,4,54019.0,19:9,1,0,1,100.0,24,28,20,15,5,8,7,15,9361.0,3:19,0,0,0,99.0,0:2,3133333
8470854,Tanner,Glass,1983-11-29,LW,L,2012-13,48,1,1,2,0.04,-11,38,2.63,62,29008.0,10:4,22,29,51,43.14,125,21,1,2,-1,1,0,1,43.0,0:0,0,0,0,3726.0,1:17,1100000
8470871,Chris,Porter,1984-05-29,LW,L,2012-13,29,2,6,8,0.28,5,46,4.35,0,20246.0,11:38,25,33,58,43.1,65,5,5,2,3,0,0,0,222.0,0:7,0,0,0,1558.0,0:53,650000
8470877,David,Jones,1984-08-10,RW,R,2012-13,33,3,6,9,0.27,-11,62,4.84,6,33306.0,16:49,6,15,21,28.57,45,20,9,11,-2,1,0,1,3498.0,1:46,0,0,0,3149.0,1:35,4000000
8470886,Clayton,Stoner,1985-02-19,D,L,2012-13,48,0,10,10,0.21,0,40,0.0,42,52458.0,18:12,0,0,0,0.0,87,57,12,21,-9,0,0,0,119.0,0:2,0,1,1,4438.0,1:32,1050000
8470920,David,Clarkson,1984-03-31,RW,R,2012-13,48,15,9,24,0.5,-6,180,8.33,78,50667.0,17:35,6,19,25,24.0,84,6,8,16,-8,6,2,8,10230.0,3:33,0,0,0,64.0,0:1,2666667
8470966,Mark,Giordano,1983-10-03,D,L,2012-13,47,4,11,15,0.32,-7,58,6.9,40,65311.0,23:9,0,0,0,0.0,65,93,34,31,3,1,2,3,6145.0,2:10,1,1,2,7688.0,2:43,4020000
8471185,Curtis,Glencross,1982-12-28,LW,L,2012-13,40,15,11,26,0.65,-8,92,16.3,18,43765.0,18:14,20,26,46,43.48,49,14,19,24,-5,3,3,6,6345.0,2:38,1,0,1,2926.0,1:13,2550000
8471208,Dustin,Penner,1982-09-28,RW,L,2012-13,33,2,12,14,0.42,-2,61,3.28,18,25142.0,12:41,2,3,5,40.0,59,7,15,16,-1,0,1,1,1768.0,0:53,0,0,0,30.0,0:0,3250000
8471214,Alex,Ovechkin,1985-09-17,LW,R,2012-13,48,32,24,56,1.17,2,220,14.55,36,60147.0,20:53,0,1,1,0.0,120,18,30,25,5,16,11,27,13230.0,4:35,0,0,0,204.0,0:4,9538462
8471215,Evgeni,Malkin,1986-07-31,C,L,2012-13,31,9,24,33,1.06,5,99,9.09,36,36647.0,19:42,195,218,413,47.22,12,11,23,21,2,4,14,18,8316.0,4:28,0,0,0,60.0,0:1,8700000
8471216,Cam,Barker,1986-04-04,D,L,2012-13,14,0,2,2,0.14,-3,19,0.0,4,11927.0,14:11,0,0,0,0.0,16,16,0,4,-4,0,0,0,295.0,0:21,0,0,0,275.0,0:19,700000
8471217,Andrew,Ladd,1985-12-12,LW,L,2012-13,48,18,28,46,0.96,10,121,14.88,22,56680.0,19:40,29,25,54,53.7,98,26,25,16,9,3,3,6,7673.0,2:39,0,0,0,4034.0,1:24,4400000
8471218,Blake,Wheeler,1986-08-31,RW,R,2012-13,48,19,22,41,0.85,-3,129,14.73,28,54145.0,18:48,4,14,18,22.22,90,39,28,20,8,2,5,7,7491.0,2:36,0,0,0,983.0,0:20,2550000
8471222,Ladislav,Smid,1986-02-01,D,L,2012-13,48,1,3,4,0.08,-1,30,3.33,55,58518.0,20:19,0,0,0,0.0,151,119,8,23,-15,0,0,0,156.0,0:3,0,1,1,9249.0,3:12,2250000
8471226,Drew,Stafford,1985-10-30,RW,R,2012-13,46,6,12,18,0.39,-16,121,4.96,21,46972.0,17:1,37,47,84,44.05,46,9,21,19,2,0,3,3,6009.0,2:10,0,0,0,3996.0,1:26,4000000
8471231,Kyle,Chipchura,1986-02-19,C,L,2012-13,46,5,9,14,0.3,1,37,13.51,50,26759.0,9:41,126,135,261,48.28,61,7,14,10,4,0,0,0,442.0,0:9,0,0,0,81.0,0:1,675000
8471232,Lauri,Korpikoski,1986-07-28,LW,L,2012-13,36,6,5,11,0.31,-3,83,7.23,12,36986.0,17:7,6,10,16,37.5,71,27,18,5,13,1,1,2,2985.0,1:22,0,0,0,4791.0,2:13,1800000
8471233,Travis,Zajac,1985-05-13,C,R,2012-13,48,7,13,20,0.42,-5,82,8.54,22,56255.0,19:31,506,375,881,57.43,33,10,29,15,14,1,3,4,8840.0,3:4,1,0,1,5074.0,1:45,3887500
8471234,Wojtek,Wolski,1986-02-24,LW,L,2012-13,27,4,5,9,0.33,1,49,8.16,6,21627.0,13:21,1,4,5,20.0,5,9,12,13,-1,0,1,1,1845.0,1:8,0,0,0,3.0,0:0,600000
8471236,Andrej,Meszaros,1985-10-13,D,L,2012-13,11,0,2,2,0.18,-9,18,0.0,2,12185.0,18:27,0,0,0,0.0,18,24,2,6,-4,0,1,1,1344.0,2:2,0,0,0,858.0,1:18,4000000
8471240,Jeff,Schultz,1986-02-25,D,L,2012-13,26,0,3,3,0.12,-6,12,0.0,12,22240.0,14:15,0,0,0,0.0,17,25,3,5,-2,0,0,0,0.0,0:0,0,0,0,2293.0,1:28,2750000
8471241,Mark,Fistric,1986-06-01,D,L,2012-13,25,0,6,6,0.24,6,9,0.0,32,23000.0,15:20,0,0,0,0.0,88,53,6,14,-8,0,0,0,91.0,0:3,0,0,0,3135.0,2:5,1475000
8471242,Mike,Green,1985-10-12,D,R,2012-13,35,12,14,26,0.74,-3,96,12.5,20,52193.0,24:51,0,0,0,0.0,36,61,14,25,-11,4,10,14,8483.0,4:2,0,0,0,2187.0,1:2,6083333
8471245,Dave,Bolland,1986-06-05,C,R,2012-13,35,7,7,14,0.4,-7,46,15.22,22,34308.0,16:20,239,279,518,46.14,43,18,21,16,5,1,2,3,5210.0,2:28,0,1,1,1854.0,0:52,3375000
8471246,Chris,Bourque,1986-01-29,LW,L,2012-13,18,1,3,4,0.22,-6,24,4.17,6,13042.0,12:4,0,1,1,0.0,25,7,6,4,2,0,3,3,2252.0,2:5,0,0,0,0.0,0:0,550000
8471254,Bryan,Bickell,1986-03-09,LW,L,2012-13,48,9,14,23,0.48,12,82,10.98,25,36880.0,12:48,2,4,6,33.33,108,13,23,11,12,0,0,0,836.0,0:17,0,0,0,0.0,0:0,541667
8471260,Blake,Comeau,1986-02-18,LW,R,2012-13,42,6,6,12,0.29,-4,48,12.5,20,30641.0,12:9,40,46,86,46.51,95,12,7,10,-3,0,0,0,146.0,0:3,1,0,1,3094.0,1:13,1250000
8471262,Carl,Soderberg,1985-10-12,C,L,2012-13,6,0,2,2,0.33,-2,6,0.0,6,5301.0,14:43,7,6,13,53.85,3,3,2,3,-1,0,0,0,888.0,2:28,0,0,0,0.0,0:0,1008333
8471266,David,Booth,1984-11-24,LW,L,2012-13,12,1,2,3,0.25,-3,27,3.7,4,9183.0,12:45,1,0,1,100.0,24,1,2,0,2,0,0,0,216.0,0:18,0,0,0,66.0,0:5,4250000
8471269,Nicklas,Grossmann,1985-01-22,D,L,2012-13,30,1,3,4,0.13,-1,21,4.76,21,32999.0,18:19,0,0,0,0.0,81,82,6,17,-11,0,0,0,96.0,0:3,0,0,0,5636.0,3:7,3500000
8471273,Brandon,Dubinsky,1986-04-29,C,L,2012-13,29,2,18,20,0.69,2,50,4.0,76,32026.0,18:24,256,183,439,58.31,64,17,13,6,7,1,6,7,4176.0,2:24,0,1,1,4345.0,2:29,4200000
8471274,Alex,Goligoski,1985-07-30,D,L,2012-13,47,3,24,27,0.57,4,80,3.75,18,63127.0,22:23,0,0,0,0.0,56,66,5,38,-33,0,11,11,8146.0,2:53,0,1,1,4063.0,1:26,4600000
8471276,David,Krejci,1986-04-28,C,R,2012-13,47,10,23,33,0.7,1,93,10.75,20,52182.0,18:30,361,293,654,55.2,41,27,20,25,-5,0,7,7,6203.0,2:11,0,0,0,897.0,0:19,5250000
8471283,Brandon,Prust,1984-03-16,LW,L,2012-13,38,5,9,14,0.37,11,39,12.82,110,31087.0,13:38,25,30,55,45.45,87,26,11,9,2,0,0,0,966.0,0:25,0,0,0,4410.0,1:56,2500000
8471284,Andrej,Sekera,1986-06-08,D,L,2012-13,37,2,10,12,0.32,-2,33,6.06,4,47082.0,21:12,0,0,0,0.0,30,73,10,19,-9,0,0,0,2350.0,1:3,0,1,1,4141.0,1:51,2750000
8471296,Alexei,Emelin,1986-04-25,D,L,2012-13,38,3,9,12,0.32,2,33,9.09,33,44840.0,19:40,0,0,0,0.0,110,47,8,32,-24,0,0,0,307.0,0:8,0,0,0,4999.0,2:11,2000000
8471299,Peter,Regin,1986-04-16,C,L,2012-13,27,0,3,3,0.11,-4,37,0.0,8,18659.0,11:31,92,118,210,43.81,12,8,10,4,6,0,0,0,578.0,0:21,0,0,0,2496.0,1:32,800000
8471303,Alexander,Edler,1986-04-21,D,L,2012-13,45,8,14,22,0.49,-5,113,7.08,37,64390.0,23:50,1,0,1,100.0,77,81,19,26,-7,5,5,10,9671.0,3:34,0,0,0,5366.0,1:59,3250000
8471309,Johan,Franzen,1979-12-23,RW,L,2012-13,41,14,17,31,0.76,13,116,12.07,41,44494.0,18:5,30,32,62,48.39,43,17,16,21,-5,6,6,12,8625.0,3:30,0,0,0,995.0,0:24,3954545
8471311,Tyler,Kennedy,1986-07-15,C,R,2012-13,46,6,5,11,0.24,-6,100,6.0,19,34393.0,12:27,13,16,29,44.83,41,9,9,9,0,1,2,3,3117.0,1:7,0,0,0,52.0,0:1,2000000
8471314,Mike,Lundin,1984-09-24,D,L,2012-13,11,0,1,1,0.09,-2,13,0.0,0,10235.0,15:30,0,0,0,0.0,2,7,2,5,-3,0,0,0,332.0,0:30,0,0,0,594.0,0:54,1150000
8471321,Brett,Carson,1985-11-29,D,R,2012-13,10,0,1,1,0.1,-1,8,0.0,0,6557.0,10:55,0,0,0,0.0,4,12,0,3,-3,0,0,0,134.0,0:13,0,0,0,44.0,0:4,575000
8471323,Ryan,Jones,1984-06-14,LW,L,2012-13,27,2,5,7,0.26,0,38,5.26,17,21023.0,12:58,2,7,9,22.22,55,13,10,12,-2,0,0,0,538.0,0:19,0,0,0,2257.0,1:23,1500000
8471326,Patrick,Bordeleau,1986-03-23,LW,L,2012-13,46,2,3,5,0.11,-7,24,8.33,70,17173.0,6:13,0,2,2,0.0,116,3,4,2,2,0,0,0,82.0,0:1,0,0,0,35.0,0:0,525000
8471331,Kevin,Porter,1986-03-12,C,L,2012-13,31,4,5,9,0.29,-1,37,10.81,10,28325.0,15:13,109,162,271,40.22,56,18,21,9,12,0,0,0,932.0,0:30,1,1,2,2727.0,1:27,537500
8471338,Torrey,Mitchell,1985-01-30,C,R,2012-13,45,4,4,8,0.18,-8,39,10.26,21,28346.0,10:29,21,21,42,50.0,47,22,14,8,6,0,0,0,76.0,0:1,0,0,0,3453.0,1:16,1900000
8471339,Ryan,Callahan,1985-03-21,RW,R,2012-13,45,16,15,31,0.69,9,144,11.11,12,58074.0,21:30,14,16,30,46.67,154,66,23,18,5,6,2,8,8657.0,3:12,2,1,3,6918.0,2:33,4275000
8471346,Kris,Versteeg,1986-05-13,RW,R,2012-13,10,2,2,4,0.4,-8,20,10.0,8,10130.0,16:53,0,5,5,0.0,5,3,7,6,1,0,1,1,1503.0,2:30,0,0,0,253.0,0:25,4400000
8471348,Nikita,Nikitin,1986-06-16,D,L,2012-13,38,3,6,9,0.24,2,60,5.0,17,48330.0,21:11,0,0,0,0.0,31,56,11,18,-7,1,1,2,4271.0,1:52,0,0,0,5369.0,2:21,2150000
8471362,Mikhail,Grabovski,1984-01-31,C,L,2012-13,48,9,7,16,0.33,-10,80,11.25,24,44842.0,15:34,323,315,638,50.63,34,20,19,32,-13,0,3,3,4909.0,1:42,0,0,0,79.0,0:1,5500000
8471371,Mike,Brown,1985-06-24,RW,R,2012-13,39,1,1,2,0.05,-7,18,5.56,123,17597.0,7:31,5,3,8,62.5,87,13,6,7,-1,0,0,0,122.0,0:3,0,0,0,236.0,0:6,736667
8471385,Adam,Pardy,1984-03-29,D,L,2012-13,17,0,4,4,0.24,4,6,0.0,14,16837.0,16:30,0,0,0,0.0,24,16,3,13,-10,0,0,0,51.0,0:3,0,0,0,1201.0,1:10,2000000
8471388,Patrick,Kaleta,1986-06-08,RW,R,2012-13,34,1,0,1,0.03,-4,34,2.94,67,22016.0,10:47,5,6,11,45.45,86,34,2,9,-7,0,0,0,154.0,0:4,0,0,0,4382.0,2:8,1250000
8471390,Mike,Santorelli,1985-12-14,C,R,2012-13,34,2,2,4,0.12,-12,35,5.71,2,24206.0,11:51,56,38,94,59.57,12,3,6,3,3,0,0,0,512.0,0:15,0,0,0,42.0,0:1,1600000
8471392,Roman,Polak,1986-04-28,D,R,2012-13,48,1,5,6,0.12,-2,39,2.56,48,53051.0,18:25,0,0,0,0.0,110,78,8,8,0,0,0,0,114.0,0:2,0,0,0,5677.0,1:58,2750000
8471409,Andrew,Gordon,1985-12-13,RW,R,2012-13,6,0,0,0,0.0,-1,2,0.0,0,3032.0,8:25,2,3,5,40.0,4,1,1,2,-1,0,0,0,0.0,0:0,0,0,0,0.0,0:0,537500
8471426,Troy,Brouwer,1985-08-17,RW,R,2012-13,47,19,14,33,0.7,-5,111,17.12,28,52276.0,18:32,111,121,232,47.84,108,23,24,22,2,7,9,16,9531.0,3:22,1,0,1,4292.0,1:31,2350000
8471436,Matt,Hunwick,1985-05-21,D,L,2012-13,43,0,6,6,0.14,4,57,0.0,16,55523.0,21:31,0,0,0,0.0,40,59,30,22,8,0,0,0,2881.0,1:7,0,0,0,6720.0,2:36,1600000
8471476,Daniel,Winnik,1985-03-06,LW,L,2012-13,48,6,13,19,0.4,13,95,6.32,16,48461.0,16:49,16,37,53,30.19,63,37,24,10,14,0,0,0,503.0,0:10,0,0,0,7341.0,2:32,1800000
8471482,Grant,Clitsome,1985-04-14,D,L,2012-13,44,4,12,16,0.36,10,56,7.14,18,49726.0,18:50,0,0,0,0.0,82,54,8,27,-19,2,1,3,2751.0,1:2,0,0,0,3856.0,1:27,1250000
8471490,Adam,Cracknell,1985-07-15,RW,R,2012-13,20,2,4,6,0.3,3,21,9.52,4,10337.0,8:36,6,19,25,24.0,22,7,6,1,5,0,0,0,10.0,0:0,0,0,0,14.0,0:0,550000
8471498,Jannik,Hansen,1986-03-15,RW,R,2012-13,47,10,17,27,0.57,12,99,10.1,8,49504.0,17:33,3,28,31,9.68,55,10,21,17,4,1,2,3,4713.0,1:40,0,0,0,6121.0,2:10,1350000
8471504,Rene,Bourque,1981-12-10,RW,L,2012-13,27,7,6,13,0.48,-1,63,11.11,32,26455.0,16:19,0,1,1,0.0,37,11,8,6,2,2,1,3,4420.0,2:43,0,0,0,808.0,0:29,3333333
8471514,Rich,Peverley,1982-07-08,C,R,2012-13,47,6,12,18,0.38,-9,95,6.32,16,43027.0,15:15,211,150,361,58.45,23,21,23,24,-1,2,4,6,4781.0,1:41,0,2,2,5364.0,1:54,3250000
8471521,Brad,Staubitz,1984-07-28,RW,R,2012-13,15,1,1,2,0.13,0,5,20.0,41,5593.0,6:12,0,0,0,0.0,31,7,0,3,-3,0,0,0,13.0,0:0,0,0,0,0.0,0:0,637500
8471636,Tim,Sestito,1984-08-28,LW,L,2012-13,6,0,0,0,0.0,1,4,0.0,2,2834.0,7:52,14,12,26,53.85,10,2,0,1,-1,0,0,0,5.0,0:0,0,0,0,0.0,0:0,525000
8471657,Cody,McLeod,1984-06-26,LW,L,2012-13,48,8,4,12,0.25,4,79,10.13,83,37695.0,13:5,7,10,17,41.18,106,17,9,2,7,0,1,1,1412.0,0:29,0,0,0,4327.0,1:30,1150000
8471663,Mike,Blunden,1986-12-15,RW,R,2012-13,5,0,0,0,0.0,-1,5,0.0,4,2504.0,8:20,0,0,0,0.0,2,3,0,1,-1,0,0,0,0.0,0:0,0,0,0,17.0,0:3,575000
8471664,Mason,Raymond,1985-09-17,LW,L,2012-13,46,10,12,22,0.48,2,79,12.66,16,43676.0,15:49,17,33,50,34.0,18,8,17,18,-1,4,2,6,5885.0,2:7,0,0,0,2992.0,1:5,2275000
8471669,Paul,Stastny,1985-12-27,C,L,2012-13,40,9,15,24,0.6,-7,87,10.34,14,46456.0,19:21,409,372,781,52.37,21,29,23,15,8,2,8,10,6487.0,2:42,0,0,0,5044.0,2:6,6600000
8471670,Guillaume,Latendresse,1987-05-24,LW,L,2012-13,27,6,4,10,0.37,-2,53,11.32,8,23977.0,14:48,0,4,4,0.0,42,8,14,7,7,1,0,1,3342.0,2:3,0,0,0,0.0,0:0,1250000
8471675,Sidney,Crosby,1987-08-07,C,L,2012-13,36,15,41,56,1.56,26,124,12.1,16,45585.0,21:6,453,381,834,54.32,21,18,15,28,-13,3,14,17,9425.0,4:21,0,0,0,1501.0,0:41,8700000
8471676,Bobby,Ryan,1987-03-17,RW,R,2012-13,46,11,19,30,0.65,3,101,10.89,17,45775.0,16:35,25,56,81,30.86,80,29,24,23,1,2,4,6,5388.0,1:57,0,0,0,139.0,0:3,5100000
8471677,Jack,Johnson,1987-01-13,D,L,2012-13,44,5,14,19,0.43,-5,96,5.21,12,68571.0,25:58,0,0,0,0.0,66,90,9,20,-11,3,5,8,9567.0,3:37,0,0,0,7351.0,2:47,4357143
8471678,Benoit,Pouliot,1986-09-29,LW,L,2012-13,34,8,12,20,0.59,8,60,13.33,15,27002.0,13:14,10,21,31,32.26,35,6,18,16,2,0,3,3,3636.0,1:46,0,0,0,53.0,0:1,1800000
8471681,Jack,Skille,1987-05-19,RW,R,2012-13,40,3,9,12,0.3,-9,69,4.35,11,31977.0,13:19,8,8,16,50.0,96,15,12,3,9,0,0,0,584.0,0:14,0,0,0,2629.0,1:5,825000
8471682,Devin,Setoguchi,1987-01-01,RW,R,2012-13,48,13,14,27,0.56,5,97,13.4,20,41583.0,14:26,7,10,17,41.18,92,19,18,18,0,5,1,6,5692.0,1:58,0,0,0,14.0,0:0,3000000
8471683,Brian,Lee,1987-03-26,D,R,2012-13,22,0,0,0,0.0,-13,13,0.0,16,18376.0,13:55,0,0,0,0.0,49,28,1,8,-7,0,0,0,19.0,0:0,0,0,0,415.0,0:18,1150000
8471685,Anze,Kopitar,1987-08-24,C,L,2012-13,47,10,32,42,0.89,14,98,10.2,16,57751.0,20:28,473,415,888,53.27,70,25,27,35,-8,0,16,16,7823.0,2:46,0,0,0,4209.0,1:29,6800000
8471686,Marc,Staal,1987-01-13,D,L,2012-13,21,2,9,11,0.52,4,20,10.0,14,30807.0,24:27,0,0,0,0.0,47,36,4,12,-8,1,2,3,1316.0,1:2,0,0,0,3950.0,3:8,3975000
8471691,Martin,Hanzal,1987-02-20,C,L,2012-13,39,11,12,23,0.59,2,93,11.83,24,43385.0,18:32,298,339,637,46.78,100,17,24,17,7,4,3,7,6907.0,2:57,0,1,1,1810.0,0:46,3100000
8471693,Jakub,Kindl,1987-02-10,D,L,2012-13,41,4,9,13,0.32,15,76,5.26,28,45648.0,18:33,0,0,0,0.0,46,33,8,30,-22,1,2,3,6434.0,2:36,0,0,0,655.0,0:15,883333
8471698,T.J.,Oshie,1986-12-23,RW,R,2012-13,30,7,13,20,0.67,-5,65,10.77,15,34368.0,19:5,5,8,13,38.46,33,24,18,12,6,2,8,10,4488.0,2:29,1,1,2,2948.0,1:38,4175000
8471699,Andrew,Cogliano,1987-06-14,LW,L,2012-13,48,13,10,23,0.48,14,79,16.46,6,44261.0,15:22,32,60,92,34.78,40,24,13,15,-2,0,0,0,432.0,0:9,2,0,2,4594.0,1:35,2390000
8471701,Joe,Finley,1987-06-29,D,L,2012-13,16,0,1,1,0.06,-5,2,0.0,20,11479.0,11:57,0,1,1,0.0,24,15,3,6,-3,0,0,0,6.0,0:0,0,0,0,230.0,0:14,533333
8471702,Matt,Niskanen,1986-12-06,D,R,2012-13,40,4,10,14,0.35,4,67,5.97,12,48858.0,20:21,0,0,0,0.0,49,47,15,17,-2,0,2,2,4825.0,2:0,0,0,0,2700.0,1:7,2300000
8471703,Steve,Downie,1987-04-03,RW,R,2012-13,2,0,1,1,0.5,1,2,0.0,6,1067.0,8:53,1,0,1,100.0,5,1,0,1,-1,0,0,0,143.0,1:11,0,0,0,0.0,0:0,2650000
8471707,James,Neal,1987-09-03,LW,L,2012-13,40,21,15,36,0.9,5,136,15.44,26,41925.0,17:28,1,5,6,16.67,56,17,11,7,4,9,7,16,9591.0,3:59,0,0,0,31.0,0:0,5000000
8471709,Marc-Edouard,Vlasic,1987-03-30,D,L,2012-13,48,3,4,7,0.15,5,59,5.08,29,59975.0,20:49,0,0,0,0.0,27,81,10,34,-24,0,0,0,1524.0,0:31,0,0,0,6205.0,2:9,3100000
8471716,Justin,Abdelkader,1987-02-25,LW,L,2012-13,48,10,3,13,0.27,6,96,10.42,34,42657.0,14:48,65,60,125,52.0,120,13,10,10,0,0,0,0,1885.0,0:39,0,0,0,1471.0,0:30,1800000
8471717,Adam,McQuaid,1986-10-12,D,R,2012-13,32,1,3,4,0.12,0,26,3.85,60,27441.0,14:17,0,0,0,0.0,62,43,3,8,-5,0,0,0,6.0,0:0,0,1,1,1196.0,0:37,1566667
8471719,Matt,Kassian,1986-10-28,LW,L,2012-13,15,1,0,1,0.07,0,6,16.67,47,5743.0,6:22,0,0,0,0.0,38,4,1,3,-2,0,0,0,0.0,0:0,0,0,0,0.0,0:0,575000
8471724,Kris,Letang,1987-04-24,D,R,2012-13,35,5,33,38,1.09,16,95,5.26,8,53836.0,25:38,0,0,0,0.0,45,59,12,34,-22,1,12,13,9714.0,4:37,0,0,0,4631.0,2:12,3500000
8471729,Kris,Russell,1987-05-02,D,L,2012-13,33,1,6,7,0.21,6,41,2.44,9,31776.0,16:2,0,0,0,0.0,26,57,10,8,2,1,1,2,1188.0,0:36,0,0,0,1150.0,0:34,1300000
8471733,Rich,Clune,1987-04-25,LW,L,2012-13,47,4,5,9,0.19,3,46,8.7,113,26524.0,9:24,0,2,2,0.0,159,6,4,6,-2,0,0,0,240.0,0:5,0,0,0,99.0,0:2,537500
8471735,Keith,Yandle,1986-09-09,D,L,2012-13,48,10,20,30,0.62,4,130,7.69,54,64072.0,22:14,0,0,0,0.0,18,40,20,30,-10,5,5,10,10112.0,3:30,0,0,0,238.0,0:4,5250000
8471742,Cody,Franson,1987-08-08,D,R,2012-13,45,4,25,29,0.64,4,70,5.71,8,50729.0,18:47,0,0,0,0.0,124,59,21,40,-19,3,10,13,7619.0,2:49,0,0,0,2439.0,0:54,1200000
8471743,Vladimir,Sobotka,1987-07-02,LW,L,2012-13,48,8,11,19,0.4,-4,69,11.59,35,44514.0,15:27,286,220,506,56.52,98,16,15,4,11,1,3,4,2161.0,0:45,0,0,0,5736.0,1:59,1300000
8471748,Mark,Fraser,1986-09-29,D,L,2012-13,45,0,8,8,0.18,18,33,0.0,85,45785.0,16:57,0,0,0,0.0,153,102,13,26,-13,0,0,0,117.0,0:2,0,0,0,5446.0,2:1,600000
8471761,Chris,Butler,1986-10-27,D,L,2012-13,44,1,7,8,0.18,-10,40,2.5,19,44981.0,17:2,0,0,0,0.0,53,74,8,21,-13,0,0,0,135.0,0:3,1,0,1,5060.0,1:55,1250000
8471762,Chris,VandeVelde,1987-03-15,C,L,2012-13,11,0,0,0,0.0,-3,7,0.0,4,4652.0,7:2,21,23,44,47.73,12,3,2,2,0,0,0,0,0.0,0:0,0,0,0,660.0,1:0,714000
8471766,Jared,Boll,1986-05-13,RW,R,2012-13,43,2,4,6,0.14,1,19,10.53,100,20853.0,8:4,4,5,9,44.44,80,7,1,6,-5,0,0,0,134.0,0:3,0,0,0,0.0,0:0,1050000
8471767,Blair,Jones,1986-09-27,C,R,2012-13,15,0,1,1,0.07,-6,22,0.0,10,9668.0,10:44,58,51,109,53.21,22,9,4,0,4,0,0,0,13.0,0:0,0,0,0,583.0,0:38,650000
8471768,Tom,Pyatt,1987-02-14,LW,L,2012-13,43,8,8,16,0.37,5,60,13.33,12,35041.0,13:34,145,145,290,50.0,22,36,16,5,11,0,0,0,523.0,0:12,0,0,0,4744.0,1:50,600000
8471769,Niklas,Hjalmarsson,1987-06-06,D,L,2012-13,46,2,8,10,0.22,15,43,4.65,22,57705.0,20:54,0,0,0,0.0,26,94,29,40,-11,0,0,0,260.0,0:5,0,0,0,7469.0,2:42,3500000
8471794,Darren,Helm,1987-01-21,LW,L,2012-13,1,0,0,0,0.0,0,1,0.0,2,747.0,12:27,6,8,14,42.86,4,0,1,1,0,0,0,0,0.0,0:0,0,0,0,330.0,5:30,2125000
8471804,Nathan,Gerbe,1987-07-24,C,L,2012-13,42,5,5,10,0.24,-3,64,7.81,14,31510.0,12:30,0,1,1,0.0,32,8,12,17,-5,0,0,0,2300.0,0:54,1,0,1,333.0,0:7,1450000
8471807,Tom,Wandell,1987-01-29,C,L,2012-13,18,1,0,1,0.06,0,14,7.14,4,9117.0,8:26,46,65,111,41.44,15,9,8,6,2,0,0,0,104.0,0:5,0,0,0,366.0,0:20,892500
8471810,Derek,Joslin,1987-03-17,D,L,2012-13,2,0,0,0,0.0,-2,2,0.0,0,2039.0,16:59,0,0,0,0.0,4,4,0,1,-1,0,0,0,0.0,0:0,0,0,0,136.0,1:8,700000
8471816,Mark,Fayne,1987-05-15,D,R,2012-13,31,1,5,6,0.19,6,34,2.94,16,33662.0,18:5,0,0,0,0.0,25,40,6,10,-4,0,0,0,241.0,0:7,1,0,1,4583.0,2:27,1300000
8471817,Ryan,Reaves,1987-01-20,RW,R,2012-13,43,4,2,6,0.14,3,24,16.67,79,19216.0,7:26,3,0,3,100.0,135,7,9,5,4,0,0,0,70.0,0:1,0,0,0,0.0,0:0,600000
8471832,Nick,Drazenovic,1987-01-14,C,L,2012-13,8,0,0,0,0.0,-2,5,0.0,4,4765.0,9:55,29,25,54,53.7,8,1,3,1,2,0,0,0,32.0,0:4,0,0,0,459.0,0:57,600000
8471840,Brett,Sutter,1987-06-02,LW,L,2012-13,3,0,0,0,0.0,-1,2,0.0,4,1502.0,8:20,8,6,14,57.14,7,0,1,0,1,0,0,0,19.0,0:6,0,0,0,0.0,0:0,550000
8471842,Tim,Kennedy,1986-04-30,LW,L,2012-13,13,2,0,2,0.15,-3,24,8.33,2,10601.0,13:35,3,7,10,30.0,22,4,9,6,3,0,0,0,851.0,1:5,0,0,0,21.0,0:1,675000
8471851,Matt,D'Agostini,1986-10-23,RW,R,2012-13,29,3,3,6,0.21,-5,33,9.09,8,21428.0,12:18,5,13,18,27.78,21,12,6,6,0,0,1,1,1890.0,1:5,0,0,0,0.0,0:0,1650000
8471856,Joe,Vitale,1985-08-20,C,R,2012-13,33,2,3,5,0.15,-7,26,7.69,17,18843.0,9:31,157,100,257,61.09,45,19,8,1,7,0,0,0,77.0,0:2,0,0,0,260.0,0:7,550000
8471859,Sergei,Kostitsyn,1987-03-20,LW,L,2012-13,46,3,12,15,0.33,-5,42,7.14,11,46146.0,16:43,3,1,4,75.0,27,25,15,20,-5,1,2,3,4768.0,1:43,0,0,0,3409.0,1:14,3000000
8471862,Colin,Greening,1986-03-09,C,L,2012-13,47,8,11,19,0.4,5,80,10.0,11,41538.0,14:43,22,25,47,46.81,122,24,19,18,1,2,2,4,2818.0,0:59,0,0,0,2141.0,0:45,816666
8471873,Anton,Stralman,1986-08-01,D,R,2012-13,48,4,3,7,0.15,14,66,6.06,16,51978.0,18:2,0,1,1,0.0,75,42,8,19,-11,0,0,0,3095.0,1:4,0,0,0,2753.0,0:57,1700000
8471887,Patric,Hornqvist,1987-01-01,RW,R,2012-13,24,4,10,14,0.58,-1,87,4.6,14,23364.0,16:13,1,1,2,50.0,29,9,7,6,1,4,3,7,4044.0,2:48,0,0,0,0.0,0:0,3083333
8471912,Kevin,Henderson,1986-12-03,LW,L,2012-13,4,1,0,1,0.25,-1,3,33.33,0,3526.0,14:41,0,0,0,0.0,3,1,1,1,0,0,0,0,86.0,0:21,0,0,0,97.0,0:24,550000
8471956,Andrew,Desjardins,1986-07-27,LW,L,2012-13,42,2,1,3,0.07,-6,51,3.92,61,25512.0,10:7,39,33,72,54.17,53,27,5,11,-6,0,0,0,57.0,0:1,0,0,0,2902.0,1:9,640000
8471958,Dan,Girardi,1984-04-29,D,R,2012-13,46,2,12,14,0.3,-1,81,2.47,16,70145.0,25:24,0,0,0,0.0,102,125,15,32,-17,0,2,2,5917.0,2:8,0,0,0,8394.0,3:2,3325000
8471976,David,Desharnais,1986-09-14,C,L,2012-13,48,10,18,28,0.58,-2,66,15.15,26,47423.0,16:27,382,382,764,50.0,26,18,23,15,8,2,5,7,8328.0,2:53,0,0,0,344.0,0:7,850000
8472368,Chris,Conner,1983-12-23,RW,L,2012-13,12,1,1,2,0.17,3,15,6.67,2,8190.0,11:22,0,2,2,0.0,15,5,7,0,7,0,0,0,163.0,0:13,0,0,0,0.0,0:0,650000
8472382,Andy,Greene,1982-10-30,D,L,2012-13,48,4,12,16,0.33,12,63,6.35,20,66358.0,23:2,0,0,0,0.0,47,70,32,18,14,2,4,6,5575.0,1:56,1,0,1,7201.0,2:30,3000000
8472394,Peter,Harrold,1983-06-08,D,R,2012-13,23,2,3,5,0.22,-8,36,5.56,6,24332.0,17:37,0,0,0,0.0,21,10,5,7,-2,1,2,3,2252.0,1:37,0,0,0,797.0,0:34,525000
8472410,Stephen,Gionta,1983-10-09,RW,R,2012-13,48,4,10,14,0.29,2,58,6.9,14,37513.0,13:1,137,253,390,35.13,87,14,21,6,15,0,0,0,361.0,0:7,0,1,1,4789.0,1:39,562500
8472424,Ryan,Hamilton,1985-04-15,LW,L,2012-13,10,0,2,2,0.2,1,6,0.0,0,6512.0,10:51,4,14,18,22.22,22,7,1,1,0,0,0,0,82.0,0:8,0,0,0,755.0,1:15,600000
8473412,Bryan,Little,1987-11-12,C,R,2012-13,48,7,25,32,0.67,8,84,8.33,4,57021.0,19:47,431,411,842,51.19,32,19,29,11,18,2,3,5,7336.0,2:32,0,1,1,4453.0,1:32,2383333
8473419,Brad,Marchand,1988-05-11,LW,L,2012-13,45,18,18,36,0.8,23,91,19.78,27,45804.0,16:57,6,6,12,50.0,38,20,28,32,-4,4,0,4,4700.0,1:44,2,0,2,3427.0,1:16,2500000
8473422,Nick,Foligno,1987-10-31,LW,L,2012-13,45,6,13,19,0.42,6,69,8.7,28,44616.0,16:31,3,6,9,33.33,99,33,17,8,9,1,2,3,5352.0,1:58,0,0,0,236.0,0:5,3083333
8473426,Mike,Weber,1987-12-16,D,L,2012-13,42,1,6,7,0.17,3,25,4.0,70,46276.0,18:21,0,0,0,0.0,122,92,5,25,-20,0,0,0,207.0,0:4,0,1,1,7035.0,2:47,950000
8473432,Derek,Dorsett,1986-12-20,RW,R,2012-13,24,3,6,9,0.38,-11,38,7.89,53,23025.0,15:59,13,10,23,56.52,55,10,5,1,4,0,0,0,497.0,0:20,0,0,0,2656.0,1:50,1633333
8473446,Erik,Johnson,1988-03-21,D,R,2012-13,31,0,4,4,0.13,-3,64,0.0,18,38602.0,20:45,0,0,0,0.0,44,58,19,26,-7,0,0,0,3508.0,1:53,0,0,0,4431.0,2:22,3750000
8473449,Kyle,Okposo,1988-04-16,RW,R,2012-13,48,4,20,24,0.5,-2,101,3.96,38,48833.0,16:57,104,82,186,55.91,48,21,35,35,0,0,3,3,4452.0,1:32,0,0,0,299.0,0:6,2800000
8473453,Trevor,Lewis,1987-01-08,C,R,2012-13,48,5,9,14,0.29,5,92,5.43,19,43785.0,15:12,31,33,64,48.44,83,31,11,9,2,0,0,0,2304.0,0:48,1,1,2,5292.0,1:50,725000
8473463,Leo,Komarov,1987-01-23,C,L,2012-13,42,4,5,9,0.21,-1,51,7.84,18,35118.0,13:56,29,28,57,50.88,176,24,16,15,1,0,0,0,422.0,0:10,0,0,0,4560.0,1:48,850000
8473465,Jamie,McGinn,1988-08-05,LW,L,2012-13,47,11,11,22,0.47,-13,128,8.59,26,48743.0,17:17,3,3,6,50.0,82,16,20,14,6,3,4,7,6550.0,2:19,0,0,0,2116.0,0:45,1750000
8473466,Ryan,White,1988-03-17,C,R,2012-13,26,1,0,1,0.04,1,16,6.25,67,14683.0,9:24,91,76,167,54.49,50,15,7,6,1,0,0,0,125.0,0:4,0,0,0,1540.0,0:59,687500
8473468,Eric,Gryba,1988-04-14,D,R,2012-13,33,2,4,6,0.18,-3,51,3.92,26,40149.0,20:16,0,0,0,0.0,89,37,10,32,-22,0,0,0,253.0,0:7,0,0,0,4657.0,2:21,562500
8473473,Milan,Lucic,1988-06-07,LW,L,2012-13,46,7,20,27,0.59,8,79,8.86,75,46677.0,16:54,17,18,35,48.57,139,16,20,37,-17,0,2,2,5461.0,1:58,0,0,0,91.0,0:1,4083333
8473482,Jiri,Tlusty,1988-03-16,LW,L,2012-13,48,23,15,38,0.79,15,117,19.66,18,52547.0,18:14,3,15,18,16.67,53,41,22,21,1,4,4,8,7583.0,2:37,0,0,0,2800.0,0:58,1600000
8473484,Kaspars,Daugavins,1988-05-18,LW,L,2012-13,25,1,3,4,0.16,-8,36,2.78,9,16522.0,11:0,9,9,18,50.0,23,10,13,10,3,0,1,1,112.0,0:4,0,0,0,2532.0,1:41,635000
8473485,Chris,Stewart,1987-10-30,RW,R,2012-13,48,18,18,36,0.75,0,97,18.56,40,45558.0,15:49,8,19,27,29.63,41,13,13,11,2,6,6,12,6698.0,2:19,0,0,0,42.0,0:0,3000000
8473492,Matt,Beleskey,1988-06-07,LW,L,2012-13,42,8,5,13,0.31,2,61,13.11,56,30281.0,12:0,6,13,19,31.58,103,16,8,11,-3,2,0,2,2081.0,0:49,0,0,0,192.0,0:4,737500
8473504,Cal,Clutterbuck,1987-11-18,RW,R,2012-13,42,4,6,10,0.24,-5,87,4.6,27,34611.0,13:44,1,1,2,50.0,155,17,13,10,3,0,0,0,130.0,0:3,0,1,1,4098.0,1:37,1400000
8473507,Jeff,Petry,1987-12-09,D,R,2012-13,48,3,9,12,0.25,1,66,4.55,29,63098.0,21:54,0,1,1,0.0,112,86,32,46,-14,0,0,0,1716.0,0:35,1,0,1,9661.0,3:21,1750000
8473512,Claude,Giroux,1988-01-12,C,R,2012-13,48,13,35,48,1.0,-7,137,9.49,22,60974.0,21:10,644,538,1182,54.48,57,29,17,30,-13,6,15,21,10605.0,3:40,1,0,1,4914.0,1:42,3750000
8473514,Jesse,Joensuu,1987-10-05,LW,L,2012-13,7,0,2,2,0.29,2,15,0.0,6,4258.0,10:8,0,0,0,0.0,12,0,5,3,2,0,0,0,7.0,0:1,0,0,0,0.0,0:0,600000
8473526,Peter,Mueller,1988-04-14,C,R,2012-13,43,8,9,17,0.4,-11,131,6.11,18,41956.0,16:15,46,58,104,44.23,29,10,33,11,22,2,2,4,6069.0,2:21,0,0,0,107.0,0:2,1725000
8473533,Jordan,Staal,1988-09-10,C,L,2012-13,48,10,21,31,0.65,-18,114,8.77,32,57903.0,20:6,458,456,914,50.11,105,20,31,20,11,1,6,7,6636.0,2:18,0,1,1,6289.0,2:11,4000000
8473534,Patrik,Berglund,1988-06-02,C,L,2012-13,48,17,8,25,0.52,-2,74,22.97,12,48466.0,16:49,279,324,603,46.27,53,24,10,9,1,5,1,6,6755.0,2:20,2,0,2,3903.0,1:21,2250000
8473536,James,Sheppard,1988-04-25,C,L,2012-13,32,1,3,4,0.12,-9,40,2.5,12,22559.0,11:44,2,4,6,33.33,63,17,16,11,5,0,0,0,785.0,0:24,0,0,0,16.0,0:0,825000
8473537,Viktor,Stalberg,1986-01-17,LW,L,2012-13,47,9,14,23,0.49,16,113,7.96,25,39822.0,14:7,0,1,1,0.0,43,14,22,11,11,0,2,2,6186.0,2:11,0,0,0,142.0,0:3,875000
8473542,Tom,Sestito,1987-09-28,LW,L,2012-13,30,3,0,3,0.1,-2,14,21.43,65,11572.0,6:25,1,1,2,50.0,39,2,5,3,2,0,0,0,0.0,0:0,0,0,0,0.0,0:0,605000
8473544,Derick,Brassard,1987-09-22,C,L,2012-13,47,12,17,29,0.62,1,88,13.64,16,46687.0,16:33,215,231,446,48.21,83,8,19,17,2,3,8,11,7885.0,2:47,0,0,0,230.0,0:4,3200000
8473546,Michael,Grabner,1987-10-05,RW,L,2012-13,45,16,5,21,0.47,4,108,14.81,12,39943.0,14:47,10,12,22,45.45,16,19,30,19,11,2,1,3,1391.0,0:30,1,0,1,6275.0,2:19,3000000
8473548,Phil,Kessel,1987-10-02,RW,R,2012-13,48,20,32,52,1.08,-3,161,12.42,18,57053.0,19:48,5,3,8,62.5,16,23,25,45,-20,6,15,21,9551.0,3:18,0,0,0,86.0,0:1,5400000
8473558,Cory,Emmerton,1988-06-01,C,L,2012-13,48,5,3,8,0.17,-1,55,9.09,4,31137.0,10:48,187,226,413,45.28,28,26,10,2,8,0,1,1,161.0,0:3,0,0,0,5015.0,1:44,533333
8473560,Korbinian,Holzer,1988-02-16,D,R,2012-13,22,2,1,3,0.14,-12,16,12.5,28,24429.0,18:30,0,0,0,0.0,61,54,3,15,-12,0,0,0,170.0,0:7,0,0,0,3396.0,2:34,575000
8473563,Nicklas,Backstrom,1987-11-23,C,L,2012-13,48,8,40,48,1.0,8,82,9.76,20,57314.0,19:54,432,408,840,51.43,31,35,33,26,7,3,15,18,10275.0,3:34,0,0,0,4399.0,1:31,6700000
8473564,Michael,Frolik,1988-02-17,RW,L,2012-13,45,3,7,10,0.22,5,98,3.06,8,33798.0,12:31,15,25,40,37.5,32,23,42,6,36,0,0,0,547.0,0:12,0,0,0,6497.0,2:24,2333333
8473565,Brian,Strait,1988-01-04,D,L,2012-13,19,0,4,4,0.21,4,13,0.0,10,19556.0,17:9,0,0,0,0.0,33,21,2,6,-4,0,0,0,72.0,0:3,0,0,0,1807.0,1:35,605000
8473571,Jamie,McBain,1988-02-25,D,R,2012-13,40,1,7,8,0.2,0,46,2.17,12,44218.0,18:25,0,0,0,0.0,22,63,8,18,-10,0,0,0,3206.0,1:20,0,0,0,1858.0,0:46,1800000
8473573,Artem,Anisimov,1988-05-24,C,L,2012-13,35,11,7,18,0.51,-6,68,16.18,12,34458.0,16:24,249,260,509,48.92,13,24,17,5,12,1,0,1,3592.0,1:42,0,0,0,3289.0,1:33,1875000
8473574,Shawn,Matthias,1988-02-19,LW,L,2012-13,48,14,7,21,0.44,-8,106,13.21,16,43747.0,15:11,153,194,347,44.09,66,21,16,4,12,2,1,3,2618.0,0:54,1,0,1,3031.0,1:3,851625
8473579,Nikolay,Kulemin,1986-07-14,LW,L,2012-13,48,7,16,23,0.48,-5,72,9.72,22,48205.0,16:44,10,10,20,50.0,122,47,30,13,17,0,0,0,1204.0,0:25,0,0,0,6302.0,2:11,2800000
8473584,Andrew,MacDonald,1986-09-07,D,L,2012-13,48,3,9,12,0.25,-2,45,6.67,20,67749.0,23:31,0,0,0,0.0,26,123,24,36,-12,1,2,3,4348.0,1:30,0,0,0,8035.0,2:47,550000
8473588,Erik,Condra,1986-08-06,RW,R,2012-13,48,4,8,12,0.25,3,73,5.48,34,37942.0,13:10,8,13,21,38.1,12,32,27,14,13,0,0,0,118.0,0:2,0,0,0,6095.0,2:6,625000
8473589,Chris,Summers,1988-02-05,D,L,2012-13,6,0,0,0,0.0,-3,5,0.0,9,4555.0,12:39,0,0,0,0.0,12,10,1,0,1,0,0,0,0.0,0:0,0,0,0,762.0,2:7,803250
8473600,Benn,Ferriero,1987-04-29,RW,R,2012-13,4,0,1,1,0.25,0,4,0.0,0,2306.0,9:36,2,7,9,22.22,4,2,2,1,1,0,0,0,105.0,0:26,0,0,0,45.0,0:11,700000
8473604,Jonathan,Toews,1988-04-29,C,L,2012-13,47,23,25,48,1.02,28,143,16.08,27,54545.0,19:20,559,374,933,59.91,24,16,56,16,40,2,4,6,7580.0,2:41,2,1,3,3995.0,1:25,6300000
8473610,Bobby,Sanguinetti,1988-02-29,D,R,2012-13,37,2,4,6,0.16,-6,48,4.17,4,32751.0,14:45,0,1,1,0.0,50,40,12,12,0,0,1,1,1287.0,0:34,0,0,0,2578.0,1:9,700000
8473618,Mathieu,Perreault,1988-01-05,C,L,2012-13,39,6,11,17,0.44,7,47,12.77,20,27302.0,11:40,168,157,325,51.69,28,8,9,7,2,2,1,3,2785.0,1:11,0,0,0,85.0,0:2,1050000
8473646,Ryan,Carter,1983-08-03,LW,L,2012-13,44,6,9,15,0.34,-2,63,9.52,31,34459.0,13:3,43,40,83,51.81,50,15,17,9,8,0,0,0,140.0,0:3,1,2,3,2450.0,0:55,775000
8473658,Victor,Bartley,1988-02-17,D,L,2012-13,24,0,7,7,0.29,2,19,0.0,6,28141.0,19:32,0,0,0,0.0,35,28,11,15,-4,0,0,0,1035.0,0:43,0,0,0,1660.0,1:9,537500
8473673,David,Schlemko,1987-05-07,D,L,2012-13,30,1,5,6,0.2,8,35,2.86,12,30991.0,17:13,0,0,0,0.0,38,57,5,6,-1,0,0,0,3339.0,1:51,0,0,0,2591.0,1:26,550000
8473682,Andrew,Ebbett,1983-01-02,C,L,2012-13,28,1,5,6,0.21,-1,23,4.35,4,20704.0,12:19,106,161,267,39.7,17,15,7,8,-1,0,0,0,489.0,0:17,0,0,0,1715.0,1:1,600000
8473700,Ryan,Wilson,1987-02-03,D,L,2012-13,12,0,3,3,0.25,4,23,0.0,8,13322.0,18:30,0,0,0,0.0,17,12,5,6,-1,0,0,0,392.0,0:32,0,0,0,2187.0,3:2,2250000
8473712,Frazer,McLaren,1987-10-29,LW,L,2012-13,36,3,2,5,0.14,0,20,15.0,102,11241.0,5:12,4,7,11,36.36,53,9,1,5,-4,0,0,0,120.0,0:3,0,0,0,4.0,0:0,632500
8473722,John,Scott,1982-09-26,LW,L,2012-13,34,0,0,0,0.0,-1,15,0.0,69,11106.0,5:26,0,0,0,0.0,38,5,8,7,1,0,0,0,2.0,0:0,0,0,0,13.0,0:0,600000
8473908,Kevin,Westgarth,1984-02-07,RW,R,2012-13,31,2,2,4,0.13,1,16,12.5,45,10642.0,5:43,0,3,3,0.0,28,1,4,7,-3,0,0,0,74.0,0:2,0,0,0,0.0,0:0,725000
8473914,Mark,Letestu,1985-02-04,C,R,2012-13,46,13,14,27,0.59,7,92,14.13,10,45583.0,16:30,244,243,487,50.1,36,12,27,7,20,3,2,5,3354.0,1:12,2,0,2,6101.0,2:12,625000
8473932,Darroll,Powe,1985-06-22,C,L,2012-13,42,0,0,0,0.0,-1,23,0.0,27,22675.0,8:59,56,48,104,53.85,82,22,5,3,2,0,0,0,280.0,0:6,0,0,0,4069.0,1:36,1066667
8473933,Ben,Lovejoy,1984-02-20,D,R,2012-13,35,0,10,10,0.29,4,58,0.0,29,37435.0,17:49,0,0,0,0.0,76,42,8,8,0,0,3,3,1119.0,0:31,0,1,1,1654.0,0:47,525000
8473953,Derek,Smith,1984-10-13,D,L,2012-13,22,0,1,1,0.05,-5,18,0.0,10,16164.0,12:14,0,0,0,0.0,7,24,2,9,-7,0,0,0,21.0,0:0,0,0,0,492.0,0:22,775000
8473962,Teddy,Purcell,1985-09-08,LW,R,2012-13,48,11,25,36,0.75,-1,94,11.7,12,48219.0,16:44,2,4,6,33.33,11,7,20,25,-5,3,10,13,9736.0,3:22,0,0,0,115.0,0:2,2362500
8473970,Rob,Klinkhammer,1986-08-12,LW,L,2012-13,22,5,6,11,0.5,7,34,14.71,10,16144.0,12:13,2,0,2,100.0,65,6,5,1,4,1,0,1,263.0,0:11,0,0,0,157.0,0:7,650000
8473986,Alex,Killorn,1989-09-14,LW,L,2012-13,38,7,12,19,0.5,-6,82,8.54,14,38347.0,16:49,11,17,28,39.29,40,22,11,17,-6,1,2,3,4263.0,1:52,0,0,0,2590.0,1:8,875000
8473991,Karl,Alzner,1988-09-24,D,L,2012-13,48,1,4,5,0.1,-6,39,2.56,14,60352.0,20:57,0,0,0,0.0,45,85,10,23,-13,0,0,0,264.0,0:5,0,0,0,7413.0,2:34,1285000
8473992,Justin,Falk,1988-10-11,D,L,2012-13,36,0,3,3,0.08,-9,27,0.0,40,28543.0,13:12,0,0,0,0.0,53,39,7,6,1,0,0,0,127.0,0:3,0,0,0,2738.0,1:16,825000
8473994,Jamie,Benn,1989-07-18,LW,L,2012-13,41,12,21,33,0.8,-12,110,10.91,40,48979.0,19:54,327,382,709,46.12,71,32,41,31,10,3,7,10,8163.0,3:19,0,0,0,1086.0,0:26,5250000
8474001,TJ,Galiardi,1988-04-22,LW,L,2012-13,36,5,9,14,0.39,1,68,7.35,14,29960.0,13:52,5,14,19,26.32,36,15,18,14,4,1,1,2,1219.0,0:33,0,0,0,1750.0,0:48,950000
8474009,Nick,Bonino,1988-04-20,C,L,2012-13,27,5,8,13,0.48,-3,37,13.51,8,25736.0,15:53,138,157,295,46.78,11,49,16,8,8,1,2,3,2869.0,1:46,0,0,0,1981.0,1:13,700000
8474013,Ian,Cole,1989-02-21,D,L,2012-13,15,0,1,1,0.07,-4,10,0.0,10,15971.0,17:44,0,0,0,0.0,6,22,1,5,-4,0,0,0,220.0,0:14,0,0,0,236.0,0:15,875000
8474024,Jim,O'Brien,1989-01-29,C,R,2012-13,29,5,1,6,0.21,-2,38,13.16,8,19879.0,11:25,100,119,219,45.66,30,13,9,6,3,1,0,1,191.0,0:6,0,0,0,3596.0,2:4,637500
8474025,Eric,Tangradi,1989-02-10,LW,L,2012-13,41,1,3,4,0.1,-2,48,2.08,22,24808.0,10:5,0,2,2,0.0,87,22,8,8,0,0,0,0,411.0,0:10,0,0,0,7.0,0:0,726000
8474027,Justin,Braun,1987-02-10,D,R,2012-13,41,0,7,7,0.17,-5,48,0.0,6,46251.0,18:48,0,0,0,0.0,53,51,12,24,-12,0,1,1,3197.0,1:17,0,0,0,3793.0,1:32,1250000
8474030,Aaron,Palushaj,1989-09-07,RW,R,2012-13,25,2,7,9,0.36,-2,29,6.9,8,16973.0,11:18,2,6,8,25.0,32,13,8,5,3,0,0,0,1108.0,0:44,0,0,0,1.0,0:0,600000
8474031,Kevin,Shattenkirk,1989-01-29,D,R,2012-13,48,5,18,23,0.48,2,84,5.95,20,61348.0,21:18,0,0,0,0.0,55,59,22,22,0,2,7,9,7554.0,2:37,0,0,0,5110.0,1:46,875000
8474034,Patrick,Maroon,1988-04-23,LW,L,2012-13,13,2,1,3,0.23,-1,21,9.52,10,7633.0,9:47,4,10,14,28.57,22,7,5,0,5,0,0,0,336.0,0:25,0,0,0,0.0,0:0,550000
8474037,James,van Riemsdyk,1989-05-04,LW,L,2012-13,48,18,14,32,0.67,-7,140,12.86,26,55317.0,19:12,24,19,43,55.81,55,15,17,31,-14,5,1,6,8135.0,2:49,0,0,0,3448.0,1:11,4250000
8474038,Paul,Byron,1989-04-27,LW,L,2012-13,4,0,1,1,0.25,-2,1,0.0,2,2509.0,10:27,7,10,17,41.18,3,1,0,1,-1,0,0,0,59.0,0:14,0,0,0,151.0,0:37,560000
8474040,Sam,Gagner,1989-08-10,C,R,2012-13,48,14,24,38,0.79,-6,113,12.39,23,55905.0,19:24,325,416,741,43.86,35,22,23,26,-3,4,11,15,8437.0,2:55,0,2,2,4596.0,1:35,3200000
8474048,Keith,Aulie,1989-06-11,D,L,2012-13,45,2,5,7,0.16,1,37,5.41,60,34611.0,12:49,0,0,0,0.0,91,42,5,8,-3,0,0,0,27.0,0:0,0,0,0,1738.0,0:38,577500
8474049,Akim,Aliu,1989-04-24,RW,R,2012-13,5,0,0,0,0.0,-2,2,0.0,14,3259.0,10:51,0,0,0,0.0,5,2,1,2,-1,0,0,0,205.0,0:41,0,0,0,0.0,0:0,695000
8474052,Chris,Terry,1989-04-07,LW,L,2012-13,3,1,0,1,0.33,0,1,100.0,0,1729.0,9:36,1,0,1,100.0,1,1,2,0,2,0,0,0,66.0,0:22,0,0,0,0.0,0:0,537500
8474053,Logan,Couture,1989-03-28,C,L,2012-13,48,21,16,37,0.77,7,151,13.91,4,52119.0,18:5,252,237,489,51.53,32,51,31,22,9,7,5,12,8977.0,3:7,0,1,1,2575.0,0:53,2875000
8474056,P.K.,Subban,1989-05-13,D,R,2012-13,42,11,27,38,0.9,12,126,8.73,57,58575.0,23:14,0,0,0,0.0,51,49,10,42,-32,7,19,26,11870.0,4:42,0,0,0,3654.0,1:27,3109375
8474061,Anthony,Peluso,1989-04-18,RW,R,2012-13,5,0,2,2,0.4,1,4,0.0,14,1499.0,4:59,0,0,0,0.0,7,0,0,1,-1,0,0,0,58.0,0:11,0,0,0,0.0,0:0,605000
8474062,Riley,Nash,1989-05-09,C,R,2012-13,32,4,5,9,0.28,-4,36,11.11,8,24577.0,12:48,128,161,289,44.29,36,10,31,3,28,0,0,0,1493.0,0:46,0,0,0,530.0,0:16,704166
8474066,Thomas,Hickey,1989-02-08,D,L,2012-13,39,1,3,4,0.1,9,40,2.5,8,39451.0,16:51,0,0,0,0.0,27,47,13,17,-4,0,0,0,111.0,0:2,0,0,0,2505.0,1:4,700000
8474068,Kyle,Turris,1989-08-14,C,R,2012-13,48,12,17,29,0.6,6,118,10.17,24,56561.0,19:38,451,469,920,49.02,30,20,28,27,1,3,6,9,7873.0,2:44,0,0,0,4126.0,1:25,1400000
8474074,Paul,Postma,1989-02-22,D,R,2012-13,34,4,5,9,0.26,-5,32,12.5,6,30658.0,15:1,0,0,0,0.0,17,27,9,16,-7,2,2,4,3439.0,1:41,0,0,0,106.0,0:3,550000
8474089,Brad,Malone,1989-05-20,C,L,2012-13,13,1,1,2,0.15,-7,10,10.0,16,6855.0,8:47,22,24,46,47.83,39,3,6,1,5,0,0,0,13.0,0:1,0,0,0,229.0,0:17,700000
8474090,Brendan,Smith,1989-02-08,D,L,2012-13,34,0,8,8,0.24,1,33,0.0,36,37538.0,18:24,0,0,0,0.0,20,35,10,27,-17,0,2,2,2352.0,1:9,0,0,0,2610.0,1:16,875000
8474091,Brandon,Sutter,1989-02-14,C,R,2012-13,48,11,8,19,0.4,3,82,13.41,4,47250.0,16:24,382,379,761,50.2,30,32,19,19,0,3,1,4,3397.0,1:10,0,0,0,5449.0,1:53,2066667
8474094,Matt,Halischuk,1988-06-01,RW,R,2012-13,36,5,6,11,0.31,1,51,9.8,10,25813.0,11:57,2,4,6,33.33,33,21,13,12,1,0,0,0,178.0,0:4,0,0,0,1868.0,0:51,712500
8474095,Dana,Tyrell,1989-04-23,C,L,2012-13,21,1,3,4,0.19,-3,19,5.26,4,13044.0,10:21,5,10,15,33.33,24,2,5,4,1,0,0,0,162.0,0:7,0,0,0,1511.0,1:11,600000
8474096,Nick,Spaling,1988-09-19,C,L,2012-13,47,9,4,13,0.28,-10,57,15.79,18,44726.0,15:51,223,259,482,46.27,38,21,22,7,15,1,1,2,675.0,0:14,0,1,1,5892.0,2:5,1050000
8474100,Dwight,King,1989-07-05,LW,L,2012-13,47,4,6,10,0.21,-3,60,6.67,11,35972.0,12:45,2,4,6,33.33,58,9,14,11,3,0,0,0,951.0,0:20,0,0,0,67.0,0:1,750000
8474102,David,Perron,1988-05-28,LW,R,2012-13,48,10,15,25,0.52,0,84,11.9,44,51860.0,18:0,8,14,22,36.36,48,11,26,14,12,2,4,6,7142.0,2:28,0,0,0,2121.0,0:44,3812500
8474113,TJ,Brennan,1989-04-03,D,L,2012-13,29,3,7,10,0.34,-9,42,7.14,8,29038.0,16:41,0,0,0,0.0,31,32,12,8,4,1,3,4,3816.0,2:11,0,0,0,263.0,0:9,550000
8474121,Colton,Gillies,1989-02-12,C,L,2012-13,27,1,1,2,0.07,1,17,5.88,17,13443.0,8:17,0,2,2,0.0,61,10,3,2,1,0,0,0,46.0,0:1,0,0,0,0.0,0:0,625000
8474125,Carl,Gunnarsson,1986-11-09,D,L,2012-13,37,1,14,15,0.41,5,28,3.57,14,47247.0,21:16,0,0,0,0.0,78,71,11,32,-21,0,0,0,1687.0,0:45,0,0,0,5758.0,2:35,1325000
8474134,Yannick,Weber,1988-09-23,D,R,2012-13,6,0,2,2,0.33,-1,3,0.0,2,4950.0,13:45,0,0,0,0.0,3,4,1,2,-1,0,1,1,605.0,1:40,0,0,0,113.0,0:18,850000
8474135,Brett,Bellemore,1988-06-25,D,R,2012-13,8,0,2,2,0.25,-2,3,0.0,7,6607.0,13:45,0,0,0,0.0,14,13,3,4,-1,0,0,0,39.0,0:4,0,0,0,934.0,1:56,525000
8474137,Drayson,Bowman,1989-03-08,LW,L,2012-13,37,3,2,5,0.14,-7,68,4.41,17,25984.0,11:42,4,6,10,40.0,55,14,21,7,14,0,0,0,614.0,0:16,0,0,0,1084.0,0:29,600000
8474138,Dustin,Jeffrey,1988-02-27,LW,L,2012-13,24,3,3,6,0.25,1,26,11.54,2,16579.0,11:30,94,106,200,47.0,6,5,2,5,-3,0,0,0,599.0,0:24,0,0,0,242.0,0:10,575000
8474141,Patrick,Kane,1988-11-19,RW,L,2012-13,47,23,32,55,1.17,11,138,16.67,8,56558.0,20:3,2,8,10,20.0,11,9,36,25,11,8,9,17,8345.0,2:57,0,0,0,24.0,0:0,6300000
8474145,Robert,Bortuzzo,1989-03-18,D,R,2012-13,15,2,2,4,0.27,3,10,20.0,27,11962.0,13:17,0,0,0,0.0,18,14,1,1,0,0,0,0,64.0,0:4,0,0,0,521.0,0:34,525000
8474150,Mikael,Backlund,1989-03-17,C,L,2012-13,32,8,8,16,0.5,-6,88,9.09,29,29039.0,15:7,194,213,407,47.67,31,19,28,17,11,2,2,4,2681.0,1:23,0,0,0,759.0,0:23,725000
8474151,Ryan,McDonagh,1989-06-13,D,L,2012-13,47,4,15,19,0.4,13,83,4.82,22,68690.0,24:21,0,1,1,0.0,69,78,27,26,1,0,1,1,1786.0,0:38,0,1,1,7609.0,2:41,875000
8474157,Max,Pacioretty,1988-11-20,LW,L,2012-13,44,15,24,39,0.89,8,163,9.2,28,43585.0,16:30,2,5,7,28.57,59,16,24,12,12,4,8,12,8147.0,3:5,0,0,0,272.0,0:6,1625000
8474161,Jakub,Voracek,1989-08-15,RW,L,2012-13,48,22,24,46,0.96,-7,129,17.05,35,49644.0,17:14,2,3,5,40.0,20,12,21,25,-4,8,9,17,10342.0,3:35,0,0,0,85.0,0:1,4250000
8474162,Jake,Muzzin,1989-02-21,D,L,2012-13,45,7,9,16,0.36,16,77,9.09,35,48317.0,17:53,0,0,0,0.0,70,29,7,23,-16,3,4,7,6080.0,2:15,0,0,0,126.0,0:2,577500
8474164,Jonathon,Blum,1989-01-30,D,R,2012-13,35,1,6,7,0.2,-1,26,3.85,6,30029.0,14:17,0,0,0,0.0,32,44,10,12,-2,0,0,0,2434.0,1:9,0,0,0,197.0,0:5,650000
8474166,Alec,Martinez,1987-07-26,D,L,2012-13,27,1,4,5,0.19,-2,30,3.33,10,25957.0,16:1,0,0,0,0.0,31,31,2,13,-11,0,1,1,2025.0,1:15,0,0,0,1187.0,0:43,737500
8474168,Joakim,Andersson,1989-02-05,C,L,2012-13,38,3,5,8,0.21,2,43,6.98,8,27555.0,12:5,144,166,310,46.45,17,12,4,16,-12,0,1,1,519.0,0:13,0,0,0,3013.0,1:19,612500
8474176,Carl,Hagelin,1988-08-23,LW,L,2012-13,48,10,14,24,0.5,10,132,7.58,18,49833.0,17:18,7,10,17,41.18,49,28,13,20,-7,1,0,1,2977.0,1:2,0,0,0,2057.0,0:42,637500
8474184,Keaton,Ellerby,1988-11-05,D,L,2012-13,44,0,3,3,0.07,3,23,0.0,52,38214.0,14:28,0,0,0,0.0,74,43,5,21,-16,0,0,0,300.0,0:6,0,0,0,4244.0,1:36,700000
8474189,Lars,Eller,1989-05-08,C,L,2012-13,46,8,22,30,0.65,8,84,9.52,45,40930.0,14:49,267,275,542,49.26,86,33,23,19,4,1,4,5,1947.0,0:42,0,0,0,4055.0,1:28,1150000
8474190,Wayne,Simmonds,1988-08-26,RW,R,2012-13,45,15,17,32,0.71,-7,110,13.64,82,42221.0,15:38,2,1,3,66.67,72,16,10,19,-9,6,10,16,8676.0,3:12,0,0,0,63.0,0:1,1750000
8474192,Matt,Frattin,1988-01-03,RW,R,2012-13,25,7,6,13,0.52,6,42,16.67,4,19839.0,13:13,5,3,8,62.5,55,11,10,13,-3,0,0,0,868.0,0:34,0,0,0,16.0,0:0,875000
8474201,Pierre-Cedric,Labrie,1986-12-06,LW,L,2012-13,19,2,1,3,0.16,2,16,12.5,30,9756.0,8:33,2,2,4,50.0,40,6,3,5,-2,0,0,0,12.0,0:0,0,0,0,2.0,0:0,525000
8474207,Nick,Holden,1987-05-15,D,L,2012-13,2,0,0,0,0.0,1,2,0.0,0,1029.0,8:34,0,0,0,0.0,3,0,0,2,-2,0,0,0,0.0,0:0,0,0,0,1.0,0:0,550000
8474218,Jason,Demers,1988-06-09,D,R,2012-13,22,1,2,3,0.14,-4,27,3.7,10,24589.0,18:37,0,0,0,0.0,32,24,6,12,-6,0,0,0,1730.0,1:18,0,0,0,1727.0,1:18,1250000
8474230,Micheal,Haley,1986-03-30,C,L,2012-13,9,0,0,0,0.0,-1,4,0.0,12,3579.0,6:37,2,1,3,66.67,21,5,0,1,-1,0,0,0,10.0,0:1,0,0,0,0.0,0:0,600000
8474250,Zack,Smith,1988-04-05,LW,L,2012-13,48,4,11,15,0.31,-9,94,4.26,56,43626.0,15:8,379,352,731,51.85,97,22,22,21,1,0,2,2,1926.0,0:40,0,0,0,1411.0,0:29,700000
8474291,Jay,Beagle,1985-10-16,C,R,2012-13,48,2,6,8,0.17,-1,56,3.57,14,34862.0,12:6,249,195,444,56.08,55,23,18,12,6,0,0,0,389.0,0:8,0,0,0,6109.0,2:7,900000
8474497,Michael,Kostka,1985-11-28,D,R,2012-13,35,0,8,8,0.23,-7,49,0.0,27,46367.0,22:4,0,0,0,0.0,49,66,12,31,-19,0,5,5,5457.0,2:35,0,0,0,3008.0,1:25,600000
8474518,Davis,Drewiske,1984-11-22,D,L,2012-13,29,2,5,7,0.24,3,28,7.14,14,26444.0,15:11,1,0,1,100.0,21,35,1,12,-11,1,0,1,473.0,0:16,0,0,0,4865.0,2:47,616667
8474519,Jack,Hillen,1986-01-24,D,L,2012-13,23,3,6,9,0.39,9,28,10.71,14,24305.0,17:36,0,0,0,0.0,10,35,2,13,-11,0,0,0,293.0,0:12,0,0,0,1239.0,0:53,650000
8474520,Jason,Garrison,1984-11-13,D,L,2012-13,47,8,8,16,0.34,18,94,8.51,28,61166.0,21:41,0,0,0,0.0,36,58,16,24,-8,3,3,6,6481.0,2:17,0,0,0,6522.0,2:18,4600000
8474535,Chris,Mueller,1986-03-06,C,R,2012-13,18,2,3,5,0.28,-4,22,9.09,6,11563.0,10:42,92,93,185,49.73,14,15,5,1,4,0,0,0,63.0,0:3,0,0,0,391.0,0:21,550000
8474551,Ville,Leino,1983-10-06,LW,L,2012-13,8,2,4,6,0.75,0,11,18.18,6,7586.0,15:48,4,6,10,40.0,5,2,1,2,-1,1,1,2,800.0,1:40,0,0,0,0.0,0:0,4500000
8474554,Eric,Selleck,1987-10-20,LW,L,2012-13,2,0,1,1,0.5,2,2,0.0,17,950.0,7:55,0,0,0,0.0,5,0,2,0,2,0,0,0,0.0,0:0,0,0,0,0.0,0:0,550000
8474563,Drew,Doughty,1989-12-08,D,R,2012-13,48,6,16,22,0.46,4,114,5.26,36,76016.0,26:23,0,0,0,0.0,128,46,9,36,-27,3,7,10,8802.0,3:3,0,0,0,6193.0,2:9,7000000
8474564,Steven,Stamkos,1990-02-07,C,R,2012-13,48,29,28,57,1.19,-4,157,18.47,32,63426.0,22:1,406,413,819,49.57,63,17,24,31,-7,10,8,18,10811.0,3:45,0,0,0,2096.0,0:43,7500000
8474565,Alex,Pietrangelo,1990-01-18,D,R,2012-13,47,5,19,24,0.51,0,93,5.38,10,70818.0,25:6,0,0,0,0.0,24,101,26,27,-1,2,4,6,8051.0,2:51,0,1,1,8525.0,3:1,816667
8474567,Zach,Bogosian,1990-07-15,D,R,2012-13,33,5,9,14,0.42,-5,85,5.88,29,45785.0,23:7,0,0,0,0.0,79,50,12,28,-16,0,3,3,3452.0,1:44,0,0,0,3945.0,1:59,2500000
8474568,Luke,Schenn,1989-11-02,D,R,2012-13,47,3,8,11,0.23,3,81,3.7,34,61653.0,21:51,0,0,0,0.0,187,102,14,31,-17,0,0,0,1022.0,0:21,0,0,0,7951.0,2:49,3600000
8474569,Colin,Wilson,1989-10-20,C,L,2012-13,25,7,12,19,0.76,1,26,26.92,4,24850.0,16:34,8,13,21,38.1,10,13,12,13,-1,2,4,6,3555.0,2:22,0,0,0,12.0,0:0,2000000
8474570,Cody,Hodgson,1990-02-18,C,R,2012-13,48,15,19,34,0.71,-4,114,13.16,20,52987.0,18:23,380,432,812,46.8,21,24,19,29,-10,3,2,5,7525.0,2:36,1,1,2,3716.0,1:17,816667
8474571,Mikkel,Boedker,1989-12-16,LW,L,2012-13,48,7,19,26,0.54,0,83,8.43,12,53213.0,18:28,1,10,11,9.09,77,17,27,13,14,3,4,7,8028.0,2:47,0,0,0,3118.0,1:4,1100000
8474573,Josh,Bailey,1989-10-02,RW,L,2012-13,38,11,8,19,0.5,7,76,14.47,6,37344.0,16:22,35,40,75,46.67,24,22,26,21,5,0,2,2,2937.0,1:17,0,0,0,2052.0,0:54,1050000
8474574,Tyler,Myers,1990-02-01,D,R,2012-13,39,3,5,8,0.21,-8,48,6.25,32,49874.0,21:18,0,0,0,0.0,58,56,11,30,-19,1,2,3,5161.0,2:12,0,0,0,5253.0,2:14,5500000
8474576,Zach,Boychuk,1989-10-04,LW,L,2012-13,13,1,1,2,0.15,-1,14,7.14,6,9603.0,12:18,0,0,0,0.0,10,2,2,3,-1,0,0,0,106.0,0:8,0,0,0,0.0,0:0,625000
8474577,Joe,Colborne,1990-01-30,C,L,2012-13,5,0,0,0,0.0,-1,4,0.0,2,2736.0,9:7,15,14,29,51.72,11,0,2,1,1,0,0,0,53.0,0:10,0,0,0,0.0,0:0,875000
8474578,Erik,Karlsson,1990-05-31,D,R,2012-13,17,6,8,14,0.82,8,79,7.59,8,27698.0,27:9,0,0,0,0.0,10,14,18,18,0,2,2,4,4602.0,4:30,1,0,1,1810.0,1:46,6500000
8474579,Luca,Sbisa,1990-01-30,D,L,2012-13,41,1,7,8,0.2,0,39,2.56,23,48792.0,19:50,0,0,0,0.0,99,57,10,13,-3,0,3,3,1692.0,0:41,0,0,0,4631.0,1:52,2175000
8474581,Jake,Gardiner,1990-07-04,D,L,2012-13,12,0,4,4,0.33,0,12,0.0,0,14746.0,20:28,0,0,0,0.0,13,15,6,12,-6,0,2,2,1764.0,2:27,0,0,0,164.0,0:13,875000
8474582,Mattias,Tedenby,1990-02-21,RW,L,2012-13,4,0,1,1,0.25,0,2,0.0,2,2158.0,8:59,0,0,0,0.0,1,1,0,1,-1,0,0,0,50.0,0:12,0,0,0,12.0,0:3,875000
8474584,Michael,Del Zotto,1990-06-24,D,L,2012-13,46,3,18,21,0.46,6,81,3.7,18,63962.0,23:10,0,0,0,0.0,77,64,10,26,-16,0,8,8,8006.0,2:54,1,0,1,4355.0,1:34,2550000
8474586,Jordan,Eberle,1990-05-15,C,R,2012-13,48,16,21,37,0.77,-4,133,12.03,16,54706.0,18:59,8,11,19,42.11,31,16,28,32,-4,3,6,9,9198.0,3:11,0,0,0,553.0,0:11,875000
8474589,Tyler,Ennis,1989-10-06,LW,L,2012-13,47,10,21,31,0.66,-14,108,9.26,16,50415.0,17:52,158,219,377,41.91,28,25,16,20,-4,2,12,14,9540.0,3:22,0,0,0,147.0,0:3,2812500
8474590,John,Carlson,1990-01-10,D,R,2012-13,48,6,16,22,0.46,11,97,6.19,18,66300.0,23:1,1,0,1,100.0,59,123,18,41,-23,0,5,5,6429.0,2:13,0,0,0,8321.0,2:53,3966667
8474594,Slava,Voynov,1990-01-15,D,R,2012-13,48,6,19,25,0.52,5,79,7.59,14,64230.0,22:18,2,0,2,100.0,83,48,8,38,-30,1,7,8,6043.0,2:5,0,0,0,4808.0,1:40,762500
8474597,Cody,Goloubef,1989-11-30,D,R,2012-13,11,1,0,1,0.09,-3,14,7.14,0,9777.0,14:48,0,0,0,0.0,10,7,0,1,-1,0,0,0,59.0,0:5,0,0,0,25.0,0:2,783333
8474600,Roman,Josi,1990-06-01,D,L,2012-13,48,5,13,18,0.38,-7,96,5.21,8,67765.0,23:31,0,0,0,0.0,31,73,16,20,-4,1,6,7,8307.0,2:53,0,0,0,2552.0,0:53,875000
8474602,Justin,Schultz,1990-07-06,D,R,2012-13,48,8,19,27,0.56,-17,85,9.41,8,61775.0,21:26,0,1,1,0.0,15,35,15,34,-19,4,11,15,9220.0,3:12,0,0,0,1676.0,0:34,925000
8474605,Patrick,Wiercioch,1990-09-12,D,L,2012-13,42,5,14,19,0.45,9,81,6.17,39,39548.0,15:41,0,0,0,0.0,28,29,1,18,-17,3,7,10,5842.0,2:19,0,0,0,159.0,0:3,875000
8474606,Colby,Robak,1990-04-24,D,L,2012-13,16,0,1,1,0.06,-1,15,0.0,17,14569.0,15:10,0,0,0,0.0,4,13,3,4,-1,0,0,0,1203.0,1:15,0,0,0,501.0,0:31,791667
8474609,Luke,Adam,1990-06-18,C,L,2012-13,4,1,0,1,0.25,1,2,50.0,2,2350.0,9:47,1,0,1,100.0,3,2,0,0,0,0,0,0,90.0,0:22,0,0,0,0.0,0:0,737500
8474610,Zac,Dalpe,1989-11-01,C,R,2012-13,10,1,2,3,0.3,-7,18,5.56,0,7381.0,12:18,1,2,3,33.33,14,4,4,0,4,0,0,0,523.0,0:52,0,0,0,0.0,0:0,704167
8474612,Travis,Hamonic,1990-08-16,D,R,2012-13,48,3,7,10,0.21,-8,83,3.61,28,65675.0,22:48,0,0,0,0.0,59,109,34,46,-12,1,2,3,3590.0,1:14,0,1,1,7882.0,2:44,875000
8474613,Derek,Stepan,1990-06-18,C,R,2012-13,48,18,26,44,0.92,25,108,16.67,12,60257.0,20:55,448,529,977,45.85,52,28,34,22,12,4,6,10,8141.0,2:49,1,3,4,6068.0,2:6,820833
8474615,Jared,Staal,1990-08-21,RW,R,2012-13,2,0,0,0,0.0,-2,3,0.0,2,1606.0,13:23,0,0,0,0.0,12,1,2,0,2,0,0,0,75.0,0:37,0,0,0,0.0,0:0,566666
8474616,Patrice,Cormier,1990-06-14,C,L,2012-13,10,0,0,0,0.0,-3,4,0.0,7,2332.0,3:53,1,5,6,16.67,15,2,0,0,0,0,0,0,22.0,0:2,0,0,0,0.0,0:0,575000
8474618,Marco,Scandella,1990-02-23,D,L,2012-13,6,1,0,1,0.17,-1,7,14.29,4,5193.0,14:25,0,0,0,0.0,8,4,0,1,-1,0,0,0,13.0,0:2,0,0,0,409.0,1:8,643333
8474625,Jimmy,Hayes,1989-11-21,RW,R,2012-13,10,1,3,4,0.4,0,13,7.69,0,8599.0,14:19,4,3,7,57.14,11,9,3,2,1,0,0,0,245.0,0:24,0,0,0,38.0,0:3,654167
8474628,Michael,Stone,1990-06-07,D,R,2012-13,40,5,4,9,0.22,2,50,10.0,16,40048.0,16:41,0,0,0,0.0,89,64,8,4,4,1,1,2,2616.0,1:5,0,0,0,2962.0,1:14,591667
8474641,Adam,Henrique,1990-02-06,C,L,2012-13,42,11,5,16,0.38,-3,78,14.1,16,46162.0,18:19,333,347,680,48.97,27,21,26,13,13,3,1,4,6685.0,2:39,2,1,3,4430.0,1:45,575000
8474646,Brandon,McMillan,1990-03-22,LW,L,2012-13,6,0,1,1,0.17,-1,2,0.0,2,3147.0,8:44,12,14,26,46.15,4,1,0,0,0,0,0,0,0.0,0:0,0,0,0,308.0,0:51,687500
8474649,Tomas,Kundratek,1989-12-26,D,R,2012-13,25,1,6,7,0.28,-5,23,4.35,8,24218.0,16:8,0,0,0,0.0,21,23,5,10,-5,0,3,3,1283.0,0:51,0,0,0,2080.0,1:23,579167
8474661,Michal,Jordan,1990-07-17,D,L,2012-13,5,0,0,0,0.0,-2,2,0.0,2,3206.0,10:41,0,0,0,0.0,0,2,0,2,-2,0,0,0,0.0,0:0,0,0,0,6.0,0:1,606667
8474666,David,Ullstrom,1989-04-22,LW,L,2012-13,20,2,3,5,0.25,-2,28,7.14,6,11398.0,9:29,10,8,18,55.56,23,1,3,5,-2,0,0,0,221.0,0:11,0,0,0,13.0,0:0,637500
8474668,Dale,Weise,1988-08-05,RW,R,2012-13,40,3,3,6,0.15,-7,35,8.57,43,22933.0,9:33,1,7,8,12.5,84,13,8,5,3,0,0,0,143.0,0:3,0,0,0,2148.0,0:53,615000
8474673,TJ,Brodie,1990-06-07,D,L,2012-13,47,2,12,14,0.3,-9,44,4.55,8,57011.0,20:13,0,0,0,0.0,24,74,25,36,-11,0,6,6,5697.0,2:1,0,0,0,1688.0,0:35,566667
8474674,James,Wright,1990-03-24,C,L,2012-13,38,2,3,5,0.13,-5,32,6.25,31,26446.0,11:35,22,24,46,47.83,43,17,12,4,8,0,0,0,11.0,0:0,0,0,0,3284.0,1:26,650000
8474679,Gustav,Nyquist,1989-09-01,RW,L,2012-13,22,3,3,6,0.27,0,46,6.52,6,17212.0,13:2,1,3,4,25.0,2,3,19,3,16,0,2,2,2838.0,2:9,0,0,0,10.0,0:0,762500
8474681,Andrei,Loktionov,1990-05-30,C,L,2012-13,28,8,4,12,0.43,-2,47,17.02,4,23948.0,14:15,80,126,206,38.83,6,8,19,10,9,1,2,3,2450.0,1:27,0,0,0,82.0,0:2,604167
8474683,Derek,Grant,1990-04-20,C,L,2012-13,5,0,0,0,0.0,-1,5,0.0,0,2599.0,8:39,17,14,31,54.84,8,0,0,1,-1,0,0,0,0.0,0:0,0,0,0,471.0,1:34,605000
8474685,Matt,Calvert,1989-12-24,LW,L,2012-13,42,9,7,16,0.38,-9,63,14.29,32,35732.0,14:10,2,4,6,33.33,57,24,17,6,11,0,0,0,1150.0,0:27,1,0,1,3009.0,1:11,712500
8474697,Mark,Borowiecki,1989-07-12,D,L,2012-13,6,0,0,0,0.0,1,1,0.0,18,4679.0,12:59,0,0,0,0.0,26,5,0,4,-4,0,0,0,0.0,0:0,0,0,0,784.0,2:10,610000
8474707,Philip,Larsen,1989-12-07,D,R,2012-13,32,2,3,5,0.16,-10,30,6.67,18,28570.0,14:52,0,0,0,0.0,50,18,3,11,-8,1,0,1,1333.0,0:41,0,0,0,784.0,0:24,1025000
8474709,Matt,Martin,1989-05-08,LW,L,2012-13,48,4,7,11,0.23,-2,67,5.97,63,34291.0,11:54,6,12,18,33.33,234,22,10,12,-2,1,0,1,628.0,0:13,0,0,0,4607.0,1:35,1000000
8474715,Cam,Atkinson,1989-06-05,RW,R,2012-13,35,9,9,18,0.51,9,91,9.89,4,32731.0,15:35,0,0,0,0.0,24,16,19,6,13,1,1,2,2774.0,1:19,0,0,0,1445.0,0:41,775000
8474716,Jared,Spurgeon,1989-11-29,D,R,2012-13,39,5,10,15,0.38,1,67,7.46,4,50412.0,21:32,0,0,0,0.0,46,55,10,15,-5,4,3,7,7238.0,3:5,0,0,0,3097.0,1:19,526667
8474717,Mark,Barberio,1990-03-23,D,L,2012-13,2,0,0,0,0.0,-2,1,0.0,0,1859.0,15:29,0,0,0,0.0,0,1,0,5,-5,0,0,0,352.0,2:56,0,0,0,35.0,0:17,580000
8474719,Teemu,Hartikainen,1990-05-03,C,L,2012-13,23,1,2,3,0.13,-8,21,4.76,6,14584.0,10:34,1,3,4,25.0,22,3,6,2,4,1,2,3,2797.0,2:1,0,0,0,10.0,0:0,875000
8474727,Ben,Smith,1988-07-11,RW,R,2012-13,1,1,0,1,1.0,1,1,100.0,0,1101.0,18:21,0,2,2,0.0,1,0,0,0,0,0,0,0,102.0,1:42,0,0,0,91.0,1:31,562500
8474736,Zac,Rinaldo,1990-06-15,C,L,2012-13,32,3,2,5,0.16,-7,15,20.0,85,16089.0,8:22,1,1,2,50.0,143,12,4,2,2,0,0,0,76.0,0:2,0,0,0,50.0,0:1,540000
8474739,Tommy,Wingels,1988-04-12,C,R,2012-13,42,5,8,13,0.31,-9,69,7.25,26,35868.0,14:14,4,12,16,25.0,115,32,18,12,6,0,1,1,1669.0,0:39,1,0,1,2454.0,0:58,775000
8474743,Zach,Redmond,1988-07-26,D,R,2012-13,8,1,3,4,0.5,0,13,7.69,12,9398.0,19:34,0,0,0,0.0,12,8,1,5,-4,0,1,1,715.0,1:29,1,0,1,679.0,1:24,687500
8474749,Matt,Bartkowski,1988-06-04,D,L,2012-13,11,0,2,2,0.18,0,9,0.0,6,8899.0,13:29,0,0,0,0.0,11,3,1,5,-4,0,0,0,7.0,0:0,0,0,0,134.0,0:12,660000
8474772,Stu,Bickel,1986-10-02,D,R,2012-13,16,0,0,0,0.0,-2,2,0.0,49,5296.0,5:31,0,0,0,0.0,13,6,1,6,-5,0,0,0,15.0,0:0,0,0,0,0.0,0:0,750000
8474774,Dalton,Prout,1990-03-13,D,R,2012-13,28,1,6,7,0.25,15,16,6.25,25,31128.0,18:31,0,0,0,0.0,51,40,6,15,-9,0,1,1,67.0,0:2,0,0,0,1592.0,0:56,666667
8474818,Jordie,Benn,1987-07-26,D,L,2012-13,26,1,5,6,0.23,-4,31,3.23,10,27013.0,17:18,0,0,0,0.0,25,31,8,21,-13,1,0,1,2303.0,1:28,0,0,0,3081.0,1:58,525000
8474837,Mark,Cundari,1990-04-23,D,L,2012-13,4,1,2,3,0.75,-2,8,12.5,2,4745.0,19:46,0,0,0,0.0,15,4,1,4,-3,1,1,2,398.0,1:39,0,0,0,219.0,0:54,541667
8474849,Antoine,Roussel,1989-11-21,LW,L,2012-13,39,7,7,14,0.36,3,46,15.22,85,21995.0,9:23,30,25,55,54.55,75,16,12,8,4,0,0,0,196.0,0:5,0,0,0,1687.0,0:43,612500
8474850,Brandon,Mashinter,1988-09-20,LW,L,2012-13,4,0,0,0,0.0,-2,2,0.0,0,1420.0,5:55,1,0,1,100.0,7,1,0,1,-1,0,0,0,0.0,0:0,0,0,0,0.0,0:0,550000
8474870,Tyler,Johnson,1990-07-29,C,R,2012-13,14,3,3,6,0.43,3,11,27.27,4,10982.0,13:4,72,49,121,59.5,18,4,2,4,-2,0,0,0,1413.0,1:40,0,0,0,562.0,0:40,756667
8474873,Brian,Lashoff,1990-07-16,D,L,2012-13,31,1,4,5,0.16,-10,26,3.85,15,33077.0,17:47,0,0,0,0.0,44,43,3,11,-8,0,0,0,343.0,0:11,0,0,0,4348.0,2:20,525000
8474884,Mike,Hoffman,1989-11-24,LW,L,2012-13,3,0,0,0,0.0,-1,6,0.0,2,2217.0,12:19,2,0,2,100.0,8,2,1,1,0,0,0,0,0.0,0:0,0,0,0,0.0,0:0,610000
8475098,Tyler,Bozak,1986-03-19,C,R,2012-13,46,12,16,28,0.61,-1,61,19.67,6,56057.0,20:18,559,504,1063,52.59,65,23,37,37,0,4,5,9,8207.0,2:58,1,0,1,4531.0,1:38,1500000
8475147,Jordan,Schroeder,1990-09-29,LW,R,2012-13,31,3,6,9,0.29,0,28,10.71,4,25506.0,13:42,140,181,321,43.61,10,11,14,5,9,1,0,1,4598.0,2:28,0,0,0,4.0,0:0,900000
8475148,Tim,Erixon,1991-02-24,D,L,2012-13,31,0,5,5,0.16,4,21,0.0,14,29195.0,15:41,0,0,0,0.0,20,35,0,11,-11,0,2,2,1770.0,0:57,0,0,0,313.0,0:10,900000
8475149,Marcus,Johansson,1990-10-06,LW,L,2012-13,34,6,16,22,0.65,3,40,15.0,4,33835.0,16:35,40,47,87,45.98,14,6,15,19,-4,3,1,4,3375.0,1:39,0,1,1,1958.0,0:57,900000
8475150,Jordan,Caron,1990-11-02,RW,L,2012-13,17,1,2,3,0.18,1,20,5.0,4,9594.0,9:24,0,0,0,0.0,18,4,3,3,0,0,0,0,289.0,0:17,0,0,0,0.0,0:0,886667
8475151,Kyle,Palmieri,1991-02-01,RW,R,2012-13,42,10,11,21,0.5,2,92,10.87,9,31064.0,12:19,1,11,12,8.33,48,10,14,7,7,2,1,3,3433.0,1:21,0,0,0,1.0,0:0,900000
8475155,Simon,Despres,1991-07-27,D,L,2012-13,33,2,5,7,0.21,9,33,6.06,20,29930.0,15:6,0,0,0,0.0,48,31,4,16,-12,0,1,1,1374.0,0:41,0,0,0,1063.0,0:32,840000
8475158,Ryan,O'Reilly,1991-02-07,C,L,2012-13,29,6,14,20,0.69,-3,66,9.09,4,32204.0,18:30,241,215,456,52.85,7,14,34,10,24,3,3,6,4481.0,2:34,0,0,0,1580.0,0:54,5000000
8475160,Kyle,Clifford,1991-01-13,LW,L,2012-13,48,7,7,14,0.29,1,56,12.5,51,30546.0,10:36,1,8,9,11.11,155,12,12,8,4,0,0,0,815.0,0:16,0,0,0,1284.0,0:26,710000
8475161,Chris,Brown,1991-02-03,RW,R,2012-13,5,0,0,0,0.0,0,6,0.0,2,2291.0,7:38,0,0,0,0.0,6,0,1,0,1,0,0,0,473.0,1:34,0,0,0,0.0,0:0,853333
8475163,Alex,Chiasson,1990-10-01,RW,R,2012-13,7,6,1,7,1.0,3,13,46.15,0,5914.0,14:4,5,13,18,27.78,10,2,1,0,1,1,0,1,672.0,1:36,0,0,0,0.0,0:0,866667
8475164,Jakob,Silfverberg,1990-10-13,RW,R,2012-13,48,10,9,19,0.4,9,134,7.46,12,46739.0,16:13,5,8,13,38.46,38,13,20,23,-3,2,1,3,4868.0,1:41,1,0,1,3249.0,1:7,863333
8475165,Anton,Lander,1991-04-24,C,L,2012-13,11,0,1,1,0.09,-4,11,0.0,2,7278.0,11:1,27,28,55,49.09,7,2,5,7,-2,0,0,0,5.0,0:0,0,1,1,1160.0,1:45,880000
8475166,John,Tavares,1990-09-20,C,L,2012-13,48,28,19,47,0.98,-2,162,17.28,18,59831.0,20:46,459,471,930,49.35,33,22,27,44,-17,9,7,16,9845.0,3:25,0,0,0,386.0,0:8,5500000
8475167,Victor,Hedman,1990-12-18,D,L,2012-13,44,4,16,20,0.45,1,76,5.26,31,59821.0,22:39,0,0,0,0.0,56,84,17,42,-25,0,2,2,4581.0,1:44,0,0,0,6876.0,2:36,4000000
8475168,Matt,Duchene,1991-01-16,C,L,2012-13,47,17,26,43,0.91,-12,132,12.88,12,58996.0,20:55,488,405,893,54.65,48,47,44,24,20,2,7,9,7946.0,2:49,0,1,1,6299.0,2:14,3500000
8475169,Evander,Kane,1991-08-02,LW,L,2012-13,48,17,16,33,0.69,-3,190,8.95,80,58903.0,20:27,13,20,33,39.39,147,22,25,31,-6,2,2,4,6972.0,2:25,0,0,0,2861.0,0:59,5250000
8475170,Brayden,Schenn,1991-08-22,C,L,2012-13,47,8,18,26,0.55,-8,79,10.13,24,43792.0,15:31,206,247,453,45.47,109,22,19,11,8,2,8,10,6786.0,2:24,0,0,0,140.0,0:2,870000
8475171,Oliver,Ekman-Larsson,1991-07-17,D,L,2012-13,48,3,21,24,0.5,5,101,2.97,26,72277.0,25:5,0,0,0,0.0,73,40,21,23,-2,0,8,8,10567.0,3:40,0,0,0,8678.0,3:0,900000
8475172,Nazem,Kadri,1990-10-06,C,L,2012-13,48,18,26,44,0.92,15,107,16.82,23,46230.0,16:3,250,315,565,44.25,62,22,23,30,-7,5,3,8,6371.0,2:12,0,0,0,512.0,0:10,870000
8475174,Jared,Cowen,1991-01-25,D,L,2012-13,7,1,0,1,0.14,1,8,12.5,10,8521.0,20:17,0,0,0,0.0,26,10,4,4,0,0,0,0,596.0,1:25,0,0,0,819.0,1:57,870000
8475175,Magnus,Paajarvi,1991-04-12,LW,L,2012-13,42,9,7,16,0.38,-1,75,12.0,14,35608.0,14:7,4,8,12,33.33,24,23,9,10,-1,2,0,2,3565.0,1:24,1,0,1,1033.0,0:24,900000
8475176,Ryan,Ellis,1991-01-03,D,R,2012-13,32,2,4,6,0.19,-2,48,4.17,15,31448.0,16:22,0,0,0,0.0,22,29,8,12,-4,2,0,2,3783.0,1:58,0,0,0,120.0,0:3,840000
8475178,Zack,Kassian,1991-01-24,RW,R,2012-13,39,7,4,11,0.28,-7,49,14.29,51,31544.0,13:28,6,8,14,42.86,70,4,10,20,-10,2,1,3,3445.0,1:28,0,0,0,0.0,0:0,870000
8475179,Dmitry,Kulikov,1990-10-29,D,L,2012-13,34,3,7,10,0.29,-5,52,5.77,22,42792.0,20:58,0,0,0,0.0,84,49,9,23,-14,2,4,6,4909.0,2:24,0,0,0,2479.0,1:12,2500000
8475180,Peter,Holland,1991-01-14,C,L,2012-13,21,3,2,5,0.24,4,26,11.54,4,14603.0,11:35,89,114,203,43.84,17,8,7,8,-1,1,0,1,892.0,0:42,0,0,0,38.0,0:1,870000
8475181,Nick,Leddy,1991-03-20,D,L,2012-13,48,6,12,18,0.38,15,65,9.23,10,50168.0,17:25,0,0,0,0.0,38,39,12,18,-6,2,6,8,7629.0,2:38,0,0,0,21.0,0:0,900000
8475182,David,Rundblad,1990-10-08,D,R,2012-13,8,0,1,1,0.12,-5,9,0.0,0,6592.0,13:44,0,0,0,0.0,7,9,0,2,-2,0,0,0,1786.0,3:43,0,0,0,148.0,0:18,900000
8475184,Chris,Kreider,1991-04-30,LW,L,2012-13,23,2,1,3,0.13,-1,19,10.53,6,13954.0,10:6,0,1,1,0.0,36,6,2,3,-1,0,0,0,959.0,0:41,0,0,0,0.0,0:0,800000
8475185,Jacob,Josefson,1991-03-02,C,L,2012-13,22,1,2,3,0.14,-10,20,5.0,2,17136.0,12:58,114,122,236,48.31,12,7,10,5,5,0,0,0,987.0,0:44,0,0,0,2335.0,1:46,900000
8475186,John,Moore,1990-11-19,D,L,2012-13,30,1,6,7,0.23,4,29,3.45,7,23989.0,13:19,0,0,0,0.0,38,32,3,4,-1,0,0,0,644.0,0:21,0,0,0,659.0,0:21,840000
8475191,Reilly,Smith,1991-04-01,RW,L,2012-13,37,3,6,9,0.24,0,34,8.82,8,24236.0,10:55,3,1,4,75.0,18,6,14,13,1,0,0,0,2275.0,1:1,0,0,0,885.0,0:23,900000
8475192,Taylor,Beck,1991-05-13,LW,R,2012-13,16,3,4,7,0.44,0,39,7.69,2,15450.0,16:5,6,3,9,66.67,13,11,3,5,-2,1,1,2,1841.0,1:55,0,0,0,0.0,0:0,660000
8475193,Tomas,Tatar,1990-12-01,LW,L,2012-13,18,4,3,7,0.39,2,32,12.5,4,12284.0,11:22,1,0,1,100.0,9,5,5,2,3,1,0,1,1963.0,1:49,0,0,0,0.0,0:0,630000
8475196,Ben,Hanowski,1990-10-18,RW,L,2012-13,5,1,0,1,0.2,0,4,25.0,0,3988.0,13:17,0,2,2,0.0,8,0,0,1,-1,0,0,0,47.0,0:9,0,0,0,44.0,0:8,900000
8475197,Tyson,Barrie,1991-07-26,D,R,2012-13,32,2,11,13,0.41,-11,58,3.45,10,41437.0,21:34,0,0,0,0.0,31,24,13,15,-2,1,4,5,5060.0,2:38,0,0,0,2287.0,1:11,715000
8475199,Eric,Gelinas,1991-05-08,D,L,2012-13,1,0,0,0,0.0,-1,1,0.0,0,959.0,15:59,0,0,0,0.0,1,0,0,0,0,0,0,0,54.0,0:54,0,0,0,0.0,0:0,660000
8475200,Dmitry,Orlov,1991-07-23,D,L,2012-13,5,0,1,1,0.2,5,1,0.0,0,4483.0,14:56,0,0,0,0.0,2,4,2,2,0,0,0,0,246.0,0:49,0,0,0,67.0,0:13,690000
8475204,Brandon,Pirri,1991-04-10,RW,L,2012-13,1,0,0,0,0.0,0,2,0.0,0,1075.0,17:55,6,8,14,42.86,1,1,0,0,0,0,0,0,102.0,1:42,0,0,0,1.0,0:1,618333
8475206,Stefan,Elliott,1991-01-30,D,R,2012-13,18,1,3,4,0.22,-3,35,2.86,2,18905.0,17:30,0,0,0,0.0,10,18,8,6,2,0,1,1,1727.0,1:35,0,0,0,255.0,0:14,843333
8475209,Richard,Panik,1991-02-07,RW,L,2012-13,25,5,4,9,0.36,-2,34,14.71,4,16993.0,11:19,1,2,3,33.33,38,13,13,7,6,1,1,2,1197.0,0:47,0,0,0,40.0,0:1,740000
8475213,Drew,Shore,1991-01-29,C,R,2012-13,43,3,10,13,0.3,-10,96,3.12,14,40782.0,15:48,212,231,443,47.86,37,18,19,10,9,1,2,3,2518.0,0:58,1,0,1,2261.0,0:52,900000
8475214,Jeremy,Morin,1991-04-16,LW,R,2012-13,3,1,1,2,0.67,1,7,14.29,0,2344.0,13:1,0,4,4,0.0,3,1,0,1,-1,0,0,0,102.0,0:34,0,0,0,0.0,0:0,735000
8475220,Marcus,Foligno,1991-08-10,LW,L,2012-13,47,5,13,18,0.38,-4,55,9.09,41,38429.0,13:37,45,30,75,60.0,108,16,18,11,7,1,3,4,4345.0,1:32,0,1,1,394.0,0:8,826667
8475222,Sami,Vatanen,1991-06-03,D,R,2012-13,8,2,0,2,0.25,3,6,33.33,0,7593.0,15:49,0,0,0,0.0,2,13,2,1,1,1,0,1,1240.0,2:35,0,0,0,33.0,0:4,785000
8475225,Craig,Smith,1989-09-05,RW,R,2012-13,44,4,8,12,0.27,-11,83,4.82,20,36582.0,13:51,79,121,200,39.5,39,13,21,17,4,2,5,7,5008.0,1:53,0,0,0,1.0,0:0,715000
8475231,Casey,Cizikas,1991-02-27,C,L,2012-13,45,6,9,15,0.33,0,45,13.33,14,29124.0,10:47,144,132,276,52.17,75,21,21,6,15,0,1,1,89.0,0:1,0,0,0,1932.0,0:42,793333
8475233,David,Savard,1990-10-22,D,R,2012-13,4,0,0,0,0.0,-3,1,0.0,0,3168.0,13:12,0,0,0,0.0,4,2,0,1,-1,0,0,0,20.0,0:5,0,0,0,171.0,0:42,740167
8475236,Cody,Eakin,1991-05-24,C,L,2012-13,48,7,17,24,0.5,1,67,10.45,31,43444.0,15:5,304,322,626,48.56,71,29,27,25,2,3,0,3,3434.0,1:11,0,0,0,4947.0,1:43,571667
8475254,Gabriel,Dumont,1990-10-06,C,R,2012-13,10,1,2,3,0.3,1,20,5.0,13,5807.0,9:40,29,17,46,63.04,21,6,2,0,2,0,0,0,40.0,0:4,0,0,0,166.0,0:16,571667
8475264,Roman,Horak,1991-05-21,C,L,2012-13,20,2,5,7,0.35,-5,28,7.14,2,17433.0,14:31,93,112,205,45.37,18,13,12,5,7,0,0,0,1222.0,1:1,0,1,1,1070.0,0:53,613333
8475266,Tomas,Vincour,1990-11-19,C,R,2012-13,17,2,2,4,0.24,-1,12,16.67,4,9038.0,8:51,0,5,5,0.0,24,2,4,7,-3,0,0,0,140.0,0:8,0,0,0,0.0,0:0,621667
8475268,Gabriel,Bourque,1990-09-23,LW,L,2012-13,34,11,5,16,0.47,6,50,22.0,4,32298.0,15:49,4,2,6,66.67,39,23,13,10,3,3,0,3,2164.0,1:3,1,0,1,1767.0,0:51,618333
8475283,Lane,MacDermid,1989-08-25,LW,L,2012-13,9,2,0,2,0.22,1,4,50.0,19,2478.0,4:35,0,0,0,0.0,13,0,0,1,-1,0,0,0,0.0,0:0,0,0,0,0.0,0:0,600000
8475304,Scott,Timmins,1989-09-11,C,L,2012-13,5,0,0,0,0.0,-2,6,0.0,4,3175.0,10:35,15,16,31,48.39,6,5,1,3,-2,0,0,0,17.0,0:3,0,0,0,516.0,1:43,581667
8475314,Anders,Lee,1990-07-03,LW,L,2012-13,2,1,1,2,1.0,-3,2,50.0,0,984.0,8:12,0,2,2,0.0,0,2,0,1,-1,0,0,0,0.0,0:0,0,0,0,0.0,0:0,900000
8475323,Marcus,Kruger,1990-05-27,C,L,2012-13,47,4,9,13,0.28,3,50,8.0,24,39947.0,14:9,228,265,493,46.25,12,29,24,6,18,0,2,2,794.0,0:16,0,0,0,7089.0,2:30,735000
8475325,Jordan,Nolan,1989-06-23,C,L,2012-13,44,2,4,6,0.14,-5,23,8.7,46,22369.0,8:28,0,8,8,0.0,72,5,7,10,-3,0,0,0,282.0,0:6,0,0,0,13.0,0:0,531667
8475342,Oliver,Lauridsen,1989-03-24,D,L,2012-13,15,2,1,3,0.2,0,14,14.29,34,13621.0,15:8,0,0,0,0.0,36,24,0,12,-12,0,0,0,15.0,0:1,0,0,0,759.0,0:50,650000
8475395,Matthew,Konan,1991-09-03,D,L,2012-13,2,0,0,0,0.0,0,4,0.0,0,1911.0,15:55,0,0,0,0.0,5,2,0,1,-1,0,0,0,0.0,0:0,0,0,0,56.0,0:28,717500
8475430,Brandon,Manning,1990-06-04,D,L,2012-13,6,0,2,2,0.33,4,5,0.0,0,5329.0,14:48,0,0,0,0.0,15,4,2,3,-1,0,0,0,0.0,0:0,0,0,0,24.0,0:4,715000
8475455,Brenden,Dillon,1990-11-13,D,L,2012-13,48,3,5,8,0.17,1,75,4.0,65,61574.0,21:22,0,0,0,0.0,133,74,8,20,-12,0,0,0,1160.0,0:24,0,0,0,7443.0,2:35,743333
8475462,Radko,Gudas,1990-06-05,D,R,2012-13,22,2,3,5,0.23,3,31,6.45,38,22430.0,16:59,0,0,0,0.0,87,28,5,17,-12,0,0,0,224.0,0:10,0,0,0,1103.0,0:50,600000
8475598,Ryan,Stanton,1989-07-20,D,L,2012-13,1,0,0,0,0.0,1,1,0.0,2,1025.0,17:5,0,0,0,0.0,1,2,0,0,0,0,0,0,0.0,0:0,0,0,0,44.0,0:44,592500
8475613,Nate,Prosser,1986-05-07,D,R,2012-13,17,0,0,0,0.0,4,5,0.0,4,11476.0,11:15,0,0,0,0.0,17,22,4,5,-1,0,0,0,23.0,0:1,0,0,0,751.0,0:44,825000
8475619,Aaron,Volpatti,1985-05-30,LW,L,2012-13,33,1,1,2,0.06,-2,21,4.76,35,16508.0,8:20,1,3,4,25.0,80,10,4,5,-1,0,0,0,228.0,0:6,0,0,0,4.0,0:0,600000
8475625,Matt,Irwin,1987-11-29,D,L,2012-13,38,6,6,12,0.32,-1,79,7.59,10,43550.0,19:6,0,0,0,0.0,39,65,16,29,-13,4,1,5,3993.0,1:45,0,0,0,436.0,0:11,650000
8475637,Bobby,Butler,1987-04-26,RW,R,2012-13,34,4,7,11,0.32,-8,41,9.76,4,22039.0,10:48,2,3,5,40.0,15,4,7,4,3,1,3,4,3566.0,1:44,0,0,0,39.0,0:1,1050000
8475650,Brandon,Bollig,1987-01-31,LW,L,2012-13,25,0,0,0,0.0,-1,34,0.0,51,12019.0,8:0,0,3,3,0.0,41,6,1,0,1,0,0,0,100.0,0:4,0,0,0,55.0,0:2,575000
8475661,Dave,Dziurzynski,1989-10-06,LW,L,2012-13,12,2,0,2,0.17,-1,20,10.0,13,9035.0,12:32,3,1,4,75.0,29,3,4,2,2,0,0,0,174.0,0:14,0,0,0,8.0,0:0,600000
8475671,Matt,Fraser,1990-05-20,RW,L,2012-13,12,1,2,3,0.25,0,17,5.88,0,8490.0,11:47,0,0,0,0.0,13,8,3,2,1,0,0,0,549.0,0:45,0,0,0,0.0,0:0,560000
8475690,Christopher,Tanev,1989-12-20,D,R,2012-13,38,2,5,7,0.18,4,20,10.0,10,39419.0,17:17,0,0,0,0.0,14,61,13,14,-1,0,0,0,256.0,0:6,0,0,0,3729.0,1:38,900000
8475692,Mats,Zuccarello,1987-09-01,RW,L,2012-13,15,3,5,8,0.53,10,27,11.11,8,14782.0,16:25,0,4,4,0.0,27,15,6,5,1,0,1,1,2171.0,2:24,0,1,1,9.0,0:0,700000
8475722,Jason,Zucker,1992-01-16,LW,L,2012-13,20,4,1,5,0.25,4,34,11.76,8,13518.0,11:15,0,1,1,0.0,11,5,4,7,-3,0,0,0,391.0,0:19,0,0,0,0.0,0:0,771667
8475726,Tyler,Toffoli,1992-04-24,C,R,2012-13,10,2,3,5,0.5,3,20,10.0,2,7187.0,11:58,0,0,0,0.0,4,1,3,2,1,1,1,2,933.0,1:33,0,0,0,0.0,0:0,716667
8475727,Ryan,Spooner,1992-01-30,C,L,2012-13,4,0,0,0,0.0,0,4,0.0,0,2189.0,9:7,11,13,24,45.83,1,2,0,1,-1,0,0,0,389.0,1:37,0,0,0,3.0,0:0,760000
8475728,Johan,Larsson,1992-07-25,C,L,2012-13,1,0,0,0,0.0,0,2,0.0,0,842.0,14:2,0,0,0,0.0,2,1,0,0,0,0,0,0,8.0,0:8,0,0,0,0.0,0:0,763333
8475733,Max,Reinhart,1992-02-04,C,L,2012-13,11,1,2,3,0.27,-3,26,3.85,4,9515.0,14:25,34,57,91,37.36,8,2,4,0,4,0,1,1,520.0,0:47,0,0,0,686.0,1:2,618333
8475745,Charlie,Coyle,1992-03-02,C,R,2012-13,37,8,6,14,0.38,3,50,16.0,28,33439.0,15:3,9,17,26,34.62,50,9,14,9,5,1,0,1,1707.0,0:46,0,0,0,878.0,0:23,900000
8475749,Christian,Thomas,1992-05-26,LW,R,2012-13,1,0,0,0,0.0,0,2,0.0,0,766.0,12:46,0,0,0,0.0,3,0,0,0,0,0,0,0,95.0,1:35,0,0,0,0.0,0:0,808333
8475753,Justin,Faulk,1992-03-20,D,R,2012-13,38,5,10,15,0.39,1,76,6.58,15,54738.0,24:0,0,0,0,0.0,63,47,24,26,-2,1,2,3,6033.0,2:38,1,0,1,6803.0,2:59,840000
8475755,Alex,Petrovic,1992-03-03,D,R,2012-13,6,0,0,0,0.0,-8,5,0.0,25,6761.0,18:46,0,0,0,0.0,10,4,0,6,-6,0,0,0,106.0,0:17,0,0,0,247.0,0:41,795000
8475758,Devante,Smith-Pelly,1992-06-14,RW,R,2012-13,7,0,0,0,0.0,-4,5,0.0,0,3778.0,8:59,0,0,0,0.0,14,4,2,1,1,0,0,0,0.0,0:0,0,0,0,83.0,0:11,720000
8475760,Nick,Bjugstad,1992-07-17,C,R,2012-13,11,1,0,1,0.09,-8,17,5.88,2,10039.0,15:12,53,79,132,40.15,17,2,3,2,1,0,0,0,653.0,0:59,0,0,0,54.0,0:4,900000
8475761,Beau,Bennett,1991-11-27,RW,R,2012-13,26,3,11,14,0.54,7,30,10.0,6,19192.0,12:18,1,3,4,25.0,28,9,10,7,3,1,4,5,2596.0,1:39,0,0,0,4.0,0:0,900000
8475764,Cam,Fowler,1991-12-05,D,L,2012-13,37,1,10,11,0.3,-4,50,2.0,4,45375.0,20:26,0,0,0,0.0,19,41,5,30,-25,1,5,6,5577.0,2:30,0,0,0,1099.0,0:29,900000
8475765,Vladimir,Tarasenko,1991-12-13,RW,L,2012-13,38,8,11,19,0.5,1,75,10.67,10,30575.0,13:24,1,0,1,100.0,28,7,14,6,8,3,2,5,4069.0,1:47,0,0,0,55.0,0:1,900000
8475766,Austin,Watson,1992-01-13,LW,R,2012-13,6,1,0,1,0.17,-2,4,25.0,0,4574.0,12:42,19,25,44,43.18,2,2,3,3,0,0,0,0,367.0,1:1,0,0,0,182.0,0:30,900000
8475768,Jaden,Schwartz,1992-06-25,LW,L,2012-13,45,7,6,13,0.29,-4,50,14.0,4,33664.0,12:28,15,12,27,55.56,34,18,21,9,12,0,0,0,759.0,0:16,0,0,0,465.0,0:10,830000
8475769,Quinton,Howden,1992-01-21,C,L,2012-13,18,0,0,0,0.0,-11,22,0.0,2,11292.0,10:27,1,3,4,25.0,21,6,9,1,8,0,0,0,37.0,0:2,0,0,0,128.0,0:7,870000
8475770,Emerson,Etem,1992-06-16,RW,L,2012-13,38,3,7,10,0.26,7,48,6.25,9,26133.0,11:27,2,3,5,40.0,43,20,11,5,6,0,0,0,307.0,0:8,0,2,2,2390.0,1:2,870000
8475772,Riley,Sheahan,1991-12-07,C,L,2012-13,1,0,0,0,0.0,0,1,0.0,0,407.0,6:47,0,1,1,0.0,0,0,1,0,1,0,0,0,0.0,0:0,0,0,0,0.0,0:0,785000
8475775,Tye,McGinn,1990-07-29,LW,L,2012-13,18,3,2,5,0.28,0,33,9.09,19,13737.0,12:43,0,0,0,0.0,19,1,6,2,4,0,0,0,1814.0,1:40,0,0,0,16.0,0:0,775000
8475784,Jeff,Skinner,1992-05-16,LW,L,2012-13,42,13,11,24,0.57,-21,159,8.18,26,46528.0,18:27,21,23,44,47.73,21,11,37,17,20,5,4,9,7026.0,2:47,0,0,0,238.0,0:5,900000
8475788,Alexander,Burmistrov,1991-10-21,C,L,2012-13,44,4,6,10,0.23,0,55,7.27,14,41289.0,15:38,142,159,301,47.18,106,16,22,17,5,0,0,0,2366.0,0:53,0,0,0,4018.0,1:31,900000
8475790,Erik,Gudbranson,1992-01-07,D,R,2012-13,32,0,4,4,0.12,-22,49,0.0,47,35997.0,18:44,0,0,0,0.0,80,32,2,16,-14,0,1,1,1252.0,0:39,0,0,0,3130.0,1:37,900000
8475791,Taylor,Hall,1991-11-14,LW,L,2012-13,45,16,34,50,1.11,5,154,10.39,33,50275.0,18:37,29,24,53,54.72,24,20,31,29,2,4,10,14,8763.0,3:14,0,0,0,147.0,0:3,900000
8475792,Brett,Connolly,1992-05-02,RW,R,2012-13,5,1,0,1,0.2,-3,10,10.0,0,3082.0,10:16,4,1,5,80.0,2,1,4,0,4,1,0,1,551.0,1:50,0,0,0,0.0,0:0,900000
8475793,Ryan,Johansen,1992-07-31,C,R,2012-13,40,5,7,12,0.3,-7,84,5.95,12,38602.0,16:5,272,257,529,51.42,42,14,15,6,9,0,1,1,5568.0,2:19,0,0,0,233.0,0:5,870000
8475794,Tyler,Seguin,1992-01-31,C,R,2012-13,48,16,16,32,0.67,23,161,9.94,16,49004.0,17:0,22,23,45,48.89,25,6,18,30,-12,4,2,6,6324.0,2:11,0,0,0,22.0,0:0,900000
8475796,Mark,Pysyk,1992-01-11,D,R,2012-13,19,1,4,5,0.26,-7,21,4.76,0,18557.0,16:16,0,0,0,0.0,6,9,3,9,-6,1,0,1,934.0,0:49,0,0,0,420.0,0:22,900000
8475797,Jarred,Tinordi,1992-02-20,D,L,2012-13,8,0,2,2,0.25,5,5,0.0,2,5622.0,11:42,0,0,0,0.0,14,6,0,2,-2,0,0,0,0.0,0:0,0,0,0,434.0,0:54,870000
8475798,Mikael,Granlund,1992-02-26,RW,L,2012-13,27,2,6,8,0.3,-4,36,5.56,6,21349.0,13:10,97,109,206,47.09,15,8,8,10,-2,0,2,2,2804.0,1:43,0,0,0,11.0,0:0,900000
8475848,Brendan,Gallagher,1992-05-06,RW,R,2012-13,44,15,13,28,0.64,10,117,12.82,33,36598.0,13:51,8,17,25,32.0,44,33,17,8,9,3,1,4,6214.0,2:21,0,0,0,39.0,0:0,685000
8475913,Mark,Stone,1992-05-13,RW,R,2012-13,4,0,0,0,0.0,-1,3,0.0,2,2401.0,10:0,1,0,1,100.0,10,0,2,2,0,0,0,0,97.0,0:24,0,0,0,0.0,0:0,603333
8475917,Jason,Akeson,1990-06-03,RW,R,2012-13,1,1,0,1,1.0,2,2,50.0,0,743.0,12:23,0,0,0,0.0,0,0,2,0,2,0,0,0,0.0,0:0,0,0,0,0.0,0:0,715000
8475958,Michael,Sgarbossa,1992-07-25,C,L,2012-13,6,0,0,0,0.0,-3,6,0.0,4,3731.0,10:21,9,16,25,36.0,4,1,1,1,0,0,0,0,704.0,1:57,0,0,0,0.0,0:0,556667
8476043,Ben,Street,1987-02-13,C,L,2012-13,6,0,1,1,0.17,-1,13,0.0,0,4899.0,13:36,24,27,51,47.06,8,2,3,0,3,0,0,0,171.0,0:28,0,1,1,364.0,1:0,575000
8476116,Ryan,Garbutt,1985-08-12,C,L,2012-13,36,3,7,10,0.28,1,59,5.08,32,21431.0,9:55,7,10,17,41.18,67,9,11,3,8,0,0,0,368.0,0:10,0,0,0,1522.0,0:42,575000
8476158,Harry,Zolnierczyk,1987-09-01,LW,L,2012-13,7,0,1,1,0.14,0,4,0.0,36,3095.0,7:22,0,0,0,0.0,7,3,1,0,1,0,0,0,21.0,0:3,0,0,0,0.0,0:0,600000
8476162,Steve,Oleksy,1986-02-04,D,R,2012-13,28,1,8,9,0.32,9,25,4.0,33,29010.0,17:16,0,0,0,0.0,58,52,5,14,-9,0,0,0,200.0,0:7,0,0,0,2785.0,1:39,541667
8476177,Matt,Read,1986-06-14,RW,R,2012-13,42,11,13,24,0.57,1,72,15.28,2,45404.0,18:1,14,34,48,29.17,49,32,17,16,1,1,2,3,4656.0,1:50,0,0,0,5212.0,2:4,900000
8476195,Cory,Conacher,1989-12-14,C,L,2012-13,47,11,18,29,0.62,3,67,16.42,20,39406.0,13:58,4,11,15,26.67,39,9,10,20,-10,1,3,4,5719.0,2:1,0,0,0,123.0,0:2,871250
8476205,Stephane,Da Costa,1989-07-11,C,R,2012-13,9,1,1,2,0.22,-3,15,6.67,0,6404.0,11:51,39,25,64,60.94,8,1,1,4,-3,0,1,1,1208.0,2:14,0,0,0,0.0,0:0,800000
8476244,Raphael,Diaz,1986-01-09,D,R,2012-13,23,1,13,14,0.61,4,34,2.94,6,28367.0,20:33,0,0,0,0.0,11,44,6,17,-11,0,8,8,4683.0,3:23,0,0,0,3145.0,2:16,1225000
8476292,Ondrej,Palat,1991-03-28,LW,L,2012-13,14,2,2,4,0.29,5,16,12.5,0,9856.0,11:44,0,6,6,0.0,28,1,4,1,3,0,0,0,268.0,0:19,0,0,0,653.0,0:46,575000
8476302,Frank,Corrado,1993-03-26,D,R,2012-13,3,0,0,0,0.0,-1,4,0.0,0,3493.0,19:24,0,0,0,0.0,8,5,1,3,-2,0,0,0,228.0,1:16,0,0,0,165.0,0:55,591667
8476381,Andrew,Shaw,1991-07-20,RW,R,2012-13,48,9,6,15,0.31,6,64,14.06,38,43348.0,15:3,201,256,457,43.98,70,14,12,10,2,2,0,2,5877.0,2:2,0,0,0,235.0,0:4,573333
8476419,Jean-Gabriel,Pageau,1992-11-11,C,R,2012-13,9,2,2,4,0.44,3,14,14.29,0,6208.0,11:29,40,42,82,48.78,11,3,1,2,-1,0,0,0,47.0,0:5,0,0,0,447.0,0:49,613333
8476436,Dmitrij,Jaskin,1993-03-23,RW,L,2012-13,2,0,0,0,0.0,-1,2,0.0,0,899.0,7:29,0,0,0,0.0,2,0,1,0,1,0,0,0,0.0,0:0,0,0,0,0.0,0:0,772500
8476438,Brandon,Saad,1992-10-27,LW,L,2012-13,46,10,17,27,0.59,17,98,10.2,12,45433.0,16:27,17,29,46,36.96,41,12,26,15,11,0,3,3,4230.0,1:31,1,0,1,2375.0,0:51,764167
8476454,Ryan,Nugent-Hopkins,1993-04-12,C,L,2012-13,40,4,20,24,0.6,3,78,5.13,8,45277.0,18:51,226,325,551,41.02,27,27,22,11,11,2,9,11,7294.0,3:2,0,0,0,539.0,0:13,925000
8476455,Gabriel,Landeskog,1992-11-23,LW,L,2012-13,36,9,8,17,0.47,-4,109,8.26,22,41744.0,19:19,6,12,18,33.33,86,32,21,15,6,0,2,2,5334.0,2:28,3,0,3,4037.0,1:52,925000
8476456,Jonathan,Huberdeau,1993-06-04,LW,L,2012-13,48,14,17,31,0.65,-15,112,12.5,18,48751.0,16:55,11,22,33,33.33,33,19,17,28,-11,2,7,9,6809.0,2:21,0,0,0,84.0,0:1,894167
8476457,Adam,Larsson,1992-11-12,D,R,2012-13,37,0,6,6,0.16,4,30,0.0,12,40185.0,18:6,0,0,0,0.0,37,49,17,22,-5,0,0,0,341.0,0:9,0,0,0,2551.0,1:8,925000
8476459,Mika,Zibanejad,1993-04-18,C,R,2012-13,42,7,13,20,0.48,9,90,7.78,6,34187.0,13:33,159,184,343,46.36,82,19,12,7,5,3,1,4,4834.0,1:55,0,0,0,46.0,0:1,894167
8476460,Mark,Scheifele,1993-03-15,C,R,2012-13,4,0,0,0,0.0,0,6,0.0,0,2766.0,11:31,10,4,14,71.43,4,0,0,0,0,0,0,0,163.0,0:40,0,0,0,0.0,0:0,894167
8476461,Sean,Couturier,1992-12-07,C,L,2012-13,46,4,11,15,0.33,-8,75,5.33,10,43854.0,15:53,243,310,553,43.94,31,27,26,19,7,0,4,4,4127.0,1:29,0,0,0,6958.0,2:31,925000
8476462,Dougie,Hamilton,1993-06-17,D,R,2012-13,42,5,11,16,0.38,4,83,6.02,14,43163.0,17:7,0,0,0,0.0,59,33,8,27,-19,2,2,4,4841.0,1:55,0,0,0,705.0,0:16,925000
8476463,Jonas,Brodin,1993-07-12,D,L,2012-13,45,2,9,11,0.24,3,51,3.92,10,62675.0,23:12,0,0,0,0.0,17,60,18,15,3,1,1,2,3530.0,1:18,0,0,0,5433.0,2:0,925000
8476465,Ryan,Murphy,1993-03-31,D,R,2012-13,4,0,0,0,0.0,-4,7,0.0,2,5055.0,21:3,0,0,0,0.0,2,9,1,0,1,0,0,0,431.0,1:47,0,0,0,208.0,0:52,894167
8476466,Sven,Baertschi,1992-10-05,LW,L,2012-13,20,3,7,10,0.5,0,28,10.71,6,16087.0,13:24,1,0,1,100.0,12,5,12,5,7,0,0,0,1825.0,1:31,0,0,0,213.0,0:10,894167
8476467,Jamie,Oleksiak,1992-12-21,D,L,2012-13,16,0,2,2,0.12,-5,11,0.0,14,14240.0,14:50,0,0,0,0.0,32,18,2,8,-6,0,0,0,0.0,0:0,0,0,0,856.0,0:53,894167
8476468,J.T.,Miller,1993-03-14,C,L,2012-13,26,2,2,4,0.15,-7,43,4.65,8,21097.0,13:31,63,55,118,53.39,47,12,4,5,-1,1,1,2,2418.0,1:33,0,0,0,14.0,0:0,894167
8476470,Nathan,Beaulieu,1992-12-05,D,L,2012-13,6,0,2,2,0.33,5,8,0.0,0,5533.0,15:22,0,0,0,0.0,3,4,1,4,-3,0,0,0,824.0,2:17,0,0,0,0.0,0:0,925000
8476483,Rickard,Rakell,1993-05-05,C,R,2012-13,4,0,0,0,0.0,-2,3,0.0,0,2148.0,8:57,10,11,21,47.62,4,0,0,0,0,0,0,0,24.0,0:6,0,0,0,0.0,0:0,925000
8476807,Matt,Tennyson,1990-04-23,D,R,2012-13,4,0,2,2,0.5,2,8,0.0,2,3771.0,15:42,0,0,0,0.0,4,2,0,2,-2,0,0,0,10.0,0:2,0,0,0,25.0,0:6,925000
8476808,Brian,Flynn,1988-07-26,C,R,2012-13,26,6,5,11,0.42,6,49,12.24,0,22901.0,14:40,24,36,60,40.0,10,20,9,3,6,0,0,0,874.0,0:33,1,0,1,1565.0,1:0,925000
8476819,Jeremy,Welsh,1988-04-30,C,L,2012-13,5,0,1,1,0.2,1,4,0.0,0,1753.0,5:50,15,5,20,75.0,6,0,1,0,1,0,0,0,0.0,0:0,0,0,0,0.0,0:0,850000
8476851,Alex,Galchenyuk,1994-02-12,LW,L,2012-13,48,9,18,27,0.56,14,79,11.39,20,35484.0,12:19,59,79,138,42.75,23,25,9,8,1,0,1,1,3019.0,1:2,0,0,0,3.0,0:0,925000
8476855,Nail,Yakupov,1993-10-06,RW,L,2012-13,48,17,14,31,0.65,-4,81,20.99,24,41938.0,14:33,0,6,6,0.0,41,14,18,23,-5,6,4,10,7147.0,2:28,0,0,0,15.0,0:0,925000
8476870,Stefan,Matteau,1994-02-23,C,L,2012-13,17,1,2,3,0.18,-1,22,4.55,6,9371.0,9:11,0,4,4,0.0,25,1,5,4,1,0,0,0,17.0,0:1,0,0,0,0.0,0:0,842500
8476872,Scott,Laughton,1994-05-30,C,L,2012-13,5,0,0,0,0.0,0,10,0.0,0,3455.0,11:31,19,24,43,44.19,10,1,0,0,0,0,0,0,143.0,0:28,0,0,0,14.0,0:2,925000
8476887,Filip,Forsberg,1994-08-13,LW,R,2012-13,5,0,1,1,0.2,-5,14,0.0,0,4643.0,15:28,0,1,1,0.0,3,0,3,3,0,0,0,0,601.0,2:0,0,0,0,0.0,0:0,925000
8476888,Mikhail,Grigorenko,1994-05-16,C,L,2012-13,25,1,4,5,0.2,-1,31,3.23,0,15353.0,10:14,57,92,149,38.26,2,2,7,6,1,0,0,0,937.0,0:37,0,0,0,11.0,0:0,925000
8477205,Andrej,Sustr,1990-11-29,D,R,2012-13,2,0,0,0,0.0,1,2,0.0,0,1286.0,10:43,0,0,0,0.0,0,1,0,2,-2,0,0,0,37.0,0:18,0,0,0,0.0,0:0,925000
8477215,Danny,DeKeyser,1990-03-07,D,L,2012-13,11,0,1,1,0.09,4,15,0.0,2,11912.0,18:2,0,0,0,0.0,9,9,5,6,-1,0,0,0,389.0,0:35,0,0,0,1210.0,1:50,925000
8477243,Drew,LeBlanc,1989-06-29,C,L,2012-13,2,0,0,0,0.0,-3,3,0.0,0,1600.0,13:20,9,9,18,50.0,0,0,1,0,1,0,0,0,110.0,0:55,0,0,0,0.0,0:0,1486598
8477244,Chad,Ruhwedel,1990-05-07,D,R,2012-13,7,0,0,0,0.0,0,8,0.0,0,5963.0,14:11,0,0,0,0.0,7,8,2,0,2,0,0,0,2.0,0:0,0,0,0,69.0,0:9,925000
8448208,Jaromir,Jagr,1972-02-15,RW,L,2013-14,82,24,43,67,0.82,16,231,10.39,46,94259.0,19:9,0,2,2,0.0,4,9,36,59,-23,5,12,17,14260.0,2:53,0,0,0,246.0,0:3,2000000
8457981,Teemu,Selanne,1970-07-03,RW,R,2013-14,64,9,18,27,0.42,8,111,8.11,12,54245.0,14:7,46,60,106,43.4,15,8,16,31,-15,4,4,8,9223.0,2:24,0,0,0,68.0,0:1,2000000
8458537,Ray,Whitney,1972-05-08,LW,R,2013-14,69,9,23,32,0.46,-6,124,7.26,14,57808.0,13:57,1,1,2,50.0,14,16,25,43,-18,3,12,15,11904.0,2:52,0,0,0,16.0,0:0,4500000
8458951,Sergei,Gonchar,1974-04-13,D,L,2013-14,76,2,20,22,0.29,-12,89,2.25,20,80302.0,17:36,0,0,0,0.0,71,81,10,33,-23,1,13,14,11300.0,2:28,0,0,0,1105.0,0:14,5000000
8459444,Todd,Bertuzzi,1975-02-02,RW,L,2013-14,59,9,7,16,0.27,-17,100,9.0,40,51872.0,14:39,9,9,18,50.0,72,14,13,27,-14,6,1,7,10126.0,2:51,0,0,0,20.0,0:0,2075000
8459628,Hal,Gill,1975-04-06,D,L,2013-14,6,0,0,0,0.0,0,1,0.0,2,5343.0,14:50,0,0,0,0.0,7,6,1,1,0,0,0,0,0.0,0:0,0,0,0,518.0,1:26,700000
8459670,Kimmo,Timonen,1975-03-18,D,L,2013-14,77,6,29,35,0.45,5,152,3.95,32,93923.0,20:19,0,0,0,0.0,75,112,13,31,-18,1,19,20,15800.0,3:25,0,1,1,15716.0,3:24,6000000
8460492,Ed,Jovanovski,1976-06-26,D,L,2013-14,37,1,4,5,0.14,-6,44,2.27,39,35897.0,16:10,0,0,0,0.0,34,42,8,12,-4,0,1,1,3635.0,1:38,0,1,1,4303.0,1:56,4125000
8460496,Ryan,Smyth,1976-02-21,LW,L,2013-14,72,10,13,23,0.32,-18,129,7.75,44,66632.0,15:25,91,91,182,50.0,58,29,27,35,-8,5,2,7,11018.0,2:33,0,0,0,7317.0,1:41,2250000
8460542,Patrik,Elias,1976-04-13,C,L,2013-14,65,18,35,53,0.82,-4,116,15.52,30,69730.0,17:52,276,401,677,40.77,26,19,26,32,-6,4,13,17,9626.0,2:28,2,4,6,7246.0,1:51,5500000
8460621,Daniel,Alfredsson,1972-12-11,RW,R,2013-14,68,18,31,49,0.72,2,151,11.92,10,69064.0,16:55,5,9,14,35.71,59,25,24,36,-12,4,14,18,13125.0,3:13,0,0,0,705.0,0:10,3500000
8460626,Bryce,Salvador,1976-02-11,D,L,2013-14,40,1,3,4,0.1,-2,24,4.17,29,48705.0,20:17,0,0,0,0.0,47,50,12,21,-9,0,0,0,148.0,0:3,0,0,0,9527.0,3:58,3166667
8460720,Eric,Boulton,1976-08-17,LW,L,2013-14,23,2,2,4,0.17,0,21,9.52,88,8846.0,6:24,0,0,0,0.0,32,6,1,4,-3,0,0,0,57.0,0:2,0,0,0,51.0,0:2,550000
8462038,Shane,Doan,1976-10-10,RW,R,2013-14,69,23,24,47,0.68,-7,167,13.77,34,78416.0,18:56,6,6,12,50.0,135,22,48,20,28,10,9,19,11901.0,2:52,0,0,0,158.0,0:2,5300000
8462041,Radek,Dvorak,1977-03-09,RW,R,2013-14,60,4,5,9,0.15,3,52,7.69,41,38305.0,10:38,6,6,12,50.0,17,25,26,21,5,0,0,0,533.0,0:8,0,0,0,3438.0,0:57,600000
8462042,Jarome,Iginla,1977-07-01,RW,R,2013-14,78,30,31,61,0.78,34,209,14.35,47,85250.0,18:12,8,29,37,21.62,142,27,30,29,1,4,10,14,11711.0,2:30,0,0,0,1875.0,0:24,1800000
8462129,Michal,Handzus,1977-03-11,C,L,2013-14,59,4,12,16,0.27,0,50,8.0,16,48309.0,13:38,329,335,664,49.55,35,55,14,11,3,0,0,0,253.0,0:4,1,1,2,8899.0,2:30,1000000
8462196,Stephane,Robidas,1977-03-03,D,R,2013-14,38,5,5,10,0.26,10,56,8.93,20,45997.0,20:10,0,0,0,0.0,96,49,4,11,-7,1,0,1,1833.0,0:48,0,0,0,5229.0,2:17,3300000
8464956,Chris,Phillips,1978-03-09,D,L,2013-14,70,1,14,15,0.21,-12,90,1.11,30,80756.0,19:13,0,0,0,0.0,140,95,10,46,-36,1,7,8,5688.0,1:21,0,0,0,12976.0,3:5,3083333
8464966,Derek,Morris,1978-08-24,D,R,2013-14,63,5,12,17,0.27,-2,82,6.1,41,73516.0,19:26,0,0,0,0.0,99,104,21,23,-2,0,1,1,2069.0,0:32,0,0,0,6655.0,1:45,2750000
8464975,Daniel,Briere,1977-10-06,C,R,2013-14,69,13,12,25,0.36,1,118,11.02,30,52861.0,12:46,171,179,350,48.86,23,11,22,17,5,4,2,6,6872.0,1:39,0,0,0,66.0,0:0,6500000
8464977,Dainius,Zubrus,1978-06-16,C,L,2013-14,82,13,13,26,0.32,1,121,10.74,46,86370.0,17:33,216,208,424,50.94,107,39,19,20,-1,0,0,0,1897.0,0:23,0,0,0,10637.0,2:9,3100000
8464989,Matt,Cullen,1976-11-02,C,L,2013-14,77,10,29,39,0.51,4,134,7.46,32,71591.0,15:29,438,334,772,56.74,18,22,30,40,-10,1,8,9,10340.0,2:14,0,0,0,2108.0,0:27,3500000
8465009,Zdeno,Chara,1977-03-18,D,L,2013-14,77,17,23,40,0.52,25,168,10.12,66,113899.0,24:39,0,0,0,0.0,163,104,20,62,-42,10,5,15,11252.0,2:26,0,1,1,14684.0,3:10,6916667
8465058,Michal,Rozsival,1978-09-03,D,R,2013-14,42,1,7,8,0.19,7,39,2.56,32,41962.0,16:39,0,0,0,0.0,67,43,15,24,-9,0,0,0,1072.0,0:25,0,0,0,2002.0,0:47,2200000
8465166,Craig,Adams,1977-04-26,RW,R,2013-14,82,5,6,11,0.13,-16,73,6.85,46,61307.0,12:27,61,78,139,43.88,190,59,15,16,-1,0,0,0,76.0,0:0,0,0,0,14986.0,3:2,700000
8465185,Willie,Mitchell,1977-04-23,D,L,2013-14,76,1,11,12,0.16,14,73,1.37,58,92707.0,20:19,0,0,0,0.0,102,128,10,56,-46,0,2,2,2090.0,0:27,0,0,0,13433.0,2:56,3500000
8465202,Sami,Salo,1974-09-02,D,R,2013-14,71,4,13,17,0.24,11,81,4.94,18,77490.0,18:11,0,0,0,0.0,57,66,17,20,-3,0,6,6,8410.0,1:58,0,0,0,8729.0,2:2,3750000
8465914,Francis,Bouillon,1975-10-17,D,L,2013-14,52,2,4,6,0.12,-5,34,5.88,34,55183.0,17:41,0,0,0,0.0,80,70,7,27,-20,0,1,1,3942.0,1:15,0,0,0,1567.0,0:30,1500000
8465951,Matt,Cooke,1978-09-07,LW,L,2013-14,82,10,18,28,0.34,8,104,9.62,54,75796.0,15:24,10,16,26,38.46,190,61,34,25,9,0,2,2,307.0,0:3,1,1,2,12407.0,2:31,2500000
8465978,Shawn,Thornton,1977-07-23,LW,R,2013-14,64,5,3,8,0.12,3,93,5.38,74,33768.0,8:47,3,6,9,33.33,111,19,13,10,3,0,0,0,180.0,0:2,0,0,0,0.0,0:0,1100000
8466138,Joe,Thornton,1979-07-02,C,L,2013-14,82,11,65,76,0.93,20,122,9.02,32,93141.0,18:55,617,482,1099,56.14,54,34,76,96,-20,2,17,19,18096.0,3:40,0,1,1,1685.0,0:20,7000000
8466139,Patrick,Marleau,1979-09-15,C,L,2013-14,82,33,37,70,0.85,0,285,11.58,18,100968.0,20:31,163,145,308,52.92,85,29,50,65,-15,11,12,23,17778.0,3:36,2,0,2,8103.0,1:38,6900000
8466140,Olli,Jokinen,1978-12-05,C,L,2013-14,82,18,25,43,0.52,-8,171,10.53,62,83755.0,17:1,612,718,1330,46.02,120,45,20,30,-10,2,6,8,9001.0,1:49,0,0,0,2426.0,0:29,4500000
8466142,Eric,Brewer,1979-04-17,D,L,2013-14,77,4,13,17,0.22,10,83,4.82,59,81095.0,17:33,0,0,0,0.0,139,99,17,40,-23,0,0,0,206.0,0:2,0,2,2,10657.0,2:18,3875000
8466148,Marian,Hossa,1979-01-12,RW,L,2013-14,72,30,30,60,0.83,28,241,12.45,20,78937.0,18:16,1,2,3,33.33,43,26,75,26,49,4,9,13,9593.0,2:13,3,1,4,5755.0,1:19,5275000
8466149,Daniel,Cleary,1978-12-18,RW,L,2013-14,52,4,4,8,0.15,-11,64,6.25,31,43365.0,13:53,12,10,22,54.55,51,17,12,6,6,0,0,0,4691.0,1:30,0,1,1,4833.0,1:32,1750000
8466158,Scott,Hannan,1979-01-23,D,L,2013-14,56,3,9,12,0.21,1,52,5.77,55,59711.0,17:46,0,0,0,0.0,29,73,13,23,-10,0,0,0,496.0,0:8,0,1,1,6284.0,1:52,1000000
8466160,Brenden,Morrow,1979-01-16,LW,L,2013-14,71,13,12,25,0.35,1,56,23.21,76,50705.0,11:54,9,20,29,31.03,110,20,12,13,-1,4,3,7,4210.0,0:59,0,0,0,233.0,0:3,1500000
8466215,Joe,Corvo,1977-06-20,D,R,2013-14,25,3,7,10,0.4,-7,54,5.56,10,26283.0,17:31,0,0,0,0.0,15,24,5,12,-7,0,2,2,3093.0,2:3,0,0,0,73.0,0:2,900000
8466251,Jason,Chimera,1979-05-02,LW,L,2013-14,82,15,27,42,0.51,4,167,8.98,36,75865.0,15:25,38,49,87,43.68,140,30,25,30,-5,1,4,5,4152.0,0:50,0,1,1,8447.0,1:43,1750000
8466285,Brian,Campbell,1979-05-23,D,L,2013-14,82,7,30,37,0.45,-6,116,6.03,20,132632.0,26:57,0,1,1,0.0,50,108,43,45,-2,2,10,12,19183.0,3:53,0,2,2,9581.0,1:56,7142875
8466333,Andrew,Ference,1979-03-17,D,L,2013-14,71,3,15,18,0.25,-18,77,3.9,63,89718.0,21:3,2,1,3,66.67,135,108,13,55,-42,0,2,2,1616.0,0:22,0,0,0,12260.0,2:52,3250000
8466378,Martin,St. Louis,1975-06-18,RW,L,2013-14,81,30,39,69,0.85,13,204,14.71,10,101771.0,20:56,68,99,167,40.72,24,38,65,53,12,9,12,21,16118.0,3:18,1,1,2,5644.0,1:9,5625000
8466393,Pascal,Dupuis,1979-04-07,RW,L,2013-14,39,7,13,20,0.51,6,97,7.22,8,41412.0,17:41,2,4,6,33.33,68,29,12,11,1,0,0,0,681.0,0:17,0,0,0,4617.0,1:58,3750000
8467096,Dan,Boyle,1976-07-12,D,R,2013-14,75,12,24,36,0.48,-8,154,7.79,32,95772.0,21:16,0,0,0,0.0,46,92,26,59,-33,6,12,18,16379.0,3:38,0,0,0,1194.0,0:15,6666666
8467329,Vincent,Lecavalier,1980-04-21,C,L,2013-14,69,20,17,37,0.54,-16,132,15.15,44,62890.0,15:11,200,248,448,44.64,77,19,16,27,-11,8,5,13,10155.0,2:27,0,0,0,155.0,0:2,7727272
8467330,David,Legwand,1980-08-17,C,L,2013-14,83,14,37,51,0.61,-17,146,9.59,61,84547.0,16:58,585,571,1156,50.61,49,38,37,42,-5,6,13,19,14179.0,2:50,0,0,0,613.0,0:7,4500000
8467331,Brad,Stuart,1979-11-06,D,L,2013-14,61,3,8,11,0.18,4,64,4.69,35,70134.0,19:9,0,0,0,0.0,122,114,13,29,-16,0,0,0,377.0,0:6,0,0,0,7416.0,2:1,3600000
8467332,Bryan,Allen,1980-08-21,D,L,2013-14,68,0,10,10,0.15,20,60,0.0,75,71605.0,17:33,0,0,0,0.0,121,118,8,26,-18,0,0,0,280.0,0:4,0,1,1,9256.0,2:16,3500000
8467334,Manny,Malhotra,1980-05-18,C,L,2013-14,69,7,6,13,0.19,0,53,13.21,18,48004.0,11:35,566,386,952,59.45,82,56,24,21,3,0,0,0,305.0,0:4,0,1,1,6763.0,1:38,600000
8467336,Mike,Rupp,1980-01-13,LW,L,2013-14,13,0,1,1,0.08,1,6,0.0,23,4843.0,6:12,0,3,3,0.0,13,0,0,2,-2,0,0,0,0.0,0:0,0,0,0,0.0,0:0,1333333
8467338,Alex,Tanguay,1979-11-21,LW,L,2013-14,16,4,7,11,0.69,7,24,16.67,4,16586.0,17:16,1,2,3,33.33,8,8,9,10,-1,0,2,2,2715.0,2:49,1,0,1,764.0,0:47,3500000
8467344,Robyn,Regehr,1980-04-19,D,L,2013-14,79,3,11,14,0.18,6,73,4.11,46,89858.0,18:57,0,0,0,0.0,211,96,5,40,-35,0,0,0,360.0,0:4,0,0,0,13313.0,2:48,3000000
8467351,Scott,Gomez,1979-12-23,C,L,2013-14,46,2,10,12,0.26,-11,56,3.57,24,36244.0,13:7,239,276,515,46.41,16,16,20,15,5,0,2,2,3739.0,1:21,0,0,0,97.0,0:2,7357143
8467365,John,Erskine,1980-06-26,D,L,2013-14,37,1,3,4,0.11,-5,38,2.63,56,34626.0,15:35,0,0,0,0.0,64,66,4,12,-8,0,0,0,27.0,0:0,0,0,0,4606.0,2:4,1962500
8467370,Mike,Fisher,1980-06-05,C,R,2013-14,75,20,29,49,0.65,-4,177,11.3,60,88911.0,19:45,596,550,1146,52.01,144,73,34,38,-4,4,7,11,12264.0,2:43,0,0,0,6713.0,1:29,4200000
8467371,Mike,Ribeiro,1980-02-10,C,L,2013-14,80,16,31,47,0.59,-13,110,14.55,52,86371.0,17:59,391,512,903,43.3,72,18,24,46,-22,4,11,15,15835.0,3:17,0,0,0,739.0,0:9,5500000
8467389,Brad,Richards,1980-05-02,C,L,2013-14,82,20,31,51,0.62,-8,259,7.72,18,91923.0,18:41,512,517,1029,49.76,24,43,33,46,-13,5,14,19,18099.0,3:40,0,0,0,130.0,0:1,6666666
8467396,Erik,Cole,1978-11-06,LW,L,2013-14,75,16,13,29,0.39,-17,139,11.51,20,68224.0,15:9,19,22,41,46.34,89,21,31,34,-3,3,4,7,10974.0,2:26,0,0,0,368.0,0:4,4500000
8467400,Francois,Beauchemin,1980-06-04,D,L,2013-14,70,4,13,17,0.24,26,100,4.0,39,97017.0,23:5,0,0,0,0.0,112,171,17,51,-34,1,1,2,7002.0,1:40,0,1,1,13381.0,3:11,3500000
8467407,Brian,Gionta,1979-01-18,RW,R,2013-14,81,18,22,40,0.49,1,184,9.78,22,86731.0,17:50,23,37,60,38.33,46,52,38,21,17,2,5,7,6917.0,1:25,0,1,1,7802.0,1:36,5000000
8467423,Shawn,Horcoff,1978-09-17,C,L,2013-14,77,7,13,20,0.26,1,68,10.29,52,59406.0,12:51,209,208,417,50.12,63,29,34,17,17,4,0,4,5599.0,1:12,1,0,1,5406.0,1:10,5500000
8467428,Krys,Barch,1980-03-26,RW,L,2013-14,55,0,4,4,0.07,-10,19,0.0,99,19725.0,5:58,1,0,1,100.0,64,6,4,2,2,0,0,0,38.0,0:0,0,0,0,42.0,0:0,750000
8467452,Rob,Scuderi,1978-12-30,D,L,2013-14,53,0,4,4,0.08,-8,28,0.0,2,60170.0,18:55,0,0,0,0.0,18,90,7,21,-14,0,0,0,83.0,0:1,0,0,0,8374.0,2:38,3375000
8467463,Mikael,Samuelsson,1976-12-23,RW,R,2013-14,26,1,2,3,0.12,-4,36,2.78,6,16150.0,10:21,0,2,2,0.0,13,3,4,9,-5,0,2,2,3699.0,2:22,0,0,0,6.0,0:0,3000000
8467493,Chris,Neil,1979-06-18,RW,R,2013-14,76,8,6,14,0.18,-10,99,8.08,211,53821.0,11:48,1,2,3,33.33,253,18,16,13,3,0,1,1,2755.0,0:36,0,0,0,92.0,0:1,1900000
8467496,Andrei,Markov,1978-12-20,D,L,2013-14,81,7,36,43,0.53,12,131,5.34,34,122660.0,25:14,0,0,0,0.0,49,180,35,82,-47,2,19,21,21313.0,4:23,1,0,1,12157.0,2:30,5750000
8467514,Pavel,Datsyuk,1978-07-20,C,L,2013-14,45,17,20,37,0.82,1,126,13.49,6,54722.0,20:16,446,389,835,53.41,30,22,59,21,38,6,6,12,8502.0,3:8,0,0,0,1976.0,0:43,6700000
8467545,Michael,Ryder,1980-03-31,RW,R,2013-14,82,18,16,34,0.41,-6,166,10.84,18,77649.0,15:46,4,8,12,33.33,51,10,24,20,4,4,4,8,11570.0,2:21,1,0,1,165.0,0:2,3500000
8467831,Jeff,Halpern,1976-05-03,C,R,2013-14,69,5,7,12,0.17,-8,45,11.11,24,42585.0,10:17,296,266,562,52.67,65,33,13,4,9,0,0,0,172.0,0:2,0,0,0,8250.0,1:59,600000
8467875,Daniel,Sedin,1980-09-26,LW,L,2013-14,73,16,31,47,0.64,0,224,7.14,38,90252.0,20:36,8,19,27,29.63,37,21,32,27,5,5,13,18,15641.0,3:34,0,0,0,4102.0,0:56,6100000
8467876,Henrik,Sedin,1980-09-26,C,L,2013-14,70,11,39,50,0.71,3,97,11.34,42,86824.0,20:40,574,523,1097,52.32,43,19,22,36,-14,4,14,18,14536.0,3:27,0,0,0,4144.0,0:59,6100000
8467890,Barret,Jackman,1981-03-05,D,L,2013-14,79,3,12,15,0.19,11,83,3.61,97,84975.0,17:55,0,1,1,0.0,96,130,25,32,-7,0,0,0,115.0,0:1,0,0,0,10915.0,2:18,3166667
8467899,Martin,Havlat,1981-04-19,RW,L,2013-14,48,12,10,22,0.46,14,72,16.67,10,42405.0,14:43,0,4,4,0.0,9,14,15,34,-19,1,1,2,5136.0,1:47,0,0,0,436.0,0:9,4250000
8467917,Jordan,Leopold,1980-08-03,D,L,2013-14,27,1,5,6,0.22,1,40,2.5,6,25270.0,15:35,0,0,0,0.0,8,24,2,6,-4,0,2,2,1321.0,0:48,0,0,0,632.0,0:23,2250000
8467925,Adam,Hall,1980-08-14,RW,R,2013-14,80,4,5,9,0.11,-15,61,6.56,23,47225.0,9:50,314,213,527,59.58,77,46,18,6,12,0,0,0,161.0,0:2,2,0,2,14293.0,2:58,600000
8467931,Matt,Carkner,1980-11-03,D,R,2013-14,53,0,3,3,0.06,-10,50,0.0,149,38128.0,11:59,0,0,0,0.0,58,59,9,15,-6,0,0,0,49.0,0:0,0,0,0,1181.0,0:22,1500000
8467967,Chris,Kelly,1980-11-11,C,L,2013-14,57,9,9,18,0.32,2,69,13.04,32,50253.0,14:41,283,296,579,48.88,72,29,32,12,20,0,0,0,462.0,0:8,1,0,1,6340.0,1:51,3000000
8467977,Brian,McGrattan,1981-09-02,RW,R,2013-14,76,4,4,8,0.11,-4,79,5.06,100,30630.0,6:43,2,1,3,66.67,82,23,14,10,4,0,0,0,278.0,0:3,0,0,0,54.0,0:0,750000
8467988,Ryan,Malone,1979-12-01,LW,L,2013-14,57,5,10,15,0.26,-7,95,5.26,67,40287.0,11:46,2,5,7,28.57,75,26,11,23,-12,0,3,3,4043.0,1:10,0,0,0,426.0,0:7,4500000
8468001,Derek,MacKenzie,1981-06-11,C,L,2013-14,71,9,9,18,0.25,0,70,12.86,47,47994.0,11:15,256,241,497,51.51,241,32,24,16,8,0,0,0,405.0,0:5,2,1,3,7912.0,1:51,1000000
8468064,Martin,Erat,1981-08-29,RW,L,2013-14,70,3,26,29,0.41,5,53,5.66,28,61625.0,14:40,97,116,213,45.54,75,25,16,14,2,0,4,4,4933.0,1:10,0,0,0,4152.0,0:59,4500000
8468083,Henrik,Zetterberg,1980-10-09,C,L,2013-14,45,16,32,48,1.07,19,151,10.6,20,55493.0,20:33,259,230,489,52.97,23,15,28,26,2,3,14,17,9524.0,3:31,0,0,0,1470.0,0:32,6083333
8468085,Radim,Vrbata,1981-06-13,RW,R,2013-14,80,20,31,51,0.64,-6,263,7.6,22,86193.0,17:57,17,26,43,39.53,68,27,41,20,21,10,11,21,13442.0,2:48,0,0,0,1951.0,0:24,3000000
8468095,George,Parros,1979-12-29,RW,R,2013-14,22,0,1,1,0.05,-6,4,0.0,85,6006.0,4:33,0,0,0,0.0,14,5,0,2,-2,0,0,0,102.0,0:4,0,0,0,0.0,0:0,937500
8468101,Radek,Martinek,1976-08-31,D,R,2013-14,13,0,3,3,0.23,4,12,0.0,4,12071.0,15:28,0,0,0,0.0,9,9,5,8,-3,0,0,0,19.0,0:1,0,0,0,63.0,0:4,600000
8468114,Douglas,Murray,1980-03-12,D,L,2013-14,53,0,2,2,0.04,-12,26,0.0,42,45638.0,14:21,0,0,0,0.0,144,115,5,17,-12,0,0,0,25.0,0:0,0,0,0,9081.0,2:51,1500000
8468162,Jerred,Smithson,1979-02-04,C,R,2013-14,18,0,0,0,0.0,-5,2,0.0,9,9457.0,8:45,126,90,216,58.33,36,9,2,2,0,0,0,0,47.0,0:2,0,0,0,1908.0,1:46,550000
8468208,Joel,Ward,1980-12-02,RW,R,2013-14,82,24,25,49,0.6,7,133,18.05,32,79070.0,16:4,90,109,199,45.23,54,67,48,27,21,6,4,10,8617.0,1:45,2,0,2,8952.0,1:49,3000000
8468309,Mark,Streit,1977-12-11,D,L,2013-14,82,10,34,44,0.54,3,121,8.26,44,101564.0,20:38,0,0,0,0.0,41,108,16,41,-25,4,11,15,13269.0,2:41,0,0,0,1740.0,0:21,5250000
8468478,Mike,Weaver,1978-05-02,D,R,2013-14,72,1,12,13,0.18,0,53,1.89,31,79843.0,18:28,1,0,1,100.0,121,128,15,23,-8,0,0,0,461.0,0:6,0,0,0,12724.0,2:56,1100000
8468482,Dany,Heatley,1981-01-21,LW,L,2013-14,76,12,16,28,0.37,-18,110,10.91,18,67573.0,14:49,7,10,17,41.18,33,30,21,19,2,4,6,10,11591.0,2:32,0,0,0,37.0,0:0,7500000
8468483,Marian,Gaborik,1982-02-14,RW,L,2013-14,41,11,19,30,0.73,7,103,10.68,10,41840.0,17:0,0,2,2,0.0,15,10,11,15,-4,1,6,7,6987.0,2:50,0,0,0,117.0,0:2,7500000
8468484,Rostislav,Klesla,1982-03-21,D,L,2013-14,25,1,3,4,0.16,-3,22,4.55,24,23264.0,15:30,0,0,0,0.0,41,25,1,4,-3,0,0,0,67.0,0:2,0,0,0,3185.0,2:7,2975000
8468485,Raffi,Torres,1981-10-08,LW,L,2013-14,5,3,2,5,1.0,4,9,33.33,7,3108.0,10:21,2,2,4,50.0,9,2,1,1,0,0,0,0,369.0,1:13,0,0,0,0.0,0:0,2000000
8468486,Scott,Hartnell,1982-04-18,LW,L,2013-14,78,20,32,52,0.67,11,207,9.66,103,79003.0,16:52,4,14,18,22.22,155,39,19,35,-16,9,11,20,15472.0,3:18,0,0,0,345.0,0:4,4750000
8468493,Ron,Hainsey,1981-03-24,D,L,2013-14,82,4,11,15,0.18,-9,72,5.56,45,105480.0,21:26,0,0,0,0.0,96,124,36,40,-4,0,0,0,3086.0,0:37,0,1,1,10100.0,2:3,2000000
8468498,Brooks,Orpik,1980-09-26,D,L,2013-14,72,2,11,13,0.18,-3,50,4.0,46,91573.0,21:11,0,0,0,0.0,221,143,11,32,-21,0,0,0,500.0,0:6,0,0,0,12723.0,2:56,3750000
8468501,Anton,Volchenkov,1982-02-25,D,L,2013-14,56,0,8,8,0.14,3,42,0.0,20,56392.0,16:47,0,0,0,0.0,129,91,9,9,0,0,0,0,194.0,0:3,0,1,1,12538.0,3:43,4250000
8468504,Brad,Boyes,1982-04-17,RW,R,2013-14,78,21,15,36,0.46,-6,176,11.93,28,79766.0,17:2,37,32,69,53.62,46,35,38,29,9,2,1,3,11563.0,2:28,1,0,1,1430.0,0:18,1000000
8468505,Steve,Ott,1982-08-19,C,L,2013-14,82,9,14,23,0.28,-38,127,7.09,92,89690.0,18:13,494,423,917,53.87,246,35,15,28,-13,6,2,8,8800.0,1:47,0,0,0,10657.0,2:9,2950000
8468508,Justin,Williams,1981-10-04,RW,R,2013-14,82,19,24,43,0.52,14,239,7.95,48,83415.0,16:57,2,8,10,20.0,44,21,25,75,-50,4,3,7,11537.0,2:20,0,0,0,3092.0,0:37,3825000
8468509,Niklas,Kronwall,1981-01-12,D,L,2013-14,79,8,41,49,0.62,0,110,7.27,44,115243.0,24:18,0,0,0,0.0,93,154,25,50,-25,5,20,25,16000.0,3:22,0,1,1,14498.0,3:3,4750000
8468513,Nick,Schultz,1982-08-25,D,L,2013-14,69,0,5,5,0.07,-13,35,0.0,28,67531.0,16:18,0,0,0,0.0,73,132,2,36,-34,0,0,0,192.0,0:2,0,1,1,8962.0,2:9,3500000
8468518,Tomas,Kopecky,1982-02-05,RW,L,2013-14,49,4,8,12,0.24,0,95,4.21,18,46704.0,15:53,8,21,29,27.59,31,19,17,10,7,0,0,0,4134.0,1:24,1,0,1,5267.0,1:47,3000000
8468526,Jarret,Stoll,1982-06-24,C,R,2013-14,78,8,19,27,0.35,9,109,7.34,48,74240.0,15:51,678,561,1239,54.72,202,60,14,20,-6,1,3,4,6946.0,1:29,0,1,1,9899.0,2:6,3250000
8468535,Antoine,Vermette,1982-07-20,C,L,2013-14,82,24,21,45,0.55,0,160,15.0,44,94521.0,19:12,1005,778,1783,56.37,90,71,42,22,20,7,6,13,11981.0,2:26,3,0,3,10970.0,2:13,3750000
8468542,Paul,Martin,1981-03-05,D,L,2013-14,39,3,12,15,0.38,-4,54,5.56,10,57496.0,24:34,0,0,0,0.0,30,74,12,17,-5,1,8,9,7010.0,2:59,0,0,0,6546.0,2:47,5000000
8468575,Dominic,Moore,1980-08-03,C,L,2013-14,73,6,12,18,0.25,0,96,6.25,18,51317.0,11:42,354,294,648,54.63,62,24,18,11,7,0,0,0,406.0,0:5,1,2,3,7335.0,1:40,1000000
8468598,Lubomir,Visnovsky,1976-08-11,D,L,2013-14,24,3,8,11,0.46,-1,34,8.82,10,29564.0,20:31,0,0,0,0.0,14,26,15,18,-3,2,5,7,5699.0,3:57,0,0,0,425.0,0:17,4750000
8468611,Matt,Hendricks,1981-06-17,C,L,2013-14,77,5,2,7,0.09,-11,102,4.9,112,58850.0,12:44,34,29,63,53.97,180,59,19,14,5,0,0,0,672.0,0:8,1,0,1,11955.0,2:35,1850000
8468635,Travis,Moen,1982-04-06,LW,L,2013-14,65,2,10,12,0.18,2,56,3.57,49,44966.0,11:31,7,1,8,87.5,92,54,15,11,4,0,0,0,320.0,0:4,0,1,1,9961.0,2:33,1850000
8468639,John-Michael,Liles,1980-11-25,D,L,2013-14,41,2,7,9,0.22,5,56,3.57,8,48350.0,19:39,1,0,1,100.0,50,80,14,18,-4,1,3,4,5955.0,2:25,0,0,0,410.0,0:10,3875000
8468674,Deryk,Engelland,1982-04-03,D,R,2013-14,56,6,6,12,0.21,-6,59,10.17,58,43829.0,13:2,0,0,0,0.0,117,52,8,13,-5,0,1,1,488.0,0:8,0,0,0,3140.0,0:56,566667
8468700,Paul,Gaustad,1982-02-03,C,L,2013-14,75,10,11,21,0.28,-6,74,13.51,61,62130.0,13:48,696,504,1200,58.0,122,55,25,20,5,0,0,0,338.0,0:4,0,0,0,11174.0,2:28,3250000
8468778,Colton,Orr,1982-03-03,RW,R,2013-14,54,0,0,0,0.0,-3,12,0.0,110,17428.0,5:22,1,1,2,50.0,112,10,3,6,-3,0,0,0,94.0,0:1,0,0,0,42.0,0:0,925000
8469455,Jason,Spezza,1983-06-13,C,R,2013-14,75,23,43,66,0.88,-26,223,10.31,46,81947.0,18:12,775,661,1436,53.97,17,26,47,68,-21,9,13,22,13759.0,3:3,0,0,0,3530.0,0:47,7000000
8469457,Stephen,Weiss,1983-04-03,C,L,2013-14,26,2,2,4,0.15,-4,28,7.14,12,23025.0,14:45,184,173,357,51.54,4,10,13,10,3,0,0,0,2323.0,1:29,0,1,1,1138.0,0:43,4900000
8469459,Mikko,Koivu,1983-03-12,C,L,2013-14,65,11,43,54,0.83,0,147,7.48,24,81641.0,20:56,719,592,1311,54.84,33,32,49,27,22,2,16,18,13454.0,3:26,0,2,2,5428.0,1:23,6750000
8469460,Mike,Komisarek,1982-01-19,D,R,2013-14,32,0,4,4,0.12,-4,20,0.0,14,22462.0,11:41,0,0,0,0.0,70,27,3,16,-13,0,0,0,315.0,0:9,0,0,0,1249.0,0:39,4300000
8469462,Tuomo,Ruutu,1983-02-16,LW,L,2013-14,76,8,16,24,0.32,-18,105,7.62,44,66420.0,14:33,14,23,37,37.84,216,34,32,34,-2,3,0,3,7377.0,1:37,0,0,0,756.0,0:9,4750000
8469465,Dan,Hamhuis,1982-12-13,D,L,2013-14,79,5,17,22,0.28,13,150,3.33,26,113556.0,23:57,0,0,0,0.0,87,130,48,69,-21,0,3,3,8748.0,1:50,0,0,0,14758.0,3:6,4500000
8469466,Ales,Hemsky,1983-08-13,RW,R,2013-14,75,13,30,43,0.57,-15,138,9.42,24,71813.0,15:57,1,3,4,25.0,37,33,44,42,2,2,11,13,10628.0,2:21,0,0,0,777.0,0:10,5000000
8469467,Chuck,Kobasew,1982-04-17,RW,R,2013-14,33,2,0,2,0.06,1,37,5.41,15,22197.0,11:12,1,1,2,50.0,49,18,10,9,1,0,0,0,1404.0,0:42,0,0,0,965.0,0:29,550000
8469469,R.J.,Umberger,1982-05-03,C,L,2013-14,74,18,16,34,0.46,-3,136,13.24,26,71818.0,16:10,25,15,40,62.5,113,36,31,26,5,8,4,12,9112.0,2:3,1,1,2,4955.0,1:6,4600000
8469470,Carlo,Colaiacovo,1983-01-27,D,L,2013-14,25,1,3,4,0.16,-4,18,5.56,18,22729.0,15:9,0,0,0,0.0,29,26,1,5,-4,0,1,1,1882.0,1:15,0,0,0,24.0,0:0,2500000
8469473,Marcel,Goc,1983-08-24,C,L,2013-14,74,11,14,25,0.34,-7,117,9.4,35,72491.0,16:19,658,575,1233,53.37,119,43,21,21,0,0,2,2,3607.0,0:48,0,0,0,10061.0,2:15,1700000
8469476,Tim,Gleason,1983-01-29,D,L,2013-14,56,1,5,6,0.11,-21,43,2.33,65,55882.0,16:37,0,0,0,0.0,156,88,9,26,-17,0,0,0,97.0,0:1,0,0,0,6197.0,1:50,4000000
8469485,Derek,Roy,1983-05-04,C,L,2013-14,75,9,28,37,0.49,-1,114,7.89,30,61291.0,13:37,219,247,466,47.0,13,30,22,20,2,4,12,16,10295.0,2:17,0,0,0,701.0,0:9,4000000
8469490,Tim,Jackman,1981-11-14,RW,R,2013-14,36,4,1,5,0.14,-3,46,8.7,103,15340.0,7:6,2,1,3,66.67,69,4,4,4,0,0,0,0,137.0,0:3,0,0,0,45.0,0:1,612500
8469492,Fedor,Tyutin,1983-07-19,D,L,2013-14,69,4,22,26,0.38,6,87,4.6,44,88641.0,21:24,0,0,0,0.0,91,89,16,24,-8,1,8,9,6645.0,1:36,0,2,2,11446.0,2:45,4500000
8469500,Michael,Cammalleri,1982-06-08,LW,L,2013-14,63,26,19,45,0.71,-13,191,13.61,26,75014.0,19:50,88,103,191,46.07,26,29,30,42,-12,6,8,14,11475.0,3:2,0,0,0,1466.0,0:23,6000000
8469501,Chris,Thorburn,1983-06-03,RW,R,2013-14,55,2,9,11,0.2,0,26,7.69,65,29542.0,8:57,20,13,33,60.61,108,34,4,8,-4,0,0,0,174.0,0:3,0,0,0,240.0,0:4,866667
8469506,Jason,Pominville,1982-11-30,RW,R,2013-14,82,30,30,60,0.73,3,226,13.27,16,91463.0,18:35,87,72,159,54.72,23,31,37,24,13,7,10,17,17038.0,3:27,0,0,0,383.0,0:4,5300000
8469508,Jay,McClement,1983-03-02,C,L,2013-14,81,4,6,10,0.12,-8,67,5.97,32,71742.0,14:45,676,584,1260,53.65,141,57,36,24,12,0,0,0,139.0,0:1,0,1,1,16642.0,3:25,1500000
8469521,Tomas,Plekanec,1982-10-31,C,L,2013-14,81,20,23,43,0.53,11,199,10.05,38,96107.0,19:46,822,891,1713,47.99,44,45,38,37,1,3,7,10,9425.0,1:56,3,0,3,14339.0,2:57,5000000
8469531,Jay,Harrison,1982-11-03,D,L,2013-14,68,4,11,15,0.22,-1,103,3.88,44,67836.0,16:37,0,0,0,0.0,141,82,8,23,-15,1,5,6,4119.0,1:0,0,0,0,2904.0,0:42,1500000
8469542,Stephane,Veilleux,1981-11-16,LW,L,2013-14,34,3,0,3,0.09,-2,26,11.54,21,17211.0,8:26,1,1,2,50.0,41,20,9,2,7,0,0,0,0.0,0:0,0,0,0,2492.0,1:13,587500
8469544,Patrick,Sharp,1981-12-27,LW,R,2013-14,82,34,44,78,0.95,13,313,10.86,40,92922.0,18:53,83,69,152,54.61,55,27,41,25,16,10,15,25,15995.0,3:15,0,0,0,211.0,0:2,5900000
8469547,Jordin,Tootoo,1983-02-02,RW,R,2013-14,11,0,1,1,0.09,-3,11,0.0,5,4610.0,6:59,0,0,0,0.0,27,1,0,0,0,0,0,0,0.0,0:0,0,0,0,0.0,0:0,1900000
8469555,Christian,Ehrhoff,1982-07-06,D,L,2013-14,79,6,27,33,0.42,-27,161,3.73,38,113343.0,23:54,0,0,0,0.0,49,119,36,61,-25,1,11,12,16363.0,3:27,1,2,3,12289.0,2:35,4000000
8469591,Cody,McCormick,1983-04-18,C,R,2013-14,43,2,5,7,0.16,-6,26,7.69,52,22988.0,8:54,89,109,198,44.95,76,21,7,4,3,0,0,0,63.0,0:1,0,0,0,3409.0,1:19,1200000
8469598,Kevin,Bieksa,1981-06-16,D,R,2013-14,76,4,20,24,0.32,-8,167,2.4,104,103850.0,22:46,1,0,1,100.0,144,130,32,55,-23,1,7,8,8916.0,1:57,0,0,0,10037.0,2:12,4600000
8469619,Dennis,Seidenberg,1981-07-18,D,L,2013-14,34,1,9,10,0.29,11,53,1.89,10,44549.0,21:50,0,0,0,0.0,61,66,7,16,-9,0,0,0,921.0,0:27,0,0,0,4900.0,2:24,3250000
8469622,Ryane,Clowe,1982-09-30,LW,L,2013-14,43,7,19,26,0.6,-10,74,9.46,33,41614.0,16:7,1,2,3,33.33,82,19,8,21,-13,3,5,8,5672.0,2:11,0,0,0,25.0,0:0,4850000
8469623,Marek,Zidlicky,1977-02-03,D,R,2013-14,81,12,30,42,0.52,-3,128,9.38,60,105218.0,21:38,0,0,0,0.0,124,81,19,58,-39,8,10,18,13925.0,2:51,0,2,2,1462.0,0:18,3000000
8469626,Andrew,Alberts,1981-06-30,D,L,2013-14,10,0,0,0,0.0,1,5,0.0,0,4431.0,7:23,0,0,0,0.0,6,7,0,4,-4,0,0,0,8.0,0:0,0,0,0,216.0,0:21,600000
8469638,Jussi,Jokinen,1983-04-01,LW,L,2013-14,81,21,36,57,0.7,12,172,12.21,18,76306.0,15:42,160,139,299,53.51,34,31,22,47,-25,6,15,21,11088.0,2:16,0,0,0,172.0,0:2,3000000
8469639,Brooks,Laich,1983-06-23,C,L,2013-14,51,8,7,15,0.29,-7,75,10.67,16,52790.0,17:15,203,257,460,44.13,62,35,20,15,5,1,2,3,4109.0,1:20,1,1,2,8777.0,2:52,4500000
8469664,David,Moss,1981-12-28,RW,R,2013-14,79,8,14,22,0.28,-1,151,5.3,18,69453.0,14:39,21,30,51,41.18,120,49,32,16,16,0,2,2,2176.0,0:27,0,0,0,10227.0,2:9,2100000
8469665,Johnny,Oduya,1981-10-01,D,L,2013-14,77,3,13,16,0.21,11,83,3.61,38,92897.0,20:6,1,0,1,100.0,49,114,15,52,-37,0,0,0,832.0,0:10,0,1,1,9796.0,2:7,3375000
8469707,PA,Parenteau,1983-03-24,RW,R,2013-14,55,14,19,33,0.6,3,110,12.73,30,55936.0,16:57,2,12,14,14.29,35,16,21,21,0,1,2,3,8429.0,2:33,0,0,0,107.0,0:1,4000000
8469759,Vernon,Fiddler,1980-05-09,C,L,2013-14,76,6,17,23,0.3,3,109,5.5,37,60576.0,13:17,513,469,982,52.24,45,52,21,24,-3,0,1,1,1066.0,0:14,0,2,2,9122.0,2:0,1800000
8469760,Zbynek,Michalek,1982-12-23,D,R,2013-14,59,2,8,10,0.17,6,78,2.56,24,74262.0,20:58,0,0,0,0.0,55,165,27,23,4,0,0,0,185.0,0:3,0,0,0,10337.0,2:55,4000000
8469770,Dennis,Wideman,1983-03-20,D,R,2013-14,46,4,17,21,0.46,-15,102,3.92,18,62634.0,22:41,0,0,0,0.0,62,75,13,39,-26,2,2,4,8634.0,3:7,0,1,1,3634.0,1:19,5250000
8470018,Matt,Ellis,1981-08-31,LW,L,2013-14,50,4,2,6,0.12,-6,70,5.71,4,28414.0,9:28,69,97,166,41.57,37,24,17,3,14,0,0,0,226.0,0:4,0,0,0,4115.0,1:22,550000
8470039,Tomas,Fleischmann,1984-05-16,LW,L,2013-14,80,8,20,28,0.35,-18,188,4.26,22,82179.0,17:7,5,13,18,27.78,59,11,30,26,4,2,5,7,12437.0,2:35,0,1,1,5095.0,1:3,4500000
8470041,Rick,Nash,1984-06-16,LW,L,2013-14,65,26,13,39,0.6,10,258,10.08,36,66369.0,17:1,2,0,2,100.0,11,29,51,49,2,4,3,7,9709.0,2:29,2,2,4,1949.0,0:29,7800000
8470047,Valtteri,Filppula,1984-03-20,C,L,2013-14,75,25,33,58,0.77,5,131,19.08,20,89910.0,19:58,693,633,1326,52.26,33,33,53,28,25,6,14,20,15144.0,3:21,0,0,0,4844.0,1:4,5000000
8470054,Keith,Ballard,1982-11-26,D,L,2013-14,45,2,7,9,0.2,-7,29,6.9,37,36747.0,13:36,0,0,0,0.0,58,37,7,18,-11,0,2,2,1861.0,0:41,0,0,0,1627.0,0:36,1500000
8470063,Adam,Burish,1983-01-06,RW,R,2013-14,15,0,0,0,0.0,-4,9,0.0,6,8658.0,9:37,39,36,75,52.0,23,9,2,1,1,0,0,0,123.0,0:8,0,0,0,1012.0,1:7,1850000
8470065,Ryan,Craig,1982-01-06,C,L,2013-14,6,0,0,0,0.0,-3,4,0.0,0,2528.0,7:1,0,0,0,0.0,8,1,0,0,0,0,0,0,0.0,0:0,0,0,0,0.0,0:0,600000
8470085,Paul,Ranger,1984-09-12,D,L,2013-14,53,6,8,14,0.26,-1,59,10.17,36,55407.0,17:25,0,0,0,0.0,115,72,39,53,-14,0,0,0,853.0,0:16,1,0,1,6063.0,1:54,1000000
8470104,Tom,Gilbert,1983-01-10,D,R,2013-14,73,3,25,28,0.38,-5,93,3.23,18,93474.0,21:20,0,0,0,0.0,59,95,16,32,-16,2,4,6,9722.0,2:13,0,0,0,3816.0,0:52,4000000
8470105,Scottie,Upshall,1983-10-07,RW,L,2013-14,76,15,22,37,0.49,1,161,9.32,73,72604.0,15:55,32,39,71,45.07,134,25,35,15,20,1,5,6,7194.0,1:34,1,0,1,5619.0,1:13,3500000
8470110,Trevor,Daley,1983-10-09,D,L,2013-14,67,9,16,25,0.37,10,107,8.41,38,85005.0,21:8,0,0,0,0.0,42,98,15,21,-6,1,3,4,4750.0,1:10,0,0,0,9672.0,2:24,3300000
8470120,Alexander,Semin,1984-03-03,RW,R,2013-14,65,22,20,42,0.65,1,210,10.48,42,77648.0,19:54,1,9,10,10.0,22,30,49,56,-7,6,6,12,13270.0,3:24,1,0,1,2112.0,0:32,7000000
8470121,Matt,Greene,1983-05-13,D,R,2013-14,38,2,4,6,0.16,6,38,5.26,47,36225.0,15:53,0,1,1,0.0,118,59,1,36,-35,0,0,0,655.0,0:17,0,0,0,6131.0,2:41,2950000
8470123,Cam,Janssen,1984-04-15,RW,R,2013-14,24,3,0,3,0.12,3,11,27.27,22,7071.0,4:54,0,0,0,0.0,32,3,0,1,-1,0,0,0,0.0,0:0,0,0,0,0.0,0:0,550000
8470144,Frans,Nielsen,1984-04-24,C,L,2013-14,80,25,33,58,0.72,-11,167,14.97,8,88020.0,18:20,534,550,1084,49.26,39,47,50,35,15,5,15,20,16465.0,3:25,2,1,3,10365.0,2:9,2750000
8470151,Jay,Bouwmeester,1983-09-27,D,L,2013-14,82,4,33,37,0.45,26,152,2.63,20,118319.0,24:2,3,1,4,75.0,51,106,18,22,-4,1,10,11,10350.0,2:6,0,0,0,16071.0,3:15,6680000
8470153,Pierre-Marc,Bouchard,1984-04-27,C,L,2013-14,28,4,5,9,0.32,-9,51,7.84,12,23432.0,13:56,3,2,5,60.0,7,6,10,15,-5,1,0,1,2610.0,1:33,0,0,0,4.0,0:0,2000000
8470156,Joey,Crabb,1983-04-03,RW,R,2013-14,9,0,1,1,0.11,-2,5,0.0,7,7765.0,14:22,10,10,20,50.0,23,5,1,1,0,0,0,0,114.0,0:12,0,0,0,1004.0,1:51,600000
8470159,Boyd,Gordon,1983-10-19,C,R,2013-14,74,8,13,21,0.28,-15,80,10.0,20,65511.0,14:45,843,649,1492,56.5,27,89,21,19,2,1,3,4,2275.0,0:30,1,1,2,12360.0,2:47,3000000
8470162,Matt,Stajan,1983-12-19,C,L,2013-14,63,14,19,33,0.52,-13,70,20.0,42,69455.0,18:22,527,569,1096,48.08,74,36,49,40,9,0,1,1,1417.0,0:22,1,2,3,7677.0,2:1,3500000
8470169,Gregory,Campbell,1983-12-17,C,L,2013-14,82,8,13,21,0.26,1,84,9.52,47,58566.0,11:54,358,391,749,47.8,134,46,26,10,16,0,1,1,742.0,0:9,1,1,2,9143.0,1:51,1600000
8470171,Max,Talbot,1984-02-11,C,L,2013-14,81,8,19,27,0.33,5,124,6.45,45,78532.0,16:9,100,125,225,44.44,116,46,37,20,17,0,1,1,690.0,0:8,1,0,1,13303.0,2:44,1800000
8470176,Sean,Bergenheim,1984-02-08,LW,L,2013-14,62,16,13,29,0.47,-16,190,8.42,40,61401.0,16:30,2,2,4,50.0,111,18,27,16,11,3,1,4,8665.0,2:19,0,0,0,1364.0,0:22,2750000
8470180,Eric,Nystrom,1983-02-14,LW,L,2013-14,79,15,6,21,0.27,-25,120,12.5,60,70429.0,14:51,2,8,10,20.0,154,35,26,16,10,0,0,0,352.0,0:4,1,0,1,8720.0,1:50,2500000
8470187,Johnny,Boychuk,1984-01-19,D,R,2013-14,75,5,18,23,0.31,31,142,3.52,45,95365.0,21:11,0,0,0,0.0,158,151,16,31,-15,0,0,0,1395.0,0:18,0,3,3,13086.0,2:54,3366667
8470189,David,Van Der Gulik,1983-04-20,LW,L,2013-14,2,0,0,0,0.0,0,3,0.0,0,681.0,5:40,1,1,2,50.0,1,2,0,0,0,0,0,0,0.0,0:0,0,0,0,0.0,0:0,600000
8470201,Jiri,Hudler,1984-01-04,RW,L,2013-14,75,17,37,54,0.72,4,109,15.6,16,84802.0,18:50,4,18,22,18.18,35,15,29,39,-10,2,11,13,14007.0,3:6,0,0,0,300.0,0:4,4000000
8470207,Joffrey,Lupul,1983-09-23,LW,R,2013-14,69,22,22,44,0.64,-15,191,11.52,44,76395.0,18:27,24,31,55,43.64,118,35,25,47,-22,6,6,12,10089.0,2:26,0,0,0,109.0,0:1,5250000
8470222,James,Wisniewski,1984-02-21,D,R,2013-14,75,7,44,51,0.68,0,166,4.22,61,101798.0,22:37,0,0,0,0.0,101,73,18,38,-20,3,25,28,16426.0,3:39,0,0,0,8987.0,1:59,5500000
8470230,Daniel,Paille,1984-04-15,LW,L,2013-14,72,9,9,18,0.25,9,71,12.68,6,47361.0,10:57,11,6,17,64.71,70,30,32,13,19,0,0,0,203.0,0:2,1,0,1,6383.0,1:28,1300000
8470257,Alexander,Steen,1984-03-01,LW,L,2013-14,68,33,29,62,0.91,17,211,15.64,46,82748.0,20:16,265,276,541,48.98,43,28,42,12,30,7,10,17,13578.0,3:19,1,2,3,7762.0,1:54,3362500
8470268,Denis,Grebeshkov,1983-10-11,D,L,2013-14,7,0,1,1,0.14,0,3,0.0,2,5750.0,13:41,0,0,0,0.0,3,9,1,1,0,0,0,0,317.0,0:45,0,0,0,20.0,0:2,1500000
8470274,Chris,Higgins,1983-06-02,LW,L,2013-14,78,17,22,39,0.5,-14,216,7.87,30,89738.0,19:10,17,21,38,44.74,98,45,31,23,8,2,1,3,7702.0,1:38,0,1,1,9815.0,2:5,2500000
8470280,Ben,Eager,1984-01-22,LW,L,2013-14,7,0,1,1,0.14,1,4,0.0,2,3033.0,7:13,1,1,2,50.0,9,2,2,2,0,0,0,0,15.0,0:2,0,0,0,0.0,0:0,1100000
8470281,Duncan,Keith,1983-07-16,D,L,2013-14,79,6,55,61,0.77,22,198,3.03,28,116840.0,24:38,0,0,0,0.0,36,89,48,70,-22,3,18,21,15063.0,3:10,0,1,1,11297.0,2:23,5538462
8470289,Jim,Slater,1982-12-09,C,L,2013-14,27,1,1,2,0.07,-5,24,4.17,8,17222.0,10:37,163,118,281,58.01,41,7,7,7,0,0,0,0,133.0,0:4,0,0,0,3028.0,1:52,1600000
8470302,Patrick,Dwyer,1983-06-22,RW,R,2013-14,75,8,14,22,0.29,-2,134,5.97,14,65928.0,14:39,9,15,24,37.5,107,48,44,26,18,0,0,0,348.0,0:4,2,0,2,8183.0,1:49,900000
8470309,Ryan,Whitney,1983-02-19,D,L,2013-14,7,0,0,0,0.0,-7,8,0.0,6,7034.0,16:44,0,0,0,0.0,4,10,0,2,-2,0,0,0,820.0,1:57,0,0,0,131.0,0:18,900000
8470310,Aaron,Rome,1983-09-27,D,L,2013-14,25,0,1,1,0.04,-6,15,0.0,11,19632.0,13:5,0,0,0,0.0,20,38,2,12,-10,0,0,0,76.0,0:3,0,0,0,1484.0,0:59,1500000
8470317,Nate,Guenin,1982-12-10,D,R,2013-14,68,1,8,9,0.13,3,52,1.92,46,70496.0,17:16,0,0,0,0.0,119,128,12,24,-12,0,0,0,223.0,0:3,0,0,0,11460.0,2:48,600000
8470318,Jonathan,Ericsson,1984-03-02,D,L,2013-14,48,1,10,11,0.23,2,66,1.52,34,61190.0,21:14,0,0,0,0.0,91,46,14,35,-21,0,0,0,1342.0,0:27,0,1,1,8588.0,2:58,3250000
8470324,Josh,Gorges,1984-08-14,D,L,2013-14,66,1,13,14,0.21,6,35,2.86,12,84119.0,21:14,0,1,1,0.0,97,177,11,29,-18,0,1,1,1401.0,0:21,0,1,1,13289.0,3:21,3900000
8470358,Alexandre,Burrows,1981-04-11,RW,L,2013-14,49,5,10,15,0.31,-9,104,4.81,71,52385.0,17:49,23,32,55,41.82,84,33,24,13,11,2,4,6,6858.0,2:19,0,1,1,5477.0,1:51,4500000
8470378,Andre,Benoit,1984-01-06,D,L,2013-14,79,7,21,28,0.35,2,113,6.19,26,95805.0,20:12,0,0,0,0.0,58,119,20,32,-12,1,7,8,11598.0,2:26,0,1,1,8205.0,1:43,900000
8470543,Chris,Kunitz,1979-09-26,LW,L,2013-14,78,35,33,68,0.87,25,218,16.06,66,89656.0,19:9,3,1,4,75.0,157,25,24,45,-21,13,9,22,16992.0,3:37,0,0,0,837.0,0:10,3725000
8470595,Eric,Staal,1984-10-29,C,L,2013-14,79,21,40,61,0.77,-13,230,9.13,74,96162.0,20:17,754,676,1430,52.73,67,28,77,61,16,1,11,12,15836.0,3:20,2,2,4,4163.0,0:52,8250000
8470596,Nathan,Horton,1985-05-29,RW,R,2013-14,35,4,14,18,0.51,-3,48,8.33,24,33389.0,15:53,1,0,1,100.0,53,14,12,11,1,2,2,4,4684.0,2:13,0,0,0,124.0,0:3,5300000
8470598,Thomas,Vanek,1984-01-19,LW,R,2013-14,78,27,41,68,0.87,7,248,10.89,46,90563.0,19:21,20,26,46,43.48,30,17,31,50,-19,8,10,18,18534.0,3:57,0,0,0,153.0,0:1,7142857
8470599,Milan,Michalek,1984-12-07,LW,L,2013-14,82,17,22,39,0.48,-25,169,10.06,41,86531.0,17:35,6,8,14,42.86,86,31,32,14,18,4,4,8,10603.0,2:9,0,0,0,8864.0,1:48,4333333
8470600,Ryan,Suter,1985-01-21,D,L,2013-14,82,8,35,43,0.52,15,150,5.33,34,144714.0,29:24,1,0,1,100.0,72,132,30,41,-11,3,14,17,18556.0,3:46,0,1,1,11619.0,2:21,7538462
8470601,Braydon,Coburn,1985-02-27,D,L,2013-14,82,5,12,17,0.21,-6,122,4.1,63,110423.0,22:26,0,0,0,0.0,109,115,26,44,-18,0,0,0,1118.0,0:13,1,0,1,19641.0,3:59,4500000
8470602,Dion,Phaneuf,1985-04-10,D,L,2013-14,80,8,23,31,0.39,2,145,5.52,144,113109.0,23:33,0,1,1,0.0,227,156,32,60,-28,2,9,11,15764.0,3:17,0,1,1,13582.0,2:49,6500000
8470604,Jeff,Carter,1985-01-01,C,R,2013-14,72,27,23,50,0.69,8,256,10.55,44,81871.0,18:57,336,308,644,52.17,68,29,32,59,-27,8,6,14,14127.0,3:16,1,0,1,6526.0,1:30,5272727
8470606,Dustin,Brown,1984-11-04,RW,R,2013-14,79,15,12,27,0.34,7,195,7.69,66,75063.0,15:50,6,13,19,31.58,246,12,26,41,-15,1,3,4,10096.0,2:7,0,0,0,2324.0,0:29,3175000
8470607,Brent,Seabrook,1985-04-20,D,R,2013-14,82,7,34,41,0.5,23,149,4.7,22,109540.0,22:15,0,0,0,0.0,171,142,35,68,-33,3,6,9,9740.0,1:58,1,0,1,9786.0,1:59,5800000
8470609,Steve,Bernier,1985-03-31,RW,R,2013-14,78,3,9,12,0.15,-15,104,2.88,33,58253.0,12:26,6,12,18,33.33,118,23,22,13,9,0,1,1,4408.0,0:56,0,0,0,58.0,0:0,775000
8470610,Zach,Parise,1984-07-28,LW,L,2013-14,67,29,27,56,0.84,10,245,11.84,30,82113.0,20:25,10,14,24,41.67,70,45,46,18,28,14,6,20,13412.0,3:20,1,0,1,4163.0,1:2,7538462
8470611,Eric,Fehr,1985-09-07,C,R,2013-14,73,13,18,31,0.42,0,137,9.49,32,64601.0,14:44,196,230,426,46.01,81,33,50,17,33,0,1,1,2637.0,0:36,0,1,1,4397.0,1:0,1500000
8470612,Ryan,Getzlaf,1985-05-10,C,R,2013-14,77,31,56,87,1.13,28,204,15.2,31,98338.0,21:17,692,719,1411,49.04,110,87,53,76,-23,5,18,23,16986.0,3:40,0,0,0,9834.0,2:7,8250000
8470613,Brent,Burns,1985-03-09,D,R,2013-14,69,22,26,48,0.7,26,245,8.98,34,69608.0,16:48,61,70,131,46.56,145,24,45,37,8,2,9,11,9171.0,2:12,0,0,0,230.0,0:3,5760000
8470614,Mark,Stuart,1984-04-27,D,L,2013-14,69,2,11,13,0.19,11,73,2.74,101,77149.0,18:38,0,0,0,0.0,229,160,6,32,-26,0,0,0,77.0,0:1,0,0,0,12713.0,3:4,1700000
8470616,Ryan,Kesler,1984-08-31,C,R,2013-14,77,25,18,43,0.56,-15,239,10.46,81,100787.0,21:48,740,666,1406,52.63,133,68,47,28,19,9,7,16,16127.0,3:29,1,0,1,10198.0,2:12,5000000
8470617,Mike,Richards,1985-02-11,C,L,2013-14,82,11,30,41,0.5,-6,157,7.01,28,83530.0,16:58,489,418,907,53.91,73,21,28,65,-37,4,8,12,14065.0,2:51,1,1,2,7701.0,1:33,5750000
8470619,Brian,Boyle,1984-12-18,C,L,2013-14,82,6,12,18,0.22,1,137,4.38,56,62790.0,12:45,306,272,578,52.94,154,54,20,20,0,1,1,2,1020.0,0:12,0,2,2,10199.0,2:4,1700000
8470621,Corey,Perry,1985-05-16,RW,R,2013-14,81,43,39,82,1.01,32,280,15.36,65,94679.0,19:28,9,16,25,36.0,81,28,31,56,-25,8,10,18,17061.0,3:30,0,0,0,2691.0,0:33,8625000
8470622,Patrick,Eaves,1984-05-01,RW,R,2013-14,30,2,3,5,0.17,-7,53,3.77,2,20267.0,11:15,7,8,15,46.67,43,5,8,3,5,1,2,3,1789.0,0:59,0,0,0,2107.0,1:10,1200000
8470626,Loui,Eriksson,1985-07-17,LW,L,2013-14,61,10,27,37,0.61,14,115,8.7,6,60494.0,16:31,0,0,0,0.0,12,13,31,17,14,2,9,11,7175.0,1:57,0,1,1,5233.0,1:25,4250000
8470630,Kevin,Klein,1984-12-13,D,R,2013-14,77,2,7,9,0.12,-7,73,2.74,21,80070.0,17:19,0,0,0,0.0,111,137,19,33,-14,0,0,0,345.0,0:4,0,0,0,7308.0,1:34,2900000
8470638,Patrice,Bergeron,1985-07-24,C,R,2013-14,80,30,32,62,0.78,38,243,12.35,43,86358.0,17:59,1015,717,1732,58.6,52,57,49,28,21,7,4,11,9524.0,1:59,1,3,4,9414.0,1:57,5000000
8470640,Matt,Carle,1984-09-25,D,L,2013-14,82,2,29,31,0.38,11,115,1.74,28,109159.0,22:11,0,1,1,0.0,46,161,21,43,-22,1,6,7,7130.0,1:26,0,0,0,11443.0,2:19,5500000
8470642,Shea,Weber,1985-08-14,D,R,2013-14,79,23,33,56,0.71,-2,195,11.79,52,127522.0,26:54,0,0,0,0.0,169,173,35,50,-15,12,14,26,14795.0,3:7,0,0,0,12337.0,2:36,7857143
8470644,Colin,McDonald,1984-09-30,RW,R,2013-14,70,8,10,18,0.26,-22,96,8.33,34,52030.0,12:23,7,8,15,46.67,217,15,17,13,4,0,0,0,1679.0,0:23,0,0,0,1017.0,0:14,637500
8470647,B.J.,Crombeen,1985-07-10,RW,R,2013-14,55,3,7,10,0.18,-2,60,5.0,79,33551.0,10:10,3,5,8,37.5,57,15,15,5,10,0,0,0,92.0,0:1,0,1,1,4923.0,1:29,1150000
8470654,Maxim,Lapierre,1985-03-29,C,R,2013-14,71,9,6,15,0.21,-3,78,11.54,78,47572.0,11:10,301,292,593,50.76,87,18,19,3,16,0,0,0,98.0,0:1,0,0,0,6358.0,1:29,1100000
8470655,David,Backes,1984-05-01,RW,R,2013-14,74,27,30,57,0.77,14,165,16.36,119,86793.0,19:32,621,580,1201,51.71,273,56,32,22,10,10,6,16,11761.0,2:38,0,0,0,8511.0,1:55,4500000
8470662,Colin,Fraser,1985-01-28,C,L,2013-14,33,0,2,2,0.06,-4,22,0.0,30,17797.0,8:59,87,86,173,50.29,58,20,2,7,-5,0,0,0,179.0,0:5,0,0,0,1219.0,0:36,825000
8470666,Daniel,Carcillo,1985-01-28,LW,L,2013-14,57,4,1,5,0.09,-1,44,9.09,100,31741.0,9:16,1,0,1,100.0,112,21,4,20,-16,0,0,0,289.0,0:5,0,0,0,10.0,0:0,825000
8470667,Clarke,MacArthur,1985-04-06,LW,L,2013-14,79,24,31,55,0.7,12,159,15.09,78,83583.0,17:38,15,17,32,46.88,108,20,33,37,-4,8,7,15,12271.0,2:35,1,2,3,6946.0,1:27,3250000
8470699,Jan,Hejda,1978-06-18,D,L,2013-14,78,6,11,17,0.22,8,75,8.0,40,104484.0,22:19,0,0,0,0.0,170,144,22,31,-9,0,0,0,565.0,0:7,0,0,0,13681.0,2:55,3250000
8470713,Paul,Bissonnette,1985-03-11,LW,L,2013-14,39,2,6,8,0.21,6,25,8.0,53,11108.0,4:44,1,2,3,33.33,51,4,6,3,3,0,0,0,0.0,0:0,0,0,0,0.0,0:0,737500
8470714,Corey,Potter,1984-01-05,D,R,2013-14,19,0,5,5,0.26,-1,17,0.0,21,15700.0,13:46,0,0,0,0.0,20,18,6,6,0,0,2,2,834.0,0:43,0,0,0,1383.0,1:12,775000
8470724,Kyle,Quincey,1985-08-12,D,L,2013-14,82,4,9,13,0.16,-5,106,3.77,88,102363.0,20:48,0,0,0,0.0,88,109,31,39,-8,0,0,0,1617.0,0:19,0,0,0,11988.0,2:26,3775000
8470729,Tyson,Strachan,1984-10-30,D,R,2013-14,18,0,2,2,0.11,-2,7,0.0,28,18715.0,17:19,0,0,0,0.0,31,30,4,9,-5,0,0,0,184.0,0:10,0,0,0,1138.0,1:3,550000
8470740,Lee,Stempniak,1983-02-04,RW,R,2013-14,73,12,22,34,0.47,-16,178,6.74,32,80870.0,18:27,10,23,33,30.3,104,21,40,39,1,0,4,4,8184.0,1:52,2,3,5,5857.0,1:20,2500000
8470750,John,Mitchell,1985-01-22,C,L,2013-14,75,11,21,32,0.43,13,107,10.28,36,73222.0,16:16,374,374,748,50.0,112,51,38,27,11,3,0,3,4749.0,1:3,0,1,1,8157.0,1:48,1100000
8470755,Brad,Richardson,1985-02-04,C,L,2013-14,73,11,12,23,0.32,1,85,12.94,39,65268.0,14:54,533,433,966,55.18,63,52,27,20,7,1,0,1,606.0,0:8,2,1,3,8975.0,2:2,1150000
8470760,Marc,Methot,1985-06-21,D,L,2013-14,75,6,17,23,0.31,0,117,5.13,28,97902.0,21:45,0,0,0,0.0,181,110,21,43,-22,0,3,3,2588.0,0:34,0,0,0,12156.0,2:42,3000000
8470775,Nate,Thompson,1984-10-05,C,L,2013-14,81,9,7,16,0.2,3,105,8.57,27,62521.0,12:51,496,478,974,50.92,114,45,28,9,19,0,0,0,210.0,0:2,2,0,2,9733.0,2:0,1600000
8470778,Drew,Miller,1984-02-17,LW,L,2013-14,82,7,8,15,0.18,-11,117,5.98,21,69560.0,14:8,9,14,23,39.13,122,63,26,9,17,0,0,0,441.0,0:5,0,0,0,14814.0,3:0,1350000
8470794,Joe,Pavelski,1984-07-11,C,R,2013-14,82,41,38,79,0.96,23,225,18.22,32,97663.0,19:51,675,531,1206,55.97,47,68,56,57,-1,16,15,31,17298.0,3:30,1,1,2,7839.0,1:35,4000000
8470803,Kyle,Brodziak,1984-05-25,C,R,2013-14,81,8,16,24,0.3,0,115,6.96,61,78829.0,16:13,590,633,1223,48.24,73,41,49,20,29,0,1,1,683.0,0:8,1,0,1,12747.0,2:37,2833333
8470816,Jay,Rosehill,1985-07-16,LW,L,2013-14,34,2,0,2,0.06,-8,14,14.29,90,10082.0,4:56,0,1,1,0.0,48,4,1,5,-4,0,0,0,89.0,0:2,0,0,0,14.0,0:0,675000
8470828,Toby,Enstrom,1984-11-05,D,L,2013-14,82,10,20,30,0.37,-9,106,9.43,56,117580.0,23:53,1,0,1,100.0,37,142,13,39,-26,4,9,13,16090.0,3:16,0,0,0,9817.0,1:59,5750000
8470834,Dustin,Byfuglien,1985-03-27,D,R,2013-14,78,20,36,56,0.72,-20,256,7.81,86,108042.0,23:5,0,2,2,0.0,213,80,68,72,-4,8,18,26,16184.0,3:27,0,0,0,7629.0,1:37,5200000
8470839,Shane,O'Brien,1983-08-09,D,L,2013-14,45,0,3,3,0.07,-8,16,0.0,58,30404.0,11:15,0,0,0,0.0,56,38,3,9,-6,0,0,0,94.0,0:2,0,0,0,221.0,0:4,2000000
8470852,Matt,Moulson,1983-11-01,LW,L,2013-14,75,23,28,51,0.68,2,176,13.07,34,80863.0,17:58,2,7,9,22.22,46,43,32,14,18,9,10,19,13918.0,3:5,0,0,0,132.0,0:1,3133333
8470854,Tanner,Glass,1983-11-29,LW,L,2013-14,67,4,9,13,0.19,-8,56,7.14,90,47381.0,11:47,9,10,19,47.37,247,57,10,5,5,0,0,0,79.0,0:1,0,0,0,6602.0,1:38,1100000
8470867,Troy,Bodie,1985-01-25,RW,R,2013-14,47,3,7,10,0.21,6,50,6.0,26,24345.0,8:37,2,5,7,28.57,64,19,6,7,-1,0,0,0,49.0,0:1,0,0,0,43.0,0:0,600000
8470871,Chris,Porter,1984-05-29,LW,L,2013-14,22,0,1,1,0.05,-3,24,0.0,0,13696.0,10:22,3,7,10,30.0,68,3,3,1,2,0,0,0,46.0,0:2,0,0,0,612.0,0:27,675000
8470877,David,Jones,1984-08-10,RW,R,2013-14,48,9,8,17,0.35,1,104,8.65,10,44524.0,15:27,38,35,73,52.05,102,31,15,13,2,2,0,2,5159.0,1:47,0,0,0,328.0,0:6,4000000
8470886,Clayton,Stoner,1985-02-19,D,L,2013-14,63,1,4,5,0.08,-6,48,2.08,84,50373.0,13:19,0,0,0,0.0,99,65,11,19,-8,0,0,0,94.0,0:1,0,0,0,4874.0,1:17,1050000
8470920,David,Clarkson,1984-03-31,RW,R,2013-14,60,5,6,11,0.18,-14,102,4.9,93,54366.0,15:6,8,13,21,38.1,159,35,23,25,-2,1,1,2,3834.0,1:3,0,0,0,21.0,0:0,5250000
8470966,Mark,Giordano,1983-10-03,D,L,2013-14,64,14,33,47,0.73,12,180,7.78,63,96898.0,25:14,0,0,0,0.0,73,103,39,43,-4,7,13,20,13201.0,3:26,0,3,3,10170.0,2:38,4020000
8471185,Curtis,Glencross,1982-12-28,LW,L,2013-14,38,12,12,24,0.63,-11,77,15.58,12,40166.0,17:37,14,27,41,34.15,59,27,19,22,-3,3,5,8,5781.0,2:32,0,0,0,909.0,0:23,2550000
8471208,Dustin,Penner,1982-09-28,RW,L,2013-14,67,14,21,35,0.52,25,119,11.76,30,58164.0,14:28,15,32,47,31.91,92,24,22,27,-5,5,6,11,7715.0,1:55,0,0,0,68.0,0:1,2000000
8471214,Alex,Ovechkin,1985-09-17,LW,R,2013-14,78,51,28,79,1.01,-35,386,13.21,48,96152.0,20:32,2,1,3,66.67,204,22,32,48,-16,24,15,39,23566.0,5:2,0,1,1,59.0,0:0,9538462
8471215,Evgeni,Malkin,1986-07-31,C,L,2013-14,60,23,49,72,1.2,10,191,12.04,62,72225.0,20:3,303,318,621,48.79,27,18,37,58,-21,7,23,30,16468.0,4:34,0,0,0,94.0,0:1,8700000
8471217,Andrew,Ladd,1985-12-12,LW,L,2013-14,78,23,31,54,0.69,8,189,12.17,57,92317.0,19:43,24,38,62,38.71,154,42,37,44,-7,4,8,12,12721.0,2:43,0,2,2,9642.0,2:3,4400000
8471218,Blake,Wheeler,1986-08-31,RW,R,2013-14,82,28,41,69,0.84,4,225,12.44,63,91948.0,18:41,15,25,40,37.5,150,68,36,32,4,8,11,19,12941.0,2:37,0,0,0,4215.0,0:51,5600000
8471220,Rostislav,Olesz,1985-10-10,LW,L,2013-14,10,0,2,2,0.2,-1,9,0.0,0,6852.0,11:25,1,2,3,33.33,11,1,3,0,3,0,1,1,289.0,0:28,0,0,0,460.0,0:46,3125000
8471222,Ladislav,Smid,1986-02-01,D,L,2013-14,73,2,6,8,0.11,-10,41,4.88,78,79407.0,18:7,0,0,0,0.0,193,168,13,38,-25,0,0,0,185.0,0:2,0,0,0,8982.0,2:3,3500000
8471226,Drew,Stafford,1985-10-30,RW,R,2013-14,70,16,18,34,0.49,-19,185,8.65,39,78294.0,18:38,106,91,197,53.81,78,25,24,30,-6,2,5,7,9762.0,2:19,1,0,1,6329.0,1:30,4000000
8471231,Kyle,Chipchura,1986-02-19,C,L,2013-14,80,5,15,20,0.25,3,46,10.87,45,46647.0,9:43,176,155,331,53.17,116,9,30,12,18,0,0,0,141.0,0:1,0,0,0,239.0,0:2,875000
8471232,Lauri,Korpikoski,1986-07-28,LW,L,2013-14,64,9,16,25,0.39,-7,109,8.26,24,61736.0,16:4,5,12,17,29.41,136,38,19,13,6,1,1,2,3100.0,0:48,0,3,3,7790.0,2:1,2500000
8471233,Travis,Zajac,1985-05-13,C,R,2013-14,80,18,30,48,0.6,3,165,10.91,28,97492.0,20:18,761,633,1394,54.59,53,25,49,23,26,3,12,15,12040.0,2:30,0,0,0,9546.0,1:59,5750000
8471236,Andrej,Meszaros,1985-10-13,D,L,2013-14,52,7,15,22,0.42,5,84,8.33,40,55492.0,17:47,0,0,0,0.0,67,64,11,28,-17,1,1,2,3352.0,1:4,0,0,0,2728.0,0:52,4000000
8471241,Mark,Fistric,1986-06-01,D,L,2013-14,34,1,4,5,0.15,9,22,4.55,28,31428.0,15:24,0,0,0,0.0,145,46,5,8,-3,0,1,1,216.0,0:6,0,0,0,3384.0,1:39,900000
8471242,Mike,Green,1985-10-12,D,R,2013-14,70,9,29,38,0.54,-16,172,5.23,64,95465.0,22:43,0,0,0,0.0,62,107,32,65,-33,3,12,15,11611.0,2:45,0,0,0,2056.0,0:29,6083333
8471245,Dave,Bolland,1986-06-05,C,R,2013-14,23,8,4,12,0.52,-1,33,24.24,24,19963.0,14:27,152,185,337,45.1,38,13,10,12,-2,1,1,2,814.0,0:35,1,0,1,1642.0,1:11,3375000
8471254,Bryan,Bickell,1986-03-09,LW,L,2013-14,59,11,4,15,0.25,-6,93,11.83,28,40179.0,11:21,1,1,2,50.0,105,10,10,8,2,0,0,0,1747.0,0:29,0,0,0,0.0,0:0,4000000
8471260,Blake,Comeau,1986-02-18,LW,R,2013-14,61,5,11,16,0.26,-2,107,4.67,36,44141.0,12:3,10,7,17,58.82,197,16,22,16,6,0,0,0,548.0,0:8,0,0,0,1484.0,0:24,1000000
8471262,Carl,Soderberg,1985-10-12,C,L,2013-14,73,16,32,48,0.66,4,129,12.4,36,62453.0,14:15,139,189,328,42.38,52,36,33,14,19,5,11,16,7788.0,1:46,0,0,0,42.0,0:0,1008333
8471266,David,Booth,1984-11-24,LW,L,2013-14,66,9,10,19,0.29,1,117,7.69,18,53356.0,13:28,13,10,23,56.52,121,17,23,16,7,0,1,1,1974.0,0:29,0,0,0,212.0,0:3,4250000
8471269,Nicklas,Grossmann,1985-01-22,D,L,2013-14,78,1,13,14,0.18,-6,71,1.41,55,89453.0,19:6,0,0,0,0.0,189,174,4,44,-40,0,0,0,307.0,0:3,0,1,1,12486.0,2:40,3500000
8471273,Brandon,Dubinsky,1986-04-29,C,L,2013-14,76,16,34,50,0.66,5,189,8.47,98,85617.0,18:46,586,521,1107,52.94,234,39,33,20,13,4,6,10,11865.0,2:36,2,2,4,9814.0,2:9,4200000
8471274,Alex,Goligoski,1985-07-30,D,L,2013-14,81,6,36,42,0.52,9,141,4.26,28,118163.0,24:18,0,1,1,0.0,94,154,18,88,-70,3,12,15,16077.0,3:18,0,0,0,12023.0,2:28,4600000
8471276,David,Krejci,1986-04-28,C,R,2013-14,80,19,50,69,0.86,39,169,11.24,28,91780.0,19:7,618,590,1208,51.16,75,56,45,48,-3,3,16,19,12316.0,2:33,0,0,0,3106.0,0:38,5250000
8471283,Brandon,Prust,1984-03-16,LW,L,2013-14,52,6,7,13,0.25,-1,49,12.24,121,40007.0,12:49,65,60,125,52.0,92,35,12,15,-3,0,1,1,528.0,0:10,0,1,1,5490.0,1:45,2500000
8471284,Andrej,Sekera,1986-06-08,D,L,2013-14,74,11,33,44,0.59,4,142,7.75,20,105132.0,23:40,0,0,0,0.0,54,127,68,38,30,4,11,15,11783.0,2:39,1,0,1,11637.0,2:37,2750000
8471296,Alexei,Emelin,1986-04-25,D,L,2013-14,59,3,14,17,0.29,-1,58,5.17,59,68167.0,19:15,0,0,0,0.0,189,127,7,44,-37,1,2,3,2089.0,0:35,0,0,0,6129.0,1:43,2000000
8471299,Peter,Regin,1986-04-16,C,L,2013-14,61,4,7,11,0.18,-5,69,5.8,20,41869.0,11:26,176,220,396,44.44,43,19,21,10,11,0,1,1,1649.0,0:27,0,2,2,2177.0,0:35,750000
8471303,Alexander,Edler,1986-04-21,D,L,2013-14,63,7,15,22,0.35,-39,178,3.93,50,88023.0,23:17,2,1,3,66.67,112,136,28,34,-6,4,8,12,10791.0,2:51,0,0,0,8307.0,2:11,5000000
8471309,Johan,Franzen,1979-12-23,RW,L,2013-14,54,16,25,41,0.76,6,149,10.74,40,57211.0,17:39,119,106,225,52.89,66,23,18,28,-10,7,10,17,9493.0,2:55,0,0,0,980.0,0:18,3954545
8471311,Tyler,Kennedy,1986-07-15,C,R,2013-14,67,4,13,17,0.25,-10,143,2.8,34,51137.0,12:43,57,79,136,41.91,54,11,36,14,22,0,1,1,1983.0,0:29,0,0,0,696.0,0:10,2350000
8471323,Ryan,Jones,1984-06-14,LW,L,2013-14,52,2,4,6,0.12,0,59,3.39,40,30704.0,9:50,2,4,6,33.33,74,21,15,18,-3,0,0,0,1474.0,0:28,0,0,0,2743.0,0:52,1500000
8471326,Patrick,Bordeleau,1986-03-23,LW,L,2013-14,82,6,5,11,0.13,-1,37,16.22,115,33884.0,6:53,1,2,3,33.33,178,14,8,13,-5,0,0,0,179.0,0:2,0,0,0,0.0,0:0,1000000
8471331,Kevin,Porter,1986-03-12,C,L,2013-14,12,0,1,1,0.08,-5,3,0.0,2,8370.0,11:37,18,35,53,33.96,24,4,5,1,4,0,0,0,36.0,0:3,0,0,0,936.0,1:18,537500
8471338,Torrey,Mitchell,1985-01-30,C,R,2013-14,67,2,8,10,0.15,-3,56,3.57,25,43719.0,10:52,12,19,31,38.71,60,25,13,11,2,0,0,0,118.0,0:1,0,0,0,7088.0,1:45,1900000
8471339,Ryan,Callahan,1985-03-21,RW,R,2013-14,65,17,19,36,0.55,1,163,10.43,24,72729.0,18:38,13,19,32,40.62,189,60,34,20,14,7,5,12,9384.0,2:24,1,0,1,5490.0,1:24,4275000
8471346,Kris,Versteeg,1986-05-13,RW,R,2013-14,81,12,24,36,0.44,0,157,7.64,36,70289.0,14:27,56,63,119,47.06,29,23,37,20,17,1,7,8,9589.0,1:58,0,0,0,205.0,0:2,4400000
8471348,Nikita,Nikitin,1986-06-16,D,L,2013-14,66,2,13,15,0.23,9,95,2.11,20,67774.0,17:6,0,0,0,0.0,84,72,13,21,-8,0,0,0,3210.0,0:48,0,0,0,2954.0,0:44,2150000
8471362,Mikhail,Grabovski,1984-01-31,C,L,2013-14,58,13,22,35,0.6,6,81,16.05,26,54817.0,15:45,346,295,641,53.98,19,22,27,21,6,3,5,8,5027.0,1:26,0,0,0,78.0,0:1,5500000
8471371,Mike,Brown,1985-06-24,RW,R,2013-14,56,2,3,5,0.09,-9,45,4.44,94,24028.0,7:9,2,1,3,66.67,146,15,8,4,4,0,0,0,186.0,0:3,0,0,0,89.0,0:1,736667
8471385,Adam,Pardy,1984-03-29,D,L,2013-14,60,0,6,6,0.1,4,47,0.0,38,51915.0,14:25,0,0,0,0.0,77,55,15,31,-16,0,0,0,68.0,0:1,0,0,0,3633.0,1:0,600000
8471390,Mike,Santorelli,1985-12-14,C,R,2013-14,49,10,18,28,0.57,9,91,10.99,6,54580.0,18:33,215,204,419,51.31,23,44,22,7,15,0,0,0,4108.0,1:23,0,2,2,5050.0,1:43,550000
8471392,Roman,Polak,1986-04-28,D,R,2013-14,72,4,9,13,0.18,3,83,4.82,71,74897.0,17:20,0,0,0,0.0,151,131,10,11,-1,0,0,0,58.0,0:0,0,0,0,9886.0,2:17,2750000
8471426,Troy,Brouwer,1985-08-17,RW,R,2013-14,82,25,18,43,0.52,-6,161,15.53,92,92739.0,18:50,223,213,436,51.15,210,39,34,22,12,12,9,21,16865.0,3:25,0,0,0,10379.0,2:6,3666667
8471428,Pierre-Luc,Letourneau-Leblond,1985-06-04,RW,L,2013-14,1,0,0,0,0.0,0,1,0.0,0,274.0,4:34,0,0,0,0.0,0,1,0,0,0,0,0,0,0.0,0:0,0,0,0,0.0,0:0,550000
8471436,Matt,Hunwick,1985-05-21,D,L,2013-14,1,0,0,0,0.0,0,1,0.0,0,1047.0,17:27,0,0,0,0.0,1,2,0,0,0,0,0,0,54.0,0:54,0,0,0,61.0,1:1,1600000
8471474,Travis,Morin,1984-01-09,C,L,2013-14,4,0,1,1,0.25,2,4,0.0,0,2479.0,10:19,19,19,38,50.0,0,1,1,0,1,0,0,0,37.0,0:9,0,0,0,0.0,0:0,550000
8471476,Daniel,Winnik,1985-03-06,LW,L,2013-14,76,6,24,30,0.39,6,115,5.22,23,70175.0,15:23,85,111,196,43.37,61,62,34,30,4,0,0,0,546.0,0:7,2,2,4,11488.0,2:31,1800000
8471482,Grant,Clitsome,1985-04-14,D,L,2013-14,32,2,10,12,0.38,-5,42,4.76,18,37991.0,19:47,0,0,0,0.0,51,42,9,22,-13,0,2,2,2540.0,1:19,0,0,0,2939.0,1:31,2066667
8471490,Adam,Cracknell,1985-07-15,RW,R,2013-14,19,0,2,2,0.11,0,16,0.0,0,9327.0,8:10,10,17,27,37.04,33,8,3,0,3,0,0,0,135.0,0:7,0,0,0,129.0,0:6,600000
8471498,Jannik,Hansen,1986-03-15,RW,R,2013-14,71,11,9,20,0.28,-9,112,9.82,43,66734.0,15:39,12,17,29,41.38,99,22,28,14,14,0,1,1,3570.0,0:50,1,0,1,3516.0,0:49,1350000
8471504,Rene,Bourque,1981-12-10,RW,L,2013-14,63,9,7,16,0.25,-1,118,7.63,32,53613.0,14:11,4,4,8,50.0,90,15,13,9,4,3,1,4,4535.0,1:11,0,0,0,169.0,0:2,3333333
8471514,Rich,Peverley,1982-07-08,C,R,2013-14,62,7,23,30,0.48,-3,122,5.74,15,57235.0,15:23,348,231,579,60.1,27,42,25,26,-1,0,3,3,7626.0,2:3,1,1,2,4234.0,1:8,3250000
8471636,Tim,Sestito,1984-08-28,LW,L,2013-14,16,0,3,3,0.19,1,13,0.0,2,8733.0,9:5,20,27,47,42.55,24,9,1,3,-2,0,0,0,0.0,0:0,0,0,0,789.0,0:49,562500
8471657,Cody,McLeod,1984-06-26,LW,L,2013-14,71,5,8,13,0.18,2,76,6.58,122,43995.0,10:19,2,8,10,20.0,148,33,10,1,9,0,0,0,75.0,0:1,1,0,1,6412.0,1:30,1150000
8471663,Mike,Blunden,1986-12-15,RW,R,2013-14,7,0,0,0,0.0,-2,2,0.0,5,2576.0,6:8,0,0,0,0.0,16,3,0,0,0,0,0,0,2.0,0:0,0,0,0,77.0,0:11,550000
8471664,Mason,Raymond,1985-09-17,LW,L,2013-14,82,19,26,45,0.55,-6,178,10.67,22,85330.0,17:20,7,9,16,43.75,38,24,26,39,-13,6,5,11,9716.0,1:58,1,1,2,6708.0,1:21,1000000
8471669,Paul,Stastny,1985-12-27,C,L,2013-14,71,25,35,60,0.85,9,150,16.67,22,78351.0,18:23,655,555,1210,54.13,54,46,35,20,15,4,11,15,10113.0,2:22,0,1,1,2602.0,0:36,6600000
8471675,Sidney,Crosby,1987-08-07,C,L,2013-14,80,36,68,104,1.3,18,259,13.9,46,105467.0,21:58,991,896,1887,52.52,47,28,41,56,-15,11,27,38,20582.0,4:17,0,0,0,2420.0,0:30,8700000
8471676,Bobby,Ryan,1987-03-17,RW,R,2013-14,70,23,25,48,0.69,7,190,12.11,45,70850.0,16:52,8,5,13,61.54,104,30,50,39,11,6,3,9,10591.0,2:31,0,0,0,886.0,0:12,5100000
8471677,Jack,Johnson,1987-01-13,D,L,2013-14,82,5,28,33,0.4,-7,147,3.4,48,121423.0,24:40,0,1,1,0.0,182,128,17,40,-23,4,14,18,15793.0,3:12,0,0,0,14629.0,2:58,4357143
8471678,Benoit,Pouliot,1986-09-29,LW,L,2013-14,80,15,21,36,0.45,10,141,10.64,56,64513.0,13:26,20,19,39,51.28,141,18,31,39,-8,7,1,8,9334.0,1:56,0,0,0,32.0,0:0,1300000
8471680,Gilbert,Brule,1987-01-01,C,R,2013-14,3,0,0,0,0.0,-1,3,0.0,2,2080.0,11:33,0,0,0,0.0,3,1,1,1,0,0,0,0,28.0,0:9,0,0,0,0.0,0:0,685000
8471681,Jack,Skille,1987-05-19,RW,R,2013-14,16,4,0,4,0.25,2,23,17.39,6,8315.0,8:39,1,0,1,100.0,19,6,5,0,5,0,0,0,123.0,0:7,0,0,0,0.0,0:0,675000
8471682,Devin,Setoguchi,1987-01-01,RW,R,2013-14,75,11,16,27,0.36,-7,129,8.53,22,67743.0,15:3,5,15,20,25.0,143,37,24,29,-5,2,1,3,8081.0,1:47,0,0,0,51.0,0:0,3000000
8471685,Anze,Kopitar,1987-08-24,C,L,2013-14,82,29,41,70,0.85,34,200,14.5,24,102765.0,20:53,773,678,1451,53.27,90,44,52,41,11,10,13,23,16710.0,3:23,0,0,0,9893.0,2:0,6800000
8471686,Marc,Staal,1987-01-13,D,L,2013-14,72,3,11,14,0.19,-1,92,3.26,24,88688.0,20:31,1,0,1,100.0,83,84,41,48,-7,1,0,1,1623.0,0:22,0,1,1,8705.0,2:0,3975000
8471691,Martin,Hanzal,1987-02-20,C,L,2013-14,65,15,25,40,0.62,-9,169,8.88,73,72859.0,18:40,599,500,1099,54.5,200,37,32,19,13,5,8,13,10874.0,2:47,0,0,0,4717.0,1:12,3100000
8471693,Jakub,Kindl,1987-02-10,D,L,2013-14,66,2,17,19,0.29,-4,93,2.15,24,68233.0,17:13,0,0,0,0.0,57,42,14,34,-20,0,7,7,8065.0,2:2,0,0,0,370.0,0:5,2400000
8471698,T.J.,Oshie,1986-12-23,RW,R,2013-14,79,21,39,60,0.76,19,152,13.82,42,89985.0,18:59,28,38,66,42.42,77,54,62,21,41,5,10,15,12904.0,2:43,2,1,3,8373.0,1:45,4175000
8471699,Andrew,Cogliano,1987-06-14,LW,L,2013-14,82,21,21,42,0.51,13,157,13.38,26,75734.0,15:23,11,16,27,40.74,94,36,22,31,-9,0,0,0,1082.0,0:13,3,2,5,7836.0,1:35,2390000
8471700,Matt,Pelech,1987-09-04,RW,R,2013-14,6,1,0,1,0.17,1,3,33.33,22,1414.0,3:55,0,0,0,0.0,7,1,1,0,1,0,0,0,29.0,0:4,0,0,0,0.0,0:0,550000
8471702,Matt,Niskanen,1986-12-06,D,R,2013-14,81,10,36,46,0.57,33,162,6.17,51,103488.0,21:17,0,0,0,0.0,124,76,19,49,-30,3,12,15,14546.0,2:59,0,0,0,3477.0,0:42,2300000
8471703,Steve,Downie,1987-04-03,RW,R,2013-14,62,4,20,24,0.39,1,88,4.55,106,52461.0,14:6,4,3,7,57.14,70,18,24,21,3,3,3,6,6570.0,1:45,0,0,0,4.0,0:0,2650000
8471707,James,Neal,1987-09-03,LW,L,2013-14,59,27,34,61,1.03,15,238,11.34,55,65310.0,18:26,5,13,18,27.78,58,23,31,22,9,11,15,26,13574.0,3:50,0,0,0,71.0,0:1,5000000
8471708,Ryan,Stoa,1987-04-13,C,L,2013-14,3,0,0,0,0.0,-1,2,0.0,0,1635.0,9:5,0,9,9,0.0,4,1,0,0,0,0,0,0,0.0,0:0,0,0,0,0.0,0:0,550000
8471709,Marc-Edouard,Vlasic,1987-03-30,D,L,2013-14,81,5,19,24,0.3,31,138,3.62,38,100673.0,20:42,0,0,0,0.0,51,150,18,35,-17,0,1,1,3409.0,0:42,1,1,2,10664.0,2:11,4250000
8471716,Justin,Abdelkader,1987-02-25,LW,L,2013-14,70,10,18,28,0.4,2,147,6.8,31,64192.0,15:17,23,32,55,41.82,172,31,21,15,6,1,2,3,3705.0,0:52,0,0,0,2677.0,0:38,1800000
8471717,Adam,McQuaid,1986-10-12,D,R,2013-14,30,1,5,6,0.2,12,25,4.0,69,28886.0,16:2,0,0,0,0.0,54,42,1,10,-9,0,0,0,45.0,0:1,0,0,0,3263.0,1:48,1566667
8471718,Marc-Andre,Cliche,1987-03-23,C,R,2013-14,76,1,6,7,0.09,-11,69,1.45,17,48172.0,10:33,331,388,719,46.04,25,42,34,4,30,0,0,0,279.0,0:3,0,1,1,11543.0,2:31,537500
8471719,Matt,Kassian,1986-10-28,LW,L,2013-14,33,1,1,2,0.06,-1,12,8.33,63,8787.0,4:26,0,0,0,0.0,52,3,1,5,-4,0,0,0,0.0,0:0,0,0,0,0.0,0:0,575000
8471724,Kris,Letang,1987-04-24,D,R,2013-14,37,11,11,22,0.59,-8,108,10.19,16,53799.0,24:14,0,0,0,0.0,43,51,9,39,-30,6,6,12,8244.0,3:42,0,0,0,4436.0,1:59,3500000
8471729,Kris,Russell,1987-05-02,D,L,2013-14,68,7,22,29,0.43,-11,109,6.42,15,94389.0,23:8,0,0,0,0.0,42,201,25,39,-14,4,8,12,12059.0,2:57,0,1,1,3647.0,0:53,1500000
8471733,Rich,Clune,1987-04-25,LW,L,2013-14,58,3,4,7,0.12,-7,29,10.34,166,29432.0,8:27,0,0,0,0.0,132,9,11,6,5,0,0,0,109.0,0:1,0,0,0,614.0,0:10,537500
8471735,Keith,Yandle,1986-09-09,D,L,2013-14,82,8,45,53,0.65,-23,241,3.32,63,118799.0,24:8,0,0,0,0.0,22,105,31,65,-34,3,28,31,21616.0,4:23,0,0,0,1001.0,0:12,5250000
8471742,Cody,Franson,1987-08-08,D,R,2013-14,79,5,28,33,0.42,-20,115,4.35,30,98056.0,20:41,0,0,0,0.0,282,111,50,68,-18,1,17,18,13803.0,2:54,0,0,0,7779.0,1:38,2000000
8471743,Vladimir,Sobotka,1987-07-02,LW,L,2013-14,61,9,24,33,0.54,14,102,8.82,72,61278.0,16:44,503,310,813,61.87,110,28,25,8,17,1,6,7,5874.0,1:36,0,1,1,6879.0,1:52,1300000
8471748,Mark,Fraser,1986-09-29,D,L,2013-14,42,1,1,2,0.05,-15,11,9.09,76,38734.0,15:22,0,0,0,0.0,118,95,7,33,-26,0,0,0,96.0,0:2,0,0,0,5467.0,2:10,1275000
8471761,Chris,Butler,1986-10-27,D,L,2013-14,82,2,14,16,0.2,-23,83,2.41,39,99708.0,20:15,0,0,0,0.0,68,211,14,64,-50,0,0,0,1686.0,0:20,0,1,1,13247.0,2:41,1700000
8471762,Chris,VandeVelde,1987-03-15,C,L,2013-14,18,0,1,1,0.06,-3,8,0.0,6,8347.0,7:43,16,24,40,40.0,24,6,3,2,1,0,1,1,64.0,0:3,0,0,0,1727.0,1:35,550000
8471766,Jared,Boll,1986-05-13,RW,R,2013-14,28,1,1,2,0.07,-6,12,8.33,62,12814.0,7:37,0,1,1,0.0,55,9,2,0,2,0,0,0,35.0,0:1,0,0,0,0.0,0:0,1050000
8471767,Blair,Jones,1986-09-27,C,R,2013-14,14,2,0,2,0.14,0,14,14.29,21,9556.0,11:22,36,40,76,47.37,30,5,5,9,-4,0,0,0,247.0,0:17,1,0,1,918.0,1:5,650000
8471768,Tom,Pyatt,1987-02-14,LW,L,2013-14,27,3,4,7,0.26,-2,27,11.11,4,18568.0,11:27,101,92,193,52.33,11,20,2,5,-3,0,0,0,162.0,0:6,0,0,0,1552.0,0:57,600000
8471769,Niklas,Hjalmarsson,1987-06-06,D,L,2013-14,81,4,22,26,0.32,11,98,4.08,34,103416.0,21:16,0,0,0,0.0,39,157,21,100,-79,0,0,0,555.0,0:6,1,3,4,13714.0,2:49,3500000
8471794,Darren,Helm,1987-01-21,LW,L,2013-14,42,12,8,20,0.48,2,83,14.46,14,38231.0,15:10,269,279,548,49.09,73,16,17,13,4,1,0,1,1700.0,0:40,2,0,2,5472.0,2:10,2125000
8471804,Nathan,Gerbe,1987-07-24,C,L,2013-14,81,16,15,31,0.38,-6,221,7.24,36,79710.0,16:24,2,4,6,33.33,53,15,48,34,14,3,4,7,8509.0,1:45,2,0,2,4835.0,0:59,1450000
8471816,Mark,Fayne,1987-05-15,D,R,2013-14,72,4,7,11,0.15,-5,88,4.55,30,79105.0,18:18,0,0,0,0.0,77,83,12,32,-20,0,0,0,191.0,0:2,1,0,1,8617.0,1:59,1300000
8471817,Ryan,Reaves,1987-01-20,RW,R,2013-14,63,2,6,8,0.13,-1,25,8.0,126,32215.0,8:31,6,2,8,75.0,211,12,12,6,6,0,0,0,55.0,0:0,0,0,0,4.0,0:0,600000
8471832,Nick,Drazenovic,1987-01-14,C,L,2013-14,1,0,0,0,0.0,-1,3,0.0,2,618.0,10:18,3,1,4,75.0,1,0,0,0,0,0,0,0,43.0,0:43,0,0,0,0.0,0:0,550000
8471840,Brett,Sutter,1987-06-02,LW,L,2013-14,17,1,1,2,0.12,-4,16,6.25,9,7712.0,7:33,37,36,73,50.68,35,2,4,2,2,0,0,0,85.0,0:5,0,0,0,393.0,0:23,600000
8471842,Tim,Kennedy,1986-04-30,LW,L,2013-14,37,2,6,8,0.22,0,42,4.76,4,26108.0,11:45,18,31,49,36.73,62,21,15,11,4,0,0,0,63.0,0:1,0,0,0,99.0,0:2,700000
8471851,Matt,D'Agostini,1986-10-23,RW,R,2013-14,57,5,7,12,0.21,-15,110,4.55,26,50794.0,14:51,5,10,15,33.33,55,40,22,12,10,2,0,2,5400.0,1:34,0,0,0,1301.0,0:22,550000
8471856,Joe,Vitale,1985-08-20,C,R,2013-14,53,1,13,14,0.26,-1,42,2.38,29,34898.0,10:58,200,120,320,62.5,89,22,8,12,-4,0,1,1,150.0,0:2,0,0,0,2071.0,0:39,550000
8471862,Colin,Greening,1986-03-09,C,L,2013-14,76,6,11,17,0.22,-15,108,5.56,41,62670.0,13:44,22,37,59,37.29,225,30,28,20,8,2,1,3,1946.0,0:25,0,0,0,5496.0,1:12,816666
8471873,Anton,Stralman,1986-08-01,D,R,2013-14,81,1,12,13,0.16,9,104,0.96,26,94337.0,19:24,0,0,0,0.0,75,64,29,49,-20,0,0,0,1348.0,0:16,0,0,0,7879.0,1:37,1700000
8471887,Patric,Hornqvist,1987-01-01,RW,R,2013-14,76,22,31,53,0.7,1,248,8.87,28,76875.0,16:51,0,6,6,0.0,77,34,53,13,40,7,10,17,13316.0,2:55,0,0,0,50.0,0:0,4250000
8471956,Andrew,Desjardins,1986-07-27,LW,L,2013-14,81,3,14,17,0.21,-8,95,3.16,86,54157.0,11:8,371,304,675,54.96,103,43,37,26,11,0,0,0,298.0,0:3,0,0,0,5880.0,1:12,750000
8471958,Dan,Girardi,1984-04-29,D,R,2013-14,81,5,19,24,0.3,6,100,5.0,16,112361.0,23:7,0,0,0,0.0,191,174,28,55,-27,1,2,3,7395.0,1:31,0,2,2,13654.0,2:48,3325000
8471976,David,Desharnais,1986-09-14,C,L,2013-14,79,16,36,52,0.66,11,96,16.67,24,81533.0,17:12,611,591,1202,50.83,23,35,34,22,12,3,12,15,12749.0,2:41,0,0,0,625.0,0:7,3500000
8471996,Bracken,Kearns,1981-05-12,C,L,2013-14,25,3,2,5,0.2,-2,37,8.11,6,19789.0,13:11,30,41,71,42.25,45,16,4,4,0,1,0,1,1226.0,0:49,0,0,0,861.0,0:34,550000
8472368,Chris,Conner,1983-12-23,RW,L,2013-14,19,4,1,5,0.26,-3,17,23.53,2,13415.0,11:46,0,1,1,0.0,21,10,4,3,1,0,0,0,370.0,0:19,0,0,0,0.0,0:0,550000
8472382,Andy,Greene,1982-10-30,D,L,2013-14,82,8,24,32,0.39,3,134,5.97,32,120925.0,24:34,0,0,0,0.0,87,129,46,52,-6,3,10,13,11566.0,2:21,0,2,2,17523.0,3:33,3000000
8472394,Peter,Harrold,1983-06-08,D,R,2013-14,33,0,4,4,0.12,-2,32,0.0,14,36961.0,18:40,0,0,0,0.0,17,29,3,12,-9,0,0,0,2090.0,1:3,0,0,0,2046.0,1:2,800000
8472410,Stephen,Gionta,1983-10-09,RW,R,2013-14,66,4,7,11,0.17,-8,89,4.49,18,49346.0,12:27,238,343,581,40.96,113,25,26,10,16,0,0,0,71.0,0:1,1,0,1,7475.0,1:53,562500
8473412,Bryan,Little,1987-11-12,C,R,2013-14,82,23,41,64,0.78,8,170,13.53,58,98418.0,20:0,785,868,1653,47.49,84,38,38,31,7,8,7,15,13111.0,2:39,2,2,4,11057.0,2:14,4700000
8473419,Brad,Marchand,1988-05-11,LW,L,2013-14,82,25,28,53,0.65,36,149,16.78,64,78464.0,15:56,6,17,23,26.09,73,23,46,51,-5,1,1,2,2459.0,0:29,5,0,5,7628.0,1:33,4500000
8473422,Nick,Foligno,1987-10-31,LW,L,2013-14,70,18,21,39,0.56,5,111,16.22,96,67445.0,16:3,6,7,13,46.15,210,42,43,22,21,3,3,6,7306.0,1:44,0,0,0,859.0,0:12,3083333
8473426,Mike,Weber,1987-12-16,D,L,2013-14,68,1,8,9,0.13,-29,47,2.13,73,72694.0,17:49,0,0,0,0.0,208,161,11,35,-24,0,0,0,110.0,0:1,0,1,1,8218.0,2:0,1666667
8473432,Derek,Dorsett,1986-12-20,RW,R,2013-14,51,4,4,8,0.16,-1,67,5.97,128,33743.0,11:1,0,3,3,0.0,102,27,12,8,4,0,0,0,311.0,0:6,0,0,0,2326.0,0:45,1633333
8473446,Erik,Johnson,1988-03-21,D,R,2013-14,80,9,30,39,0.49,5,157,5.73,61,110433.0,23:0,0,0,0,0.0,136,130,49,42,7,2,12,14,12701.0,2:38,0,0,0,4828.0,1:0,3750000
8473449,Kyle,Okposo,1988-04-16,RW,R,2013-14,71,27,42,69,0.97,-9,195,13.85,51,87046.0,20:26,97,107,204,47.55,43,35,44,39,5,5,10,15,16836.0,3:57,0,0,0,725.0,0:10,2800000
8473453,Trevor,Lewis,1987-01-08,C,R,2013-14,73,6,5,11,0.15,-1,111,5.41,6,58067.0,13:15,127,135,262,48.47,145,36,14,18,-4,0,0,0,1265.0,0:17,1,0,1,8222.0,1:52,1325000
8473465,Jamie,McGinn,1988-08-05,LW,L,2013-14,79,19,19,38,0.48,-3,167,11.38,30,74791.0,15:46,1,1,2,50.0,140,35,36,17,19,5,4,9,8328.0,1:45,0,0,0,1479.0,0:18,1750000
8473466,Ryan,White,1988-03-17,C,R,2013-14,52,2,4,6,0.12,-8,51,3.92,50,30229.0,9:41,197,191,388,50.77,88,37,10,7,3,0,0,0,177.0,0:3,0,0,0,5556.0,1:46,700000
8473468,Eric,Gryba,1988-04-14,D,R,2013-14,57,2,9,11,0.19,9,57,3.51,64,59922.0,17:31,0,0,0,0.0,161,60,6,35,-29,0,0,0,446.0,0:7,0,1,1,10315.0,3:0,562500
8473473,Milan,Lucic,1988-06-07,LW,L,2013-14,80,24,35,59,0.74,30,153,15.69,91,83403.0,17:22,61,70,131,46.56,240,22,33,71,-38,3,9,12,11273.0,2:20,0,0,0,57.0,0:0,6000000
8473482,Jiri,Tlusty,1988-03-16,LW,L,2013-14,68,16,14,30,0.44,2,131,12.21,22,61890.0,15:10,3,12,15,20.0,88,38,26,19,7,0,1,1,6117.0,1:29,2,0,2,2334.0,0:34,1600000
8473485,Chris,Stewart,1987-10-30,RW,R,2013-14,63,15,11,26,0.41,0,110,13.64,118,51739.0,13:41,12,23,35,34.29,80,9,12,13,-1,3,3,6,7107.0,1:52,0,0,0,146.0,0:2,4150000
8473492,Matt,Beleskey,1988-06-07,LW,L,2013-14,55,9,15,24,0.44,8,112,8.04,64,41035.0,12:26,8,10,18,44.44,132,24,14,13,1,0,4,4,4123.0,1:14,0,1,1,1464.0,0:26,1350000
8473504,Cal,Clutterbuck,1987-11-18,RW,R,2013-14,73,12,7,19,0.26,-9,172,6.98,50,62772.0,14:19,7,9,16,43.75,270,14,30,24,6,0,0,0,5748.0,1:18,3,1,4,7781.0,1:46,2750000
8473507,Jeff,Petry,1987-12-09,D,R,2013-14,80,7,10,17,0.21,-22,96,7.29,42,103607.0,21:35,0,0,0,0.0,181,132,29,96,-67,1,1,2,4043.0,0:50,0,0,0,14669.0,3:3,1750000
8473512,Claude,Giroux,1988-01-12,C,R,2013-14,82,28,58,86,1.05,7,223,12.56,46,100538.0,20:26,931,829,1760,52.9,90,46,43,34,9,7,30,37,18440.0,3:44,0,0,0,4643.0,0:56,3750000
8473514,Jesse,Joensuu,1987-10-05,LW,L,2013-14,42,3,2,5,0.12,-16,41,7.32,16,23490.0,9:19,0,5,5,0.0,63,18,14,18,-4,1,0,1,1303.0,0:31,0,0,0,123.0,0:2,950000
8473533,Jordan,Staal,1988-09-10,C,L,2013-14,82,15,25,40,0.49,2,165,9.09,34,93233.0,18:56,803,674,1477,54.37,194,37,51,41,10,2,8,10,11074.0,2:15,1,3,4,8021.0,1:37,6000000
8473534,Patrik,Berglund,1988-06-02,C,L,2013-14,78,14,18,32,0.41,10,144,9.72,38,75685.0,16:10,373,410,783,47.64,88,30,42,12,30,2,2,4,7195.0,1:32,0,0,0,7111.0,1:31,3250000
8473536,James,Sheppard,1988-04-25,C,L,2013-14,67,4,16,20,0.3,3,84,4.76,35,48925.0,12:10,105,128,233,45.06,105,34,31,15,16,0,1,1,1047.0,0:15,0,0,0,181.0,0:2,830000
8473537,Viktor,Stalberg,1986-01-17,LW,L,2013-14,70,8,10,18,0.26,-14,114,7.02,32,52852.0,12:35,1,2,3,33.33,55,25,32,23,9,0,0,0,819.0,0:11,0,0,0,224.0,0:3,3000000
8473542,Tom,Sestito,1987-09-28,LW,L,2013-14,77,5,4,9,0.12,-14,31,16.13,213,29832.0,6:27,3,8,11,27.27,121,12,8,7,1,1,0,1,493.0,0:6,0,0,0,0.0,0:0,750000
8473544,Derick,Brassard,1987-09-22,C,L,2013-14,81,18,27,45,0.56,2,159,11.32,46,76772.0,15:47,469,508,977,48.0,124,19,28,28,0,7,11,18,12293.0,2:31,0,0,0,137.0,0:1,3200000
8473546,Michael,Grabner,1987-10-05,RW,L,2013-14,64,12,14,26,0.41,-10,137,8.76,12,54502.0,14:11,7,8,15,46.67,68,25,54,26,28,0,0,0,1081.0,0:16,3,0,3,7882.0,2:3,3000000
8473548,Phil,Kessel,1987-10-02,RW,R,2013-14,82,37,43,80,0.98,-5,305,12.13,27,101678.0,20:39,2,12,14,14.29,25,30,37,88,-51,8,12,20,15429.0,3:8,0,0,0,143.0,0:1,5400000
8473558,Cory,Emmerton,1988-06-01,C,L,2013-14,18,0,2,2,0.11,-2,22,0.0,4,9669.0,8:57,58,49,107,54.21,7,5,4,1,3,0,0,0,2.0,0:0,0,0,0,1548.0,1:26,533333
8473562,John,McCarthy,1986-08-09,C,L,2013-14,36,1,1,2,0.06,-11,49,2.04,4,23883.0,11:3,71,62,133,53.38,25,17,9,9,0,0,0,0,266.0,0:7,0,0,0,2586.0,1:11,612500
8473563,Nicklas,Backstrom,1987-11-23,C,L,2013-14,82,18,61,79,0.96,-20,196,9.18,54,97426.0,19:48,714,701,1415,50.46,89,54,54,24,30,6,38,44,18066.0,3:40,1,0,1,4772.0,0:58,6700000
8473564,Michael,Frolik,1988-02-17,RW,L,2013-14,81,15,27,42,0.52,8,189,7.94,12,81031.0,16:40,43,25,68,63.24,41,51,53,24,29,1,1,2,4827.0,0:59,0,1,1,6362.0,1:18,2333333
8473565,Brian,Strait,1988-01-04,D,L,2013-14,47,3,6,9,0.19,-14,40,7.5,14,50631.0,17:57,0,0,0,0.0,65,86,16,21,-5,0,0,0,243.0,0:5,0,1,1,7453.0,2:38,775000
8473571,Jamie,McBain,1988-02-25,D,R,2013-14,69,6,11,17,0.25,-13,98,6.12,14,83488.0,20:9,0,0,0,0.0,34,113,12,31,-19,2,3,5,11112.0,2:41,0,1,1,4314.0,1:2,1800000
8473573,Artem,Anisimov,1988-05-24,C,L,2013-14,81,22,17,39,0.48,-2,162,13.58,20,80658.0,16:35,476,489,965,49.33,31,55,51,19,32,3,3,6,9860.0,2:1,2,0,2,10177.0,2:5,3283333
8473574,Shawn,Matthias,1988-02-19,LW,L,2013-14,77,12,11,23,0.3,-3,127,9.45,26,60125.0,13:0,183,250,433,42.26,93,29,33,15,18,0,0,0,1663.0,0:21,0,0,0,7909.0,1:42,1750000
8473579,Nikolay,Kulemin,1986-07-14,LW,L,2013-14,70,9,11,20,0.29,-4,81,11.11,24,68106.0,16:12,38,70,108,35.19,153,63,30,15,15,0,0,0,286.0,0:4,0,0,0,10889.0,2:35,2800000
8473584,Andrew,MacDonald,1986-09-07,D,L,2013-14,82,4,24,28,0.34,-22,92,4.35,50,121170.0,24:37,0,0,0,0.0,69,242,23,60,-37,2,9,11,14159.0,2:52,0,1,1,11668.0,2:22,550000
8473588,Erik,Condra,1986-08-06,RW,R,2013-14,76,6,10,16,0.21,0,85,7.06,30,53118.0,11:38,1,14,15,6.67,28,44,37,30,7,0,0,0,253.0,0:3,1,1,2,10922.0,2:23,1250000
8473589,Chris,Summers,1988-02-05,D,L,2013-14,18,2,1,3,0.17,0,17,11.76,15,16116.0,14:55,0,0,0,0.0,33,25,0,4,-4,0,0,0,16.0,0:0,0,0,0,1929.0,1:47,550000
8473604,Jonathan,Toews,1988-04-29,C,L,2013-14,76,28,40,68,0.89,26,193,14.51,34,93328.0,20:28,884,660,1544,57.25,29,20,51,30,21,5,10,15,14463.0,3:10,3,2,5,7075.0,1:33,6300000
8473618,Mathieu,Perreault,1988-01-05,C,L,2013-14,69,18,25,43,0.62,13,120,15.0,36,57412.0,13:52,437,393,830,52.65,73,15,19,19,0,4,5,9,8970.0,2:10,0,0,0,113.0,0:1,1050000
8473646,Ryan,Carter,1983-08-03,LW,L,2013-14,62,7,3,10,0.16,-6,69,10.14,35,42143.0,11:19,16,20,36,44.44,72,24,14,9,5,0,0,0,97.0,0:1,0,1,1,3827.0,1:1,775000
8473658,Victor,Bartley,1988-02-17,D,L,2013-14,50,1,5,6,0.12,0,21,4.76,23,46093.0,15:21,0,0,0,0.0,81,79,14,7,7,0,0,0,193.0,0:3,0,0,0,4546.0,1:30,666667
8473673,David,Schlemko,1987-05-07,D,L,2013-14,48,1,8,9,0.19,2,61,1.64,18,47224.0,16:23,0,0,0,0.0,61,79,8,12,-4,0,3,3,2909.0,1:0,0,0,0,5489.0,1:54,1187500
8473682,Andrew,Ebbett,1983-01-02,C,L,2013-14,9,0,1,1,0.11,-4,9,0.0,0,5967.0,11:3,15,20,35,42.86,10,7,2,2,0,0,0,0,261.0,0:29,0,0,0,266.0,0:29,550000
8473700,Ryan,Wilson,1987-02-03,D,L,2013-14,28,0,6,6,0.21,1,23,0.0,12,24640.0,14:40,0,1,1,0.0,53,17,5,9,-4,0,0,0,412.0,0:14,0,0,0,1897.0,1:7,2250000
8473712,Frazer,McLaren,1987-10-29,LW,L,2013-14,27,0,0,0,0.0,-2,4,0.0,77,6490.0,4:0,1,0,1,100.0,24,3,0,3,-3,0,0,0,0.0,0:0,0,0,0,7.0,0:0,700000
8473722,John,Scott,1982-09-26,LW,L,2013-14,56,1,0,1,0.02,-12,16,6.25,125,22696.0,6:45,0,0,0,0.0,95,21,3,4,-1,0,0,0,459.0,0:8,0,0,0,0.0,0:0,750000
8473908,Kevin,Westgarth,1984-02-07,RW,R,2013-14,48,4,3,7,0.15,-4,31,12.9,68,18701.0,6:29,1,4,5,20.0,45,10,8,12,-4,0,0,0,60.0,0:1,0,0,0,0.0,0:0,725000
8473911,Steven,Pinizzotto,1984-04-26,RW,R,2013-14,6,0,2,2,0.33,-1,2,0.0,15,3472.0,9:38,0,0,0,0.0,10,1,1,1,0,0,0,0,13.0,0:2,0,0,0,0.0,0:0,650000
8473914,Mark,Letestu,1985-02-04,C,R,2013-14,82,12,22,34,0.41,1,122,9.84,20,72276.0,14:41,374,356,730,51.23,63,25,27,13,14,5,6,11,6062.0,1:13,1,2,3,11211.0,2:16,1250000
8473921,Joe,Piskula,1984-07-05,D,L,2013-14,2,0,0,0,0.0,1,2,0.0,0,1461.0,12:10,0,0,0,0.0,2,0,0,2,-2,0,0,0,49.0,0:24,0,0,0,0.0,0:0,550000
8473927,Brad,Mills,1983-05-03,C,R,2013-14,3,0,0,0,0.0,-1,2,0.0,0,1859.0,10:19,8,6,14,57.14,9,1,1,1,0,0,0,0,1.0,0:0,0,0,0,242.0,1:20,550000
8473933,Ben,Lovejoy,1984-02-20,D,R,2013-14,78,5,13,18,0.23,21,107,4.67,39,90778.0,19:23,0,0,0,0.0,215,150,17,32,-15,0,1,1,969.0,0:12,0,0,0,9295.0,1:59,1100000
8473942,Trevor,Smith,1985-02-08,C,L,2013-14,28,4,5,9,0.32,-3,24,16.67,4,17425.0,10:22,115,143,258,44.57,45,16,4,3,1,0,1,1,672.0,0:24,0,0,0,455.0,0:16,550000
8473953,Derek,Smith,1984-10-13,D,L,2013-14,14,0,1,1,0.07,-10,12,0.0,2,8006.0,9:31,2,1,3,66.67,6,6,2,3,-1,0,0,0,3.0,0:0,0,0,0,44.0,0:3,775000
8473962,Teddy,Purcell,1985-09-08,LW,R,2013-14,81,12,30,42,0.52,-3,157,7.64,14,80027.0,16:27,4,12,16,25.0,13,12,36,40,-4,3,14,17,14765.0,3:2,0,0,0,109.0,0:1,4500000
8473970,Rob,Klinkhammer,1986-08-12,LW,L,2013-14,72,11,9,20,0.28,6,103,10.68,19,49108.0,11:22,1,5,6,16.67,168,7,14,13,1,1,0,1,275.0,0:3,0,0,0,1000.0,0:13,625000
8473986,Alex,Killorn,1989-09-14,LW,L,2013-14,82,17,24,41,0.5,8,173,9.83,63,82552.0,16:46,74,98,172,43.02,77,31,32,43,-11,3,5,8,9452.0,1:55,0,0,0,740.0,0:9,875000
8473989,Luke,Gazdic,1989-07-25,LW,L,2013-14,67,2,2,4,0.06,-8,30,6.67,127,23320.0,5:48,3,0,3,100.0,103,22,6,11,-5,0,0,0,169.0,0:2,0,0,0,17.0,0:0,635000
8473991,Karl,Alzner,1988-09-24,D,L,2013-14,82,2,16,18,0.22,-7,95,2.11,26,101033.0,20:32,0,0,0,0.0,73,158,28,33,-5,0,1,1,304.0,0:3,0,2,2,17397.0,3:32,2800000
8473992,Justin,Falk,1988-10-11,D,L,2013-14,21,0,2,2,0.1,-5,10,0.0,20,15034.0,11:55,0,0,0,0.0,39,28,0,9,-9,0,0,0,22.0,0:1,0,0,0,880.0,0:41,975000
8473994,Jamie,Benn,1989-07-18,LW,L,2013-14,81,34,45,79,0.98,21,279,12.19,64,93080.0,19:9,411,367,778,52.83,118,60,70,68,2,5,14,19,17843.0,3:40,1,2,3,3580.0,0:44,5250000
8474001,TJ,Galiardi,1988-04-22,LW,L,2013-14,62,4,13,17,0.27,-13,100,4.0,21,54351.0,14:36,62,93,155,40.0,77,43,23,16,7,0,0,0,615.0,0:9,1,1,2,4067.0,1:5,1250000
8474005,Alex,Grant,1989-01-20,D,R,2013-14,2,2,0,2,1.0,3,2,100.0,2,1461.0,12:10,0,0,0,0.0,1,0,0,0,0,0,0,0,0.0,0:0,0,0,0,1.0,0:0,550000
8474008,Paul,Carey,1988-09-24,C,L,2013-14,12,0,0,0,0.0,2,6,0.0,0,4633.0,6:26,0,0,0,0.0,11,2,1,1,0,0,0,0,227.0,0:18,0,0,0,0.0,0:0,675000
8474009,Nick,Bonino,1988-04-20,C,L,2013-14,77,22,27,49,0.64,14,159,13.84,22,74981.0,16:13,583,611,1194,48.83,28,68,37,35,2,7,13,20,13235.0,2:51,0,0,0,7821.0,1:41,700000
8474012,John,Albert,1989-01-19,C,L,2013-14,9,1,0,1,0.11,-3,5,20.0,0,2761.0,5:6,9,12,21,42.86,8,3,1,0,1,0,0,0,0.0,0:0,0,0,0,0.0,0:0,585000
8474013,Ian,Cole,1989-02-21,D,L,2013-14,46,3,8,11,0.24,15,45,6.67,31,41632.0,15:5,0,0,0,0.0,24,68,9,9,0,0,2,2,667.0,0:14,0,0,0,1767.0,0:38,825000
8474025,Eric,Tangradi,1989-02-10,LW,L,2013-14,55,3,3,6,0.11,-6,52,5.77,21,28526.0,8:38,3,0,3,100.0,105,17,10,12,-2,0,0,0,447.0,0:8,0,0,0,24.0,0:0,675000
8474027,Justin,Braun,1987-02-10,D,R,2013-14,82,4,13,17,0.21,19,121,3.31,20,103251.0,20:59,0,0,0,0.0,77,146,40,39,1,1,0,1,5054.0,1:1,0,0,0,10799.0,2:11,1250000
8474030,Aaron,Palushaj,1989-09-07,RW,R,2013-14,2,0,0,0,0.0,-1,2,0.0,0,1119.0,9:19,0,1,1,0.0,3,0,0,1,-1,0,0,0,32.0,0:16,0,0,0,36.0,0:18,600000
8474031,Kevin,Shattenkirk,1989-01-29,D,R,2013-14,81,10,35,45,0.56,1,188,5.32,38,99964.0,20:34,0,0,0,0.0,72,101,38,37,1,7,19,26,16241.0,3:20,0,1,1,3384.0,0:41,4250000
8474034,Patrick,Maroon,1988-04-23,LW,L,2013-14,62,11,18,29,0.47,11,93,11.83,101,45804.0,12:18,7,8,15,46.67,124,16,15,15,0,1,3,4,6417.0,1:43,0,0,0,56.0,0:0,575000
8474037,James,van Riemsdyk,1989-05-04,LW,L,2013-14,80,30,31,61,0.76,-9,279,10.75,50,101071.0,21:3,46,67,113,40.71,118,29,36,41,-5,9,6,15,15099.0,3:8,2,2,4,6997.0,1:27,4250000
8474038,Paul,Byron,1989-04-27,LW,L,2013-14,47,7,14,21,0.45,6,46,15.22,27,40729.0,14:26,7,25,32,21.88,63,10,29,13,16,2,1,3,2046.0,0:43,1,3,4,3723.0,1:19,643500
8474040,Sam,Gagner,1989-08-10,C,R,2013-14,67,10,27,37,0.55,-29,143,6.99,41,73874.0,18:22,451,512,963,46.83,33,34,28,47,-19,1,6,7,10499.0,2:36,0,1,1,1639.0,0:24,4800000
8474048,Keith,Aulie,1989-06-11,D,L,2013-14,15,0,1,1,0.07,-3,6,0.0,9,8841.0,9:49,0,0,0,0.0,17,15,0,1,-1,0,0,0,0.0,0:0,0,0,0,377.0,0:25,975000
8474052,Chris,Terry,1989-04-07,LW,L,2013-14,10,0,2,2,0.2,-4,13,0.0,0,7249.0,12:4,0,0,0,0.0,9,6,7,3,4,0,2,2,1197.0,1:59,0,0,0,0.0,0:0,537500
8474053,Logan,Couture,1989-03-28,C,L,2013-14,65,23,31,54,0.83,21,233,9.87,20,73855.0,18:56,479,471,950,50.42,16,68,39,43,-4,4,9,13,13249.0,3:23,2,2,4,5306.0,1:21,2875000
8474056,P.K.,Subban,1989-05-13,D,R,2013-14,82,10,43,53,0.65,-4,204,4.9,81,121112.0,24:36,0,0,0,0.0,135,125,26,83,-57,4,19,23,22936.0,4:39,0,0,0,3302.0,0:40,2763889
8474061,Anthony,Peluso,1989-04-18,RW,R,2013-14,53,2,3,5,0.09,-5,24,8.33,65,18364.0,5:46,1,2,3,33.33,85,3,7,2,5,0,0,0,141.0,0:2,0,0,0,0.0,0:0,562500
8474062,Riley,Nash,1989-05-09,C,R,2013-14,73,10,14,24,0.33,0,86,11.63,29,55492.0,12:40,306,360,666,45.95,81,22,54,18,36,1,2,3,3500.0,0:47,0,1,1,3315.0,0:45,575000
8474066,Thomas,Hickey,1989-02-08,D,L,2013-14,82,4,18,22,0.27,5,96,4.17,34,92836.0,18:52,0,0,0,0.0,72,132,34,57,-23,0,1,1,1362.0,0:16,0,1,1,9736.0,1:58,675000
8474068,Kyle,Turris,1989-08-14,C,R,2013-14,82,26,32,58,0.71,22,215,12.09,39,92147.0,18:43,724,705,1429,50.66,45,33,51,39,12,6,8,14,11849.0,2:24,2,1,3,8529.0,1:44,3500000
8474074,Paul,Postma,1989-02-22,D,R,2013-14,20,1,2,3,0.15,1,19,5.26,8,19357.0,16:7,0,0,0,0.0,20,29,3,17,-14,0,0,0,839.0,0:41,0,0,0,417.0,0:20,712500
8474089,Brad,Malone,1989-05-20,C,L,2013-14,32,3,2,5,0.16,-4,16,18.75,23,12994.0,6:46,45,51,96,46.88,79,5,4,7,-3,0,0,0,111.0,0:3,0,0,0,0.0,0:0,735000
8474090,Brendan,Smith,1989-02-08,D,L,2013-14,71,5,14,19,0.27,-2,90,5.56,68,78335.0,18:23,0,0,0,0.0,57,69,18,49,-31,1,0,1,721.0,0:10,0,0,0,3440.0,0:48,1262500
8474091,Brandon,Sutter,1989-02-14,C,R,2013-14,81,13,13,26,0.32,-9,144,9.03,12,76635.0,15:46,549,601,1150,47.74,69,40,29,13,16,2,3,5,5311.0,1:5,3,0,3,11236.0,2:18,2066667
8474094,Matt,Halischuk,1988-06-01,RW,R,2013-14,46,5,5,10,0.22,-3,56,8.93,6,31286.0,11:20,2,2,4,50.0,19,27,12,5,7,0,0,0,174.0,0:3,0,0,0,2699.0,0:58,650000
8474095,Dana,Tyrell,1989-04-23,C,L,2013-14,7,0,0,0,0.0,0,4,0.0,4,3879.0,9:14,2,4,6,33.33,10,3,1,1,0,0,0,0,2.0,0:0,0,0,0,504.0,1:12,600000
8474096,Nick,Spaling,1988-09-19,C,L,2013-14,71,13,19,32,0.45,2,85,15.29,14,68245.0,16:1,88,79,167,52.69,42,32,30,7,23,3,3,6,5036.0,1:10,1,0,1,6467.0,1:31,1500000
8474098,Colton,Sceviour,1989-04-20,C,R,2013-14,26,8,4,12,0.46,-3,69,11.59,4,23213.0,14:52,17,26,43,39.53,19,16,7,13,-6,2,0,2,3000.0,1:55,0,0,0,576.0,0:22,600000
8474100,Dwight,King,1989-07-05,LW,L,2013-14,77,15,15,30,0.39,16,111,13.51,18,69496.0,15:2,2,3,5,40.0,114,17,15,33,-18,0,1,1,2281.0,0:29,2,0,2,5915.0,1:16,750000
8474102,David,Perron,1988-05-28,LW,R,2013-14,78,28,29,57,0.73,-16,220,12.73,90,89508.0,19:7,13,26,39,33.33,116,20,52,42,10,8,5,13,13246.0,2:49,1,0,1,2219.0,0:28,3812500
8474125,Carl,Gunnarsson,1986-11-09,D,L,2013-14,80,3,14,17,0.21,12,48,6.25,34,93167.0,19:24,0,0,0,0.0,166,176,29,65,-36,0,1,1,1058.0,0:13,0,0,0,14105.0,2:56,3150000
8474130,Corey,Tropp,1989-07-25,RW,R,2013-14,53,2,9,11,0.21,3,35,5.71,37,28433.0,8:56,0,1,1,0.0,112,28,9,4,5,0,0,0,237.0,0:4,0,0,0,280.0,0:5,577500
8474134,Yannick,Weber,1988-09-23,D,R,2013-14,49,6,4,10,0.2,-7,70,8.57,16,35033.0,11:54,0,0,0,0.0,39,37,9,9,0,3,2,5,4612.0,1:34,0,0,0,704.0,0:14,650000
8474135,Brett,Bellemore,1988-06-25,D,R,2013-14,64,2,6,8,0.12,-1,54,3.7,45,67093.0,17:28,0,0,0,0.0,169,98,21,39,-18,0,0,0,304.0,0:4,0,0,0,7714.0,2:0,600000
8474137,Drayson,Bowman,1989-03-08,LW,L,2013-14,70,4,8,12,0.17,-2,80,5.0,16,43496.0,10:21,6,4,10,60.0,45,18,19,12,7,0,0,0,1508.0,0:21,0,0,0,1462.0,0:20,600000
8474138,Dustin,Jeffrey,1988-02-27,LW,L,2013-14,34,2,2,4,0.12,-4,30,6.67,2,19525.0,9:34,55,60,115,47.83,6,5,9,5,4,0,0,0,671.0,0:19,0,0,0,294.0,0:8,625000
8474141,Patrick,Kane,1988-11-19,RW,L,2013-14,69,29,40,69,1.0,7,227,12.78,22,81186.0,19:36,4,4,8,50.0,16,15,44,23,21,10,15,25,13687.0,3:18,0,0,0,58.0,0:0,6300000
8474145,Robert,Bortuzzo,1989-03-18,D,R,2013-14,54,0,10,10,0.19,-3,50,0.0,74,50151.0,15:28,0,1,1,0.0,137,73,6,11,-5,0,0,0,123.0,0:2,0,1,1,4251.0,1:18,600000
8474150,Mikael,Backlund,1989-03-17,C,L,2013-14,76,18,21,39,0.51,4,178,10.11,32,84521.0,18:32,628,694,1322,47.5,64,62,63,40,23,5,6,11,8484.0,1:51,4,0,4,8827.0,1:56,1500000
8474151,Ryan,McDonagh,1989-06-13,D,L,2013-14,77,14,29,43,0.56,11,177,7.91,36,114653.0,24:49,0,0,0,0.0,88,131,51,66,-15,2,11,13,13268.0,2:52,3,1,4,12579.0,2:43,4700000
8474157,Max,Pacioretty,1988-11-20,LW,L,2013-14,73,39,21,60,0.82,8,270,14.44,35,80992.0,18:29,6,4,10,60.0,69,33,28,18,10,10,7,17,13222.0,3:1,1,0,1,4618.0,1:3,4500000
8474161,Jakub,Voracek,1989-08-15,RW,L,2013-14,82,23,39,62,0.76,11,235,9.79,22,84895.0,17:15,4,2,6,66.67,19,20,33,30,3,8,15,23,16550.0,3:21,0,0,0,240.0,0:2,4250000
8474162,Jake,Muzzin,1989-02-21,D,L,2013-14,76,5,19,24,0.32,8,175,2.86,58,86779.0,19:1,0,0,0,0.0,169,82,14,57,-43,1,4,5,10988.0,2:24,0,0,0,2035.0,0:26,1000000
8474164,Jonathon,Blum,1989-01-30,D,R,2013-14,15,0,1,1,0.07,-1,11,0.0,0,10498.0,11:39,0,0,0,0.0,10,13,1,2,-1,0,0,0,257.0,0:17,0,0,0,153.0,0:10,650000
8474166,Alec,Martinez,1987-07-26,D,L,2013-14,61,11,11,22,0.36,17,79,13.92,14,57397.0,15:40,0,0,0,0.0,96,75,5,27,-22,3,5,8,7240.0,1:58,0,0,0,1529.0,0:25,1100000
8474168,Joakim,Andersson,1989-02-05,C,L,2013-14,65,8,9,17,0.26,-11,78,10.26,12,53928.0,13:49,345,326,671,51.42,26,25,18,27,-9,0,0,0,971.0,0:14,0,1,1,10222.0,2:37,732500
8474176,Carl,Hagelin,1988-08-23,LW,L,2013-14,72,17,16,33,0.46,8,144,11.81,44,67089.0,15:31,0,5,5,0.0,64,33,32,34,-2,0,0,0,893.0,0:12,1,0,1,7228.0,1:40,2250000
8474184,Keaton,Ellerby,1988-11-05,D,L,2013-14,51,2,4,6,0.12,4,33,6.06,2,42561.0,13:54,0,0,0,0.0,76,46,13,49,-36,1,0,1,285.0,0:5,0,0,0,537.0,0:10,735000
8474189,Lars,Eller,1989-05-08,C,L,2013-14,77,12,14,26,0.34,-15,137,8.76,68,73742.0,15:57,521,458,979,53.22,130,58,30,25,5,2,1,3,5122.0,1:6,1,1,2,6504.0,1:24,1150000
8474190,Wayne,Simmonds,1988-08-26,RW,R,2013-14,82,29,31,60,0.73,-4,209,13.88,106,82510.0,16:46,1,1,2,50.0,132,35,36,27,9,15,9,24,16722.0,3:23,0,0,0,199.0,0:2,3975000
8474192,Matt,Frattin,1988-01-03,RW,R,2013-14,44,2,5,7,0.16,-4,61,3.28,11,31712.0,12:0,2,2,4,50.0,85,11,6,11,-5,1,1,2,3003.0,1:8,0,0,0,45.0,0:1,875000
8474201,Pierre-Cedric,Labrie,1986-12-06,LW,L,2013-14,13,0,0,0,0.0,-4,2,0.0,20,5363.0,6:52,2,0,2,100.0,24,2,1,0,1,0,0,0,31.0,0:2,0,0,0,20.0,0:1,625000
8474207,Nick,Holden,1987-05-15,D,L,2013-14,54,10,15,25,0.46,12,66,15.15,22,60533.0,18:40,0,0,0,0.0,118,57,10,22,-12,2,5,7,5608.0,1:43,0,1,1,5044.0,1:33,600000
8474218,Jason,Demers,1988-06-09,D,R,2013-14,75,5,29,34,0.45,14,105,4.76,30,87693.0,19:29,0,0,0,0.0,69,107,40,69,-29,1,8,9,8663.0,1:55,0,1,1,6378.0,1:25,1500000
8474236,Brett,Gallant,1988-12-28,LW,L,2013-14,4,0,0,0,0.0,0,3,0.0,17,1652.0,6:53,0,0,0,0.0,9,0,0,0,0,0,0,0,0.0,0:0,0,0,0,0.0,0:0,550000
8474250,Zack,Smith,1988-04-05,LW,L,2013-14,82,13,9,22,0.27,-9,154,8.44,111,76416.0,15:31,680,611,1291,52.67,175,28,45,39,6,0,1,1,1616.0,0:19,1,1,2,7927.0,1:36,1887500
8474291,Jay,Beagle,1985-10-16,C,R,2013-14,62,4,5,9,0.15,-9,60,6.67,28,41832.0,11:14,296,277,573,51.66,93,32,18,7,11,0,0,0,346.0,0:5,0,0,0,3367.0,0:54,900000
8474497,Michael,Kostka,1985-11-28,D,R,2013-14,28,4,7,11,0.39,10,49,8.16,8,25916.0,15:25,0,0,0,0.0,26,33,4,9,-5,0,0,0,2157.0,1:17,0,0,0,256.0,0:9,625000
8474498,Jesse,Winchester,1983-10-04,C,R,2013-14,52,9,9,18,0.35,-2,100,9.0,38,39740.0,12:44,63,67,130,48.46,65,21,9,9,0,1,0,1,1087.0,0:20,0,0,0,5964.0,1:54,600000
8474519,Jack,Hillen,1986-01-24,D,L,2013-14,13,0,1,1,0.08,-4,12,0.0,4,14251.0,18:16,0,0,0,0.0,10,16,0,11,-11,0,0,0,198.0,0:15,0,0,0,1127.0,1:26,700000
8474520,Jason,Garrison,1984-11-13,D,L,2013-14,81,7,26,33,0.41,-5,181,3.87,57,101558.0,20:53,0,0,0,0.0,58,128,30,44,-14,4,11,15,13268.0,2:43,1,2,3,7227.0,1:29,4600000
8474535,Chris,Mueller,1986-03-06,C,R,2013-14,9,0,0,0,0.0,-2,8,0.0,0,4994.0,9:14,29,25,54,53.7,11,4,1,1,0,0,0,0,20.0,0:2,0,0,0,100.0,0:11,600000
8474551,Ville,Leino,1983-10-06,LW,L,2013-14,58,0,15,15,0.26,-16,38,0.0,10,50231.0,14:26,125,162,287,43.55,26,25,23,17,6,0,6,6,6221.0,1:47,0,0,0,38.0,0:0,4500000
8474563,Drew,Doughty,1989-12-08,D,R,2013-14,78,10,27,37,0.47,17,177,5.65,64,120335.0,25:42,0,0,0,0.0,180,91,16,82,-66,6,10,16,18228.0,3:53,0,1,1,12164.0,2:35,7000000
8474564,Steven,Stamkos,1990-02-07,C,R,2013-14,37,25,15,40,1.08,9,124,20.16,18,44953.0,20:14,260,269,529,49.15,50,16,24,13,11,9,4,13,8501.0,3:49,1,0,1,1259.0,0:34,7500000
8474565,Alex,Pietrangelo,1990-01-18,D,R,2013-14,81,8,43,51,0.63,20,164,4.88,32,123245.0,25:21,0,0,0,0.0,24,164,37,34,3,2,16,18,13649.0,2:48,0,1,1,16324.0,3:21,6500000
8474567,Zach,Bogosian,1990-07-15,D,R,2013-14,55,3,8,11,0.2,3,134,2.24,48,75601.0,22:54,0,0,0,0.0,94,75,17,47,-30,0,1,1,5314.0,1:36,0,0,0,7351.0,2:13,5142857
8474568,Luke,Schenn,1989-11-02,D,R,2013-14,79,4,8,12,0.15,0,78,5.13,58,78397.0,16:32,0,0,0,0.0,260,113,17,36,-19,0,0,0,124.0,0:1,0,1,1,10204.0,2:9,3600000
8474569,Colin,Wilson,1989-10-20,C,L,2013-14,81,11,22,33,0.41,-1,112,9.82,21,73950.0,15:12,166,177,343,48.4,49,35,33,27,6,2,3,5,7620.0,1:34,0,0,0,29.0,0:0,2000000
8474570,Cody,Hodgson,1990-02-18,C,R,2013-14,72,20,24,44,0.61,-26,182,10.99,20,78377.0,18:8,453,516,969,46.75,47,22,24,36,-12,9,10,19,13565.0,3:8,0,0,0,2039.0,0:28,4250000
8474571,Mikkel,Boedker,1989-12-16,LW,L,2013-14,82,19,32,51,0.62,-9,166,11.45,20,85685.0,17:24,3,4,7,42.86,105,16,33,18,15,5,11,16,10839.0,2:12,0,0,0,1208.0,0:14,2550000
8474573,Josh,Bailey,1989-10-02,RW,L,2013-14,77,8,30,38,0.49,-8,98,8.16,26,73187.0,15:50,113,115,228,49.56,44,29,39,39,0,2,8,10,8378.0,1:48,0,0,0,2118.0,0:27,3300000
8474574,Tyler,Myers,1990-02-01,D,R,2013-14,62,9,13,22,0.35,-26,99,9.09,58,81463.0,21:53,0,0,0,0.0,107,81,18,41,-23,3,6,9,9268.0,2:29,0,0,0,8966.0,2:24,5500000
8474576,Zach,Boychuk,1989-10-04,LW,L,2013-14,11,1,3,4,0.36,2,15,6.67,0,6731.0,10:11,0,1,1,0.0,17,2,4,1,3,0,0,0,602.0,0:54,0,0,0,0.0,0:0,550000
8474577,Joe,Colborne,1990-01-30,C,L,2013-14,80,10,18,28,0.35,-17,80,12.5,34,68480.0,14:16,214,227,441,48.53,129,33,30,38,-8,1,3,4,6772.0,1:24,0,0,0,1259.0,0:15,600000
8474578,Erik,Karlsson,1990-05-31,D,R,2013-14,82,20,54,74,0.9,-15,257,7.78,36,133199.0,27:4,0,0,0,0.0,122,101,68,115,-47,5,26,31,20128.0,4:5,0,0,0,7416.0,1:30,6500000
8474579,Luca,Sbisa,1990-01-30,D,L,2013-14,30,1,5,6,0.2,0,30,3.33,43,30702.0,17:3,0,0,0,0.0,83,38,7,10,-3,0,0,0,428.0,0:14,0,0,0,2105.0,1:10,2175000
8474581,Jake,Gardiner,1990-07-04,D,L,2013-14,80,10,21,31,0.39,-3,136,7.35,19,101166.0,21:4,0,0,0,0.0,108,87,33,68,-35,2,9,11,10946.0,2:16,1,0,1,2962.0,0:37,875000
8474582,Mattias,Tedenby,1990-02-21,RW,L,2013-14,15,1,0,1,0.07,-8,9,11.11,10,9021.0,10:1,0,2,2,0.0,16,2,4,1,3,0,0,0,47.0,0:3,0,0,0,32.0,0:2,600000
8474584,Michael,Del Zotto,1990-06-24,D,L,2013-14,67,3,13,16,0.24,-9,90,3.33,18,69175.0,17:12,0,1,1,0.0,78,75,15,31,-16,1,4,5,5306.0,1:19,0,0,0,1260.0,0:18,2550000
8474586,Jordan,Eberle,1990-05-15,C,R,2013-14,80,28,37,65,0.81,-11,200,14.0,18,93827.0,19:32,8,13,21,38.1,51,40,61,71,-10,7,13,20,14592.0,3:2,1,0,1,3312.0,0:41,6000000
8474589,Tyler,Ennis,1989-10-06,LW,L,2013-14,80,21,22,43,0.54,-25,210,10.0,42,90490.0,18:51,242,383,625,38.72,89,53,38,26,12,6,10,16,15632.0,3:15,0,0,0,113.0,0:1,2812500
8474590,John,Carlson,1990-01-10,D,R,2013-14,82,10,27,37,0.45,-3,208,4.81,22,120608.0,24:30,0,1,1,0.0,64,177,55,53,2,5,17,22,15476.0,3:8,0,1,1,18423.0,3:44,3966667
8474594,Slava,Voynov,1990-01-15,D,R,2013-14,82,4,30,34,0.41,6,143,2.8,44,109710.0,22:17,1,0,1,100.0,165,69,16,75,-59,1,12,13,13907.0,2:49,0,0,0,10032.0,2:2,4166666
8474597,Cody,Goloubef,1989-11-30,D,R,2013-14,5,0,0,0,0.0,0,4,0.0,2,2947.0,9:49,0,0,0,0.0,3,7,0,0,0,0,0,0,0.0,0:0,0,0,0,8.0,0:1,826875
8474598,Nicolas,Deschamps,1990-01-06,C,L,2013-14,3,0,0,0,0.0,-1,2,0.0,0,1227.0,6:49,0,0,0,0.0,1,0,0,0,0,0,0,0,0.0,0:0,0,0,0,0.0,0:0,726000
8474600,Roman,Josi,1990-06-01,D,L,2013-14,72,13,27,40,0.56,-2,168,7.74,18,114126.0,26:25,0,0,0,0.0,32,150,22,34,-12,3,10,13,13372.0,3:5,0,0,0,11052.0,2:33,4000000
8474601,Yann,Sauve,1990-02-18,D,L,2013-14,3,0,0,0,0.0,-2,1,0.0,0,2210.0,12:16,0,0,0,0.0,5,2,1,0,1,0,0,0,0.0,0:0,0,0,0,0.0,0:0,708750
8474602,Justin,Schultz,1990-07-06,D,R,2013-14,74,11,22,33,0.45,-22,109,10.09,16,103659.0,23:20,0,1,1,0.0,30,107,20,63,-43,1,11,12,15286.0,3:26,0,0,0,4332.0,0:58,925000
8474603,Eric,O'Dell,1990-06-21,C,R,2013-14,30,3,4,7,0.23,-2,17,17.65,10,17443.0,9:41,78,78,156,50.0,31,12,15,4,11,0,0,0,630.0,0:21,0,0,0,5.0,0:0,630000
8474604,Aaron,Ness,1990-05-18,D,L,2013-14,20,1,2,3,0.15,-13,23,4.35,10,17753.0,14:47,0,0,0,0.0,14,26,3,7,-4,0,0,0,358.0,0:17,0,0,0,880.0,0:44,791667
8474605,Patrick,Wiercioch,1990-09-12,D,L,2013-14,53,4,19,23,0.43,-1,97,4.12,20,52050.0,16:22,0,2,2,0.0,54,48,4,27,-23,3,9,12,8589.0,2:42,0,0,0,1008.0,0:19,2000000
8474606,Colby,Robak,1990-04-24,D,L,2013-14,16,0,2,2,0.12,-4,15,0.0,6,17830.0,18:34,0,0,0,0.0,17,19,4,4,0,0,0,0,427.0,0:26,0,1,1,2193.0,2:17,675000
8474609,Luke,Adam,1990-06-18,C,L,2013-14,12,1,0,1,0.08,0,16,6.25,4,9240.0,12:50,10,16,26,38.46,16,1,1,0,1,0,0,0,406.0,0:33,0,0,0,0.0,0:0,735000
8474610,Zac,Dalpe,1989-11-01,C,R,2013-14,55,4,3,7,0.13,-7,52,7.69,6,23529.0,7:7,106,125,231,45.89,36,9,4,2,2,1,0,1,806.0,0:14,0,0,0,85.0,0:1,550000
8474611,Cameron,Gaunce,1990-03-19,D,L,2013-14,9,0,0,0,0.0,1,9,0.0,7,7472.0,13:50,0,0,0,0.0,11,4,3,10,-7,0,0,0,39.0,0:4,0,0,0,562.0,1:2,650000
8474612,Travis,Hamonic,1990-08-16,D,R,2013-14,69,3,15,18,0.26,2,134,2.24,68,103568.0,25:0,0,0,0,0.0,93,132,40,51,-11,2,1,3,5373.0,1:17,0,0,0,12667.0,3:3,3857143
8474613,Derek,Stepan,1990-06-18,C,R,2013-14,82,17,40,57,0.7,12,199,8.54,18,88837.0,18:3,683,829,1512,45.17,30,46,50,37,13,5,13,18,13303.0,2:42,0,3,3,5746.0,1:10,3075000
8474616,Patrice,Cormier,1990-06-14,C,L,2013-14,9,0,3,3,0.33,2,4,0.0,7,3762.0,6:58,26,20,46,56.52,20,3,2,0,2,0,0,0,54.0,0:6,0,0,0,0.0,0:0,575000
8474618,Marco,Scandella,1990-02-23,D,L,2013-14,76,3,14,17,0.22,10,80,3.75,20,85780.0,18:48,0,0,0,0.0,70,102,25,35,-10,0,0,0,1192.0,0:15,0,0,0,8784.0,1:55,1025000
8474625,Jimmy,Hayes,1989-11-21,RW,R,2013-14,55,11,7,18,0.33,-5,72,15.28,18,36192.0,10:58,11,19,30,36.67,115,19,14,5,9,3,1,4,4074.0,1:14,0,0,0,14.0,0:0,654167
8474628,Michael,Stone,1990-06-07,D,R,2013-14,70,8,13,21,0.3,-10,105,7.62,38,76467.0,18:12,0,0,0,0.0,153,114,9,5,4,2,4,6,5361.0,1:16,0,1,1,6344.0,1:30,1150000
8474638,Andrew,Campbell,1988-02-04,D,L,2013-14,3,0,0,0,0.0,0,4,0.0,0,2285.0,12:41,0,0,0,0.0,3,1,0,0,0,0,0,0,0.0,0:0,0,0,0,85.0,0:28,537500
8474641,Adam,Henrique,1990-02-06,C,L,2013-14,77,25,18,43,0.56,3,137,18.25,20,83411.0,18:3,407,511,918,44.34,73,50,50,30,20,7,5,12,9772.0,2:6,3,2,5,10166.0,2:12,4000000
8474642,Lance,Bouma,1990-03-25,LW,L,2013-14,78,5,10,15,0.19,-4,82,6.1,41,59000.0,12:36,22,63,85,25.88,181,87,20,15,5,0,0,0,1071.0,0:13,1,0,1,9451.0,2:1,577500
8474646,Brandon,McMillan,1990-03-22,LW,L,2013-14,22,2,4,6,0.27,0,35,5.71,4,16612.0,12:35,7,7,14,50.0,50,7,6,2,4,0,0,0,104.0,0:4,0,0,0,1006.0,0:45,709500
8474659,Matt,Donovan,1990-05-09,D,L,2013-14,52,2,14,16,0.31,-9,86,2.33,26,56376.0,18:4,0,0,0,0.0,68,72,18,37,-19,1,5,6,5156.0,1:39,0,0,0,2455.0,0:47,875000
8474660,David,Warsofsky,1990-05-30,D,L,2013-14,6,1,1,2,0.33,1,10,10.0,0,5821.0,16:10,0,0,0,0.0,0,4,1,1,0,0,0,0,903.0,2:30,0,0,0,24.0,0:4,645833
8474668,Dale,Weise,1988-08-05,RW,R,2013-14,61,6,10,16,0.26,3,41,14.63,59,30806.0,8:25,0,4,4,0.0,103,26,17,14,3,1,0,1,296.0,0:4,0,0,0,480.0,0:7,750000
8474673,TJ,Brodie,1990-06-07,D,L,2013-14,81,4,27,31,0.38,0,104,3.85,20,116946.0,24:3,0,0,0,0.0,58,130,48,61,-13,1,6,7,8637.0,1:46,0,2,2,9557.0,1:57,2125000
8474674,James,Wright,1990-03-24,C,L,2013-14,59,0,2,2,0.03,-3,41,0.0,15,33910.0,9:34,126,143,269,46.84,63,20,22,19,3,0,0,0,101.0,0:1,0,0,0,8112.0,2:17,650000
8474679,Gustav,Nyquist,1989-09-01,RW,L,2013-14,57,28,20,48,0.84,16,153,18.3,10,57636.0,16:51,5,4,9,55.56,18,14,34,19,15,6,3,9,11091.0,3:14,0,0,0,25.0,0:0,950000
8474681,Andrei,Loktionov,1990-05-30,C,L,2013-14,68,7,15,22,0.32,-2,78,8.97,14,52984.0,12:59,154,215,369,41.73,33,15,31,11,20,2,4,6,4314.0,1:3,0,0,0,1499.0,0:22,725000
8474683,Derek,Grant,1990-04-20,C,L,2013-14,20,0,2,2,0.1,-3,31,0.0,4,11474.0,9:33,79,71,150,52.67,32,11,5,1,4,0,0,0,11.0,0:0,0,0,0,2692.0,2:14,605000
8474685,Matt,Calvert,1989-12-24,LW,L,2013-14,56,9,15,24,0.43,-1,90,10.0,53,54105.0,16:6,3,6,9,33.33,111,29,20,19,1,2,2,4,5199.0,1:32,0,0,0,5218.0,1:33,987500
8474697,Mark,Borowiecki,1989-07-12,D,L,2013-14,13,1,0,1,0.08,-2,6,16.67,48,9815.0,12:35,0,0,0,0.0,41,13,0,5,-5,0,0,0,24.0,0:1,0,0,0,1207.0,1:32,575000
8474707,Philip,Larsen,1989-12-07,D,R,2013-14,30,3,9,12,0.4,-4,47,6.38,8,30901.0,17:10,0,0,0,0.0,44,31,4,15,-11,1,4,5,4369.0,2:25,0,1,1,148.0,0:4,1025000
8474709,Matt,Martin,1989-05-08,LW,L,2013-14,79,8,6,14,0.18,-11,120,6.67,90,56401.0,11:53,3,6,9,33.33,359,42,22,15,7,0,0,0,1538.0,0:19,0,0,0,3256.0,0:41,1000000
8474715,Cam,Atkinson,1989-06-05,RW,R,2013-14,79,21,19,40,0.51,-4,216,9.72,18,74840.0,15:47,0,0,0,0.0,55,38,29,20,9,4,5,9,10529.0,2:13,1,0,1,844.0,0:10,1150000
8474716,Jared,Spurgeon,1989-11-29,D,R,2013-14,67,5,21,26,0.39,15,91,5.49,16,91017.0,22:38,0,0,0,0.0,80,107,19,21,-2,2,5,7,8531.0,2:7,0,0,0,8136.0,2:1,2666667
8474717,Mark,Barberio,1990-03-23,D,L,2013-14,49,5,5,10,0.2,10,54,9.26,28,42855.0,14:34,0,0,0,0.0,28,38,10,27,-17,1,0,1,872.0,0:17,0,0,0,1024.0,0:20,605000
8474727,Ben,Smith,1988-07-11,RW,R,2013-14,75,14,12,26,0.35,3,90,15.56,2,57319.0,12:44,200,194,394,50.76,40,58,22,12,10,1,1,2,1663.0,0:22,0,0,0,5746.0,1:16,562500
8474736,Zac,Rinaldo,1990-06-15,C,L,2013-14,67,2,2,4,0.06,-13,54,3.7,153,30944.0,7:41,2,1,3,66.67,231,12,8,4,4,0,0,0,186.0,0:2,0,0,0,1873.0,0:27,750000
8474739,Tommy,Wingels,1988-04-12,C,R,2013-14,77,16,22,38,0.49,11,163,9.82,35,74437.0,16:6,20,36,56,35.71,218,58,26,44,-18,0,5,5,5663.0,1:13,2,1,3,5857.0,1:16,775000
8474743,Zach,Redmond,1988-07-26,D,R,2013-14,10,1,2,3,0.3,1,10,10.0,0,9200.0,15:20,0,0,0,0.0,7,11,2,4,-2,0,0,0,409.0,0:40,0,0,0,34.0,0:3,715000
8474744,Sean,Collins,1988-12-29,C,L,2013-14,6,0,1,1,0.17,1,6,0.0,0,2943.0,8:10,0,0,0,0.0,9,1,2,0,2,0,0,0,16.0,0:2,0,0,0,0.0,0:0,625000
8474749,Matt,Bartkowski,1988-06-04,D,L,2013-14,64,0,18,18,0.28,22,91,0.0,30,75019.0,19:32,0,0,0,0.0,155,56,11,28,-17,0,0,0,642.0,0:10,0,0,0,6712.0,1:44,650000
8474774,Dalton,Prout,1990-03-13,D,R,2013-14,49,2,4,6,0.12,-7,56,3.57,37,50582.0,17:12,0,1,1,0.0,99,65,13,11,2,0,0,0,214.0,0:4,0,0,0,4677.0,1:35,666667
8474818,Jordie,Benn,1987-07-26,D,L,2013-14,78,3,17,20,0.26,16,91,3.3,30,89647.0,19:9,1,0,1,100.0,118,122,27,39,-12,1,1,2,2825.0,0:36,0,1,1,8030.0,1:42,700000
8474837,Mark,Cundari,1990-04-23,D,L,2013-14,4,0,0,0,0.0,-4,6,0.0,0,2587.0,10:46,0,0,0,0.0,10,4,0,3,-3,0,0,0,44.0,0:11,0,0,0,0.0,0:0,600000
8474849,Antoine,Roussel,1989-11-21,LW,L,2013-14,81,14,15,29,0.36,-1,113,12.39,209,64799.0,13:19,19,25,44,43.18,146,49,24,24,0,0,0,0,695.0,0:8,0,2,2,8143.0,1:40,612500
8474850,Brandon,Mashinter,1988-09-20,LW,L,2013-14,6,0,0,0,0.0,-1,3,0.0,10,1646.0,4:34,0,0,0,0.0,5,1,0,1,-1,0,0,0,0.0,0:0,0,0,0,0.0,0:0,605000
8474870,Tyler,Johnson,1990-07-29,C,R,2013-14,82,24,26,50,0.61,23,181,13.26,26,92420.0,18:47,614,661,1275,48.16,55,37,23,41,-18,5,5,10,12319.0,2:30,5,1,6,9980.0,2:1,756667
8474873,Brian,Lashoff,1990-07-16,D,L,2013-14,75,1,5,6,0.08,-2,38,2.63,36,64948.0,14:25,0,0,0,0.0,65,93,14,15,-1,0,0,0,55.0,0:0,0,0,0,10578.0,2:21,725000
8474884,Mike,Hoffman,1989-11-24,LW,L,2013-14,25,3,3,6,0.24,-2,61,4.92,2,19778.0,13:11,6,3,9,66.67,18,7,18,9,9,1,2,3,3469.0,2:18,0,0,0,7.0,0:0,660000
8475060,Matt,Taormina,1986-10-20,D,L,2013-14,7,0,0,0,0.0,0,6,0.0,0,5627.0,13:23,0,0,0,0.0,5,6,2,9,-7,0,0,0,1018.0,2:25,0,0,0,182.0,0:26,650000
8475098,Tyler,Bozak,1986-03-19,C,R,2013-14,58,19,30,49,0.84,2,90,21.11,14,72897.0,20:56,681,718,1399,48.68,62,42,49,24,25,5,3,8,9384.0,2:41,1,0,1,4125.0,1:11,4200000
8475119,Zach,Sill,1988-05-24,C,L,2013-14,20,0,0,0,0.0,-4,14,0.0,12,12953.0,10:47,34,56,90,37.78,57,18,4,2,2,0,0,0,117.0,0:5,0,0,0,2281.0,1:54,550000
8475147,Jordan,Schroeder,1990-09-29,LW,R,2013-14,25,3,3,6,0.24,-7,25,12.0,2,18017.0,12:0,112,132,244,45.9,20,8,7,7,0,0,1,1,1526.0,1:1,0,0,0,121.0,0:4,600000
8475148,Tim,Erixon,1991-02-24,D,L,2013-14,2,0,0,0,0.0,2,1,0.0,2,1721.0,14:20,0,0,0,0.0,1,1,0,0,0,0,0,0,62.0,0:31,0,0,0,47.0,0:23,900000
8475149,Marcus,Johansson,1990-10-06,LW,L,2013-14,80,8,36,44,0.55,-21,107,7.48,4,84184.0,17:32,95,179,274,34.67,49,27,32,49,-17,6,15,21,14410.0,3:0,0,0,0,1578.0,0:19,2000000
8475150,Jordan,Caron,1990-11-02,RW,L,2013-14,35,1,2,3,0.09,-8,52,1.92,36,22941.0,10:55,1,3,4,25.0,47,9,11,7,4,0,0,0,154.0,0:4,0,0,0,1420.0,0:40,640000
8475151,Kyle,Palmieri,1991-02-01,RW,R,2013-14,71,14,17,31,0.44,9,147,9.52,38,50874.0,11:56,9,14,23,39.13,96,31,14,17,-3,0,0,0,5535.0,1:17,0,0,0,2.0,0:0,1466667
8475153,Dylan,Olsen,1991-01-03,D,L,2013-14,44,3,9,12,0.27,-3,60,5.0,8,40753.0,15:26,0,0,0,0.0,116,55,18,15,3,0,1,1,491.0,0:11,0,0,0,3832.0,1:27,738333
8475154,Carter,Ashton,1991-04-01,RW,L,2013-14,32,0,3,3,0.09,1,23,0.0,19,12045.0,6:16,12,11,23,52.17,46,7,3,5,-2,0,0,0,60.0,0:1,0,0,0,180.0,0:5,840000
8475155,Simon,Despres,1991-07-27,D,L,2013-14,34,0,5,5,0.15,4,41,0.0,26,34154.0,16:44,0,0,0,0.0,72,46,10,15,-5,0,1,1,1557.0,0:45,0,0,0,1558.0,0:45,840000
8475157,Landon,Ferraro,1991-08-08,C,R,2013-14,4,0,0,0,0.0,0,2,0.0,2,2154.0,8:58,0,0,0,0.0,7,2,0,2,-2,0,0,0,13.0,0:3,0,0,0,304.0,1:16,685000
8475158,Ryan,O'Reilly,1991-02-07,C,L,2013-14,80,28,36,64,0.8,-1,201,13.93,2,95138.0,19:49,192,179,371,51.75,22,43,83,33,50,9,13,22,12799.0,2:39,0,0,0,5575.0,1:9,5000000
8475159,Carl,Klingberg,1991-01-28,LW,R,2013-14,3,1,0,1,0.33,2,3,33.33,0,1597.0,8:52,0,0,0,0.0,2,1,1,0,1,0,0,0,0.0,0:0,0,0,0,0.0,0:0,760000
8475160,Kyle,Clifford,1991-01-13,LW,L,2013-14,71,3,5,8,0.11,6,74,4.05,81,43286.0,10:9,6,6,12,50.0,189,13,12,16,-4,0,0,0,686.0,0:9,0,0,0,1312.0,0:18,1075000
8475161,Chris,Brown,1991-02-03,RW,R,2013-14,12,1,1,2,0.17,0,8,12.5,17,6262.0,8:41,15,25,40,37.5,22,1,2,3,-1,0,0,0,78.0,0:6,0,0,0,0.0,0:0,853333
8475163,Alex,Chiasson,1990-10-01,RW,R,2013-14,79,13,22,35,0.44,-21,144,9.03,38,71641.0,15:6,64,68,132,48.48,76,21,27,26,1,6,7,13,15921.0,3:21,0,0,0,2638.0,0:33,866667
8475164,Jakob,Silfverberg,1990-10-13,RW,R,2013-14,52,10,13,23,0.44,2,119,8.4,12,44501.0,14:15,1,11,12,8.33,31,20,17,9,8,1,0,1,4161.0,1:20,2,0,2,3249.0,1:2,863333
8475165,Anton,Lander,1991-04-24,C,L,2013-14,27,0,1,1,0.04,-10,18,0.0,4,22094.0,13:38,71,89,160,44.38,29,8,6,9,-3,0,0,0,1772.0,1:5,0,0,0,3078.0,1:54,880000
8475166,John,Tavares,1990-09-20,C,L,2013-14,59,24,42,66,1.12,-6,188,12.77,40,75196.0,21:14,554,575,1129,49.07,23,19,55,56,-1,8,17,25,14470.0,4:5,0,0,0,619.0,0:10,5500000
8475167,Victor,Hedman,1990-12-18,D,L,2013-14,75,13,42,55,0.73,5,170,7.65,53,100969.0,22:26,0,0,0,0.0,86,101,34,44,-10,3,11,14,11194.0,2:29,0,6,6,9737.0,2:9,4000000
8475168,Matt,Duchene,1991-01-16,C,L,2013-14,71,23,47,70,0.99,8,217,10.6,19,78796.0,18:29,532,526,1058,50.28,53,44,40,36,4,5,12,17,11638.0,2:43,0,0,0,1135.0,0:15,3500000
8475169,Evander,Kane,1991-08-02,LW,L,2013-14,63,19,22,41,0.65,-7,250,7.6,66,76693.0,20:17,45,60,105,42.86,173,36,28,26,2,1,4,5,8416.0,2:13,2,0,2,6960.0,1:50,5250000
8475170,Brayden,Schenn,1991-08-22,C,L,2013-14,82,20,21,41,0.5,0,178,11.24,54,77481.0,15:44,296,389,685,43.21,200,37,37,19,18,4,5,9,10758.0,2:11,0,0,0,772.0,0:9,870000
8475171,Oliver,Ekman-Larsson,1991-07-17,D,L,2013-14,80,15,29,44,0.55,-4,199,7.54,50,124297.0,25:53,0,1,1,0.0,134,80,26,36,-10,8,14,22,19646.0,4:5,0,0,0,13727.0,2:51,5500000
8475172,Nazem,Kadri,1990-10-06,C,L,2013-14,78,20,30,50,0.64,-11,148,13.51,67,81386.0,17:23,510,617,1127,45.25,141,34,44,57,-13,7,11,18,11133.0,2:22,0,0,0,697.0,0:8,2900000
8475174,Jared,Cowen,1991-01-25,D,L,2013-14,68,6,9,15,0.22,0,68,8.82,45,83690.0,20:30,0,0,0,0.0,214,99,11,45,-34,0,1,1,602.0,0:8,0,0,0,12097.0,2:57,3100000
8475175,Magnus,Paajarvi,1991-04-12,LW,L,2013-14,55,6,6,12,0.22,-6,60,10.0,6,33817.0,10:14,2,4,6,33.33,26,24,13,3,10,0,0,0,561.0,0:10,0,0,0,112.0,0:2,1200000
8475176,Ryan,Ellis,1991-01-03,D,R,2013-14,80,6,21,27,0.34,9,123,4.88,24,77123.0,16:4,0,0,0,0.0,57,97,17,42,-25,0,6,6,8411.0,1:45,0,0,0,334.0,0:4,840000
8475177,Calvin,de Haan,1991-05-09,D,L,2013-14,51,3,13,16,0.31,-7,71,4.23,30,64334.0,21:1,0,0,0,0.0,114,104,30,34,-4,1,2,3,3851.0,1:15,0,0,0,5035.0,1:38,870000
8475178,Zack,Kassian,1991-01-24,RW,R,2013-14,73,14,15,29,0.4,-4,91,15.38,124,56629.0,12:55,6,15,21,28.57,91,6,19,25,-6,1,0,1,3092.0,0:42,0,0,0,27.0,0:0,870000
8475179,Dmitry,Kulikov,1990-10-29,D,L,2013-14,81,8,11,19,0.23,-26,127,6.3,66,105429.0,21:41,0,0,0,0.0,125,92,29,47,-18,2,3,5,11619.0,2:23,1,0,1,8786.0,1:48,2500000
8475180,Peter,Holland,1991-01-14,C,L,2013-14,43,6,5,11,0.26,0,43,13.95,18,29279.0,11:20,182,213,395,46.08,46,22,25,12,13,1,0,1,582.0,0:13,0,0,0,27.0,0:0,870000
8475181,Nick,Leddy,1991-03-20,D,L,2013-14,82,7,24,31,0.38,10,123,5.69,10,80542.0,16:22,0,0,0,0.0,52,45,12,35,-23,4,6,10,9883.0,2:0,0,0,0,167.0,0:2,2700000
8475182,David,Rundblad,1990-10-08,D,R,2013-14,17,0,1,1,0.06,-4,21,0.0,6,14027.0,13:45,0,0,0,0.0,18,14,3,5,-2,0,1,1,1384.0,1:21,0,0,0,36.0,0:2,785000
8475183,Louis,Leblanc,1991-01-26,C,R,2013-14,8,0,0,0,0.0,1,7,0.0,4,4738.0,9:52,2,2,4,50.0,3,7,0,1,-1,0,0,0,78.0,0:9,0,0,0,0.0,0:0,870000
8475184,Chris,Kreider,1991-04-30,LW,L,2013-14,66,17,20,37,0.56,14,136,12.5,72,62286.0,15:43,8,11,19,42.11,146,18,21,25,-4,6,6,12,8628.0,2:10,0,0,0,102.0,0:1,800000
8475185,Jacob,Josefson,1991-03-02,C,L,2013-14,27,1,2,3,0.11,0,21,4.76,4,16415.0,10:7,83,85,168,49.4,15,4,10,5,5,0,0,0,89.0,0:3,1,0,1,1993.0,1:13,725000
8475186,John,Moore,1990-11-19,D,L,2013-14,74,4,11,15,0.2,7,115,3.48,25,68059.0,15:19,0,0,0,0.0,59,57,4,27,-23,0,2,2,4822.0,1:5,0,0,0,599.0,0:8,840000
8475188,Brayden,McNabb,1991-01-21,D,L,2013-14,12,0,0,0,0.0,1,10,0.0,6,12404.0,17:13,0,0,0,0.0,25,12,2,5,-3,0,0,0,1392.0,1:56,0,0,0,710.0,0:59,715000
8475190,Jamie,Devane,1991-02-20,LW,L,2013-14,2,0,0,0,0.0,-1,1,0.0,0,703.0,5:51,0,0,0,0.0,2,0,0,0,0,0,0,0,0.0,0:0,0,0,0,0.0,0:0,576667
8475191,Reilly,Smith,1991-04-01,RW,L,2013-14,82,20,31,51,0.62,28,146,13.7,14,72355.0,14:42,0,2,2,0.0,63,14,35,41,-6,6,8,14,8059.0,1:38,0,0,0,39.0,0:0,900000
8475192,Taylor,Beck,1991-05-13,LW,R,2013-14,7,0,0,0,0.0,-2,9,0.0,6,5393.0,12:50,0,0,0,0.0,4,5,0,2,-2,0,0,0,383.0,0:54,0,0,0,28.0,0:4,660000
8475193,Tomas,Tatar,1990-12-01,LW,L,2013-14,73,19,20,39,0.53,12,158,12.03,30,62856.0,14:21,26,26,52,50.0,81,20,41,19,22,2,4,6,10051.0,2:17,0,0,0,0.0,0:0,630000
8475194,Philip,Samuelsson,1991-07-26,D,L,2013-14,5,0,0,0,0.0,-1,5,0.0,0,4672.0,15:34,0,0,0,0.0,5,7,2,4,-2,0,0,0,17.0,0:3,0,0,0,297.0,0:59,623333
8475196,Ben,Hanowski,1990-10-18,RW,L,2013-14,11,0,2,2,0.18,-2,10,0.0,2,4783.0,7:14,1,0,1,100.0,13,1,2,3,-1,0,0,0,74.0,0:6,0,0,0,10.0,0:0,900000
8475197,Tyson,Barrie,1991-07-26,D,R,2013-14,64,13,25,38,0.59,17,101,12.87,20,71201.0,18:32,0,0,0,0.0,50,57,26,27,-1,4,6,10,10731.0,2:47,0,0,0,337.0,0:5,715000
8475199,Eric,Gelinas,1991-05-08,D,L,2013-14,60,7,22,29,0.48,-3,124,5.65,22,60926.0,16:55,0,0,0,0.0,99,20,12,26,-14,5,12,17,8743.0,2:25,0,0,0,351.0,0:5,660000
8475200,Dmitry,Orlov,1991-07-23,D,L,2013-14,54,3,8,11,0.2,-1,59,5.08,19,63497.0,19:35,0,0,0,0.0,75,62,28,28,0,0,1,1,747.0,0:13,0,0,0,1194.0,0:22,690000
8475204,Brandon,Pirri,1991-04-10,RW,L,2013-14,49,13,12,25,0.51,6,80,16.25,8,38150.0,12:58,204,250,454,44.93,24,15,16,7,9,3,3,6,4343.0,1:28,0,0,0,0.0,0:0,618333
8475206,Stefan,Elliott,1991-01-30,D,R,2013-14,1,1,0,1,1.0,0,1,100.0,0,1011.0,16:51,0,0,0,0.0,2,0,0,0,0,0,0,0,55.0,0:55,0,0,0,8.0,0:8,843333
8475208,Brian,Dumoulin,1991-09-06,D,L,2013-14,6,0,1,1,0.17,1,3,0.0,4,6924.0,19:14,0,0,0,0.0,1,8,1,4,-3,0,0,0,900.0,2:30,0,0,0,460.0,1:16,831667
8475209,Richard,Panik,1991-02-07,RW,L,2013-14,50,3,10,13,0.26,-9,56,5.36,21,38077.0,12:41,3,5,8,37.5,70,16,16,23,-7,0,4,4,3923.0,1:18,0,0,0,207.0,0:4,740000
8475213,Drew,Shore,1991-01-29,C,R,2013-14,24,5,2,7,0.29,-1,23,21.74,8,17272.0,11:59,86,122,208,41.35,23,5,6,4,2,1,0,1,1129.0,0:47,1,0,1,2706.0,1:52,900000
8475214,Jeremy,Morin,1991-04-16,LW,R,2013-14,24,5,6,11,0.46,5,46,10.87,32,13197.0,9:9,4,2,6,66.67,20,2,9,0,9,0,0,0,458.0,0:19,0,0,0,0.0,0:0,735000
8475218,Mattias,Ekholm,1990-05-24,D,L,2013-14,62,1,8,9,0.15,-8,58,1.72,10,62558.0,16:49,0,0,0,0.0,42,55,19,33,-14,0,0,0,759.0,0:12,0,1,1,4938.0,1:19,900000
8475220,Marcus,Foligno,1991-08-10,LW,L,2013-14,74,7,12,19,0.26,-17,79,8.86,82,66877.0,15:3,146,155,301,48.5,206,43,36,19,17,0,1,1,4912.0,1:6,1,0,1,4973.0,1:7,826667
8475222,Sami,Vatanen,1991-06-03,D,R,2013-14,48,6,15,21,0.44,9,73,8.22,22,50260.0,17:27,0,0,0,0.0,66,47,15,22,-7,2,5,7,6939.0,2:24,0,0,0,563.0,0:11,785000
8475223,Linden,Vey,1991-07-17,RW,R,2013-14,18,0,5,5,0.28,0,8,0.0,0,13104.0,12:8,55,69,124,44.35,2,1,7,7,0,0,1,1,1579.0,1:27,0,1,1,1007.0,0:55,790000
8475224,Jordan,Szwarz,1991-05-14,RW,R,2013-14,26,3,0,3,0.12,-6,25,12.0,19,13489.0,8:38,1,2,3,33.33,23,7,7,1,6,0,0,0,32.0,0:1,0,0,0,1656.0,1:3,613353
8475225,Craig,Smith,1989-09-05,RW,R,2013-14,79,24,28,52,0.66,16,215,11.16,22,77733.0,16:23,3,16,19,15.79,54,21,50,49,1,7,3,10,9732.0,2:3,0,0,0,102.0,0:1,2000000
8475231,Casey,Cizikas,1991-02-27,C,L,2013-14,80,6,10,16,0.2,-12,79,7.59,30,64193.0,13:22,489,522,1011,48.37,128,48,33,18,15,1,1,2,1055.0,0:13,0,2,2,11677.0,2:25,793333
8475233,David,Savard,1990-10-22,D,R,2013-14,70,5,10,15,0.21,2,63,7.94,28,74881.0,17:49,1,0,1,100.0,149,81,12,9,3,1,3,4,2451.0,0:35,0,0,0,5647.0,1:20,709275
8475235,Nicolas,Deslauriers,1991-02-22,LW,L,2013-14,17,1,0,1,0.06,-10,30,3.33,18,13405.0,13:8,0,1,1,0.0,51,3,2,1,1,0,0,0,1783.0,1:44,0,0,0,34.0,0:2,608333
8475236,Cody,Eakin,1991-05-24,C,L,2013-14,81,16,19,35,0.43,-9,161,9.94,36,84231.0,17:19,585,638,1223,47.83,91,58,57,33,24,3,3,6,9963.0,2:3,1,0,1,7660.0,1:34,571667
8475246,Kevin,Connauton,1990-02-23,D,L,2013-14,36,1,7,8,0.22,-6,56,1.79,16,33114.0,15:19,0,0,0,0.0,43,29,9,22,-13,0,2,2,1456.0,0:40,0,0,0,430.0,0:11,683333
8475247,Michael,Latta,1991-05-25,C,R,2013-14,17,1,3,4,0.24,0,6,16.67,12,7865.0,7:42,60,55,115,52.17,14,2,3,2,1,0,0,0,87.0,0:5,0,0,0,1050.0,1:1,586667
8475248,Alexander,Urbom,1990-12-20,D,L,2013-14,20,1,1,2,0.1,1,16,6.25,19,17527.0,14:36,0,0,0,0.0,25,13,5,10,-5,0,0,0,33.0,0:1,0,1,1,2308.0,1:55,563333
8475253,Garrett,Wilson,1991-03-16,LW,L,2013-14,3,0,0,0,0.0,-1,4,0.0,0,1860.0,10:20,0,0,0,0.0,11,2,0,0,0,0,0,0,64.0,0:21,0,0,0,0.0,0:0,683333
8475254,Gabriel,Dumont,1990-10-06,C,R,2013-14,2,0,0,0,0.0,0,1,0.0,0,820.0,6:50,3,5,8,37.5,3,0,1,1,0,0,0,0,0.0,0:0,0,0,0,34.0,0:17,562500
8475260,Corban,Knight,1990-09-10,C,R,2013-14,7,1,0,1,0.14,-1,4,25.0,0,3333.0,7:56,24,27,51,47.06,9,4,1,0,1,0,0,0,118.0,0:16,0,0,0,0.0,0:0,900000
8475264,Roman,Horak,1991-05-21,C,L,2013-14,3,1,0,1,0.33,-1,2,50.0,0,1695.0,9:25,4,2,6,66.67,0,4,0,0,0,0,0,0,126.0,0:42,0,0,0,0.0,0:0,613333
8475268,Gabriel,Bourque,1990-09-23,LW,L,2013-14,74,9,17,26,0.35,-5,108,8.33,8,61441.0,13:50,0,1,1,0.0,70,34,20,21,-1,0,1,1,1922.0,0:25,0,0,0,3601.0,0:48,775000
8475275,Patrick,Wey,1991-03-21,D,R,2013-14,9,0,3,3,0.33,0,5,0.0,5,7876.0,14:35,0,0,0,0.0,11,4,1,7,-6,0,0,0,0.0,0:0,0,0,0,688.0,1:16,640000
8475283,Lane,MacDermid,1989-08-25,LW,L,2013-14,7,0,2,2,0.29,1,1,0.0,12,2340.0,5:34,1,1,2,50.0,10,3,0,0,0,0,0,0,3.0,0:0,0,0,0,0.0,0:0,660000
8475287,Erik,Haula,1991-03-23,LW,L,2013-14,46,6,9,15,0.33,14,56,10.71,29,28004.0,10:8,161,187,348,46.26,23,17,8,5,3,0,0,0,288.0,0:6,1,0,1,3062.0,1:6,900000
8475309,Jerry,D'Amigo,1991-02-19,RW,L,2013-14,22,1,2,3,0.14,-1,12,8.33,0,10621.0,8:2,1,3,4,25.0,23,4,6,3,3,0,0,0,0.0,0:0,0,0,0,1384.0,1:2,870000
8475314,Anders,Lee,1990-07-03,LW,L,2013-14,22,9,5,14,0.64,3,68,13.24,14,20754.0,15:43,1,5,6,16.67,48,2,9,8,1,2,0,2,3565.0,2:42,0,0,0,53.0,0:2,900000
8475321,Phil,Varone,1990-12-04,C,L,2013-14,9,1,1,2,0.22,-3,15,6.67,4,6160.0,11:24,26,30,56,46.43,7,2,0,1,-1,0,0,0,40.0,0:4,0,0,0,0.0,0:0,586667
8475323,Marcus,Kruger,1990-05-27,C,L,2013-14,81,8,20,28,0.35,6,96,8.33,36,67430.0,13:52,438,335,773,56.66,22,70,27,18,9,0,0,0,552.0,0:6,0,1,1,12411.0,2:33,1287500
8475325,Jordan,Nolan,1989-06-23,C,L,2013-14,64,6,4,10,0.16,-1,58,10.34,54,34561.0,9:0,1,3,4,25.0,100,11,5,16,-11,0,0,0,265.0,0:4,0,0,0,122.0,0:1,700000
8475332,Adam,Almquist,1991-02-27,D,L,2013-14,2,1,0,1,0.5,-1,2,50.0,0,2066.0,17:13,0,0,0,0.0,1,0,0,0,0,0,0,0,148.0,1:14,0,0,0,27.0,0:13,666667
8475414,Craig,Cunningham,1990-09-13,LW,R,2013-14,2,0,0,0,0.0,0,4,0.0,0,1138.0,9:29,3,4,7,42.86,1,0,0,0,0,0,0,0,30.0,0:15,0,0,0,35.0,0:17,615000
8475423,Darren,Archibald,1990-02-09,RW,L,2013-14,16,1,2,3,0.19,1,11,9.09,0,7485.0,7:47,0,1,1,0.0,30,9,2,1,1,0,0,0,25.0,0:1,0,0,0,16.0,0:1,660000
8475455,Brenden,Dillon,1990-11-13,D,L,2013-14,80,6,11,17,0.21,9,97,6.19,86,101248.0,21:5,0,0,0,0.0,168,149,15,52,-37,0,0,0,584.0,0:7,2,0,2,11470.0,2:23,743333
8475462,Radko,Gudas,1990-06-05,D,R,2013-14,73,3,19,22,0.3,2,114,2.63,152,83776.0,19:7,0,0,0,0.0,273,138,13,36,-23,1,3,4,3421.0,0:46,0,0,0,7550.0,1:43,991667
8475567,Julien,Brouillette,1986-12-05,D,L,2013-14,10,1,1,2,0.2,3,4,25.0,0,9331.0,15:33,0,0,0,0.0,10,11,1,5,-4,0,0,0,22.0,0:2,0,0,0,280.0,0:28,550000
8475598,Ryan,Stanton,1989-07-20,D,L,2013-14,64,1,15,16,0.25,5,65,1.54,32,56494.0,14:42,1,0,1,100.0,97,81,20,21,-1,0,0,0,271.0,0:4,0,0,0,1945.0,0:30,550000
8475602,Casey,Wellman,1987-10-18,C,R,2013-14,13,2,1,3,0.23,3,15,13.33,0,7312.0,9:22,50,47,97,51.55,9,5,3,3,0,0,0,0,50.0,0:3,0,0,0,3.0,0:0,550000
8475613,Nate,Prosser,1986-05-07,D,R,2013-14,53,2,6,8,0.15,2,30,6.67,58,46195.0,14:31,0,0,0,0.0,22,83,17,7,10,0,1,1,63.0,0:1,0,1,1,5143.0,1:37,825000
8475619,Aaron,Volpatti,1985-05-30,LW,L,2013-14,41,2,0,2,0.05,-3,18,11.11,49,18112.0,7:21,4,8,12,33.33,77,10,6,1,5,0,0,0,49.0,0:1,0,0,0,15.0,0:0,575000
8475625,Matt,Irwin,1987-11-29,D,L,2013-14,62,2,17,19,0.31,5,147,1.36,35,69990.0,18:48,0,1,1,0.0,62,93,15,44,-29,1,5,6,7498.0,2:0,0,0,0,677.0,0:10,1000000
8475637,Bobby,Butler,1987-04-26,RW,R,2013-14,2,0,1,1,0.5,1,5,0.0,2,1660.0,13:50,0,0,0,0.0,2,0,2,0,2,0,0,0,100.0,0:50,0,0,0,0.0,0:0,600000
8475648,Chris,Breen,1989-06-29,D,L,2013-14,9,0,2,2,0.22,1,4,0.0,5,5068.0,9:23,0,0,0,0.0,3,7,0,5,-5,0,0,0,0.0,0:0,0,0,0,240.0,0:26,577500
8475650,Brandon,Bollig,1987-01-31,LW,L,2013-14,82,7,7,14,0.17,-1,109,6.42,92,50555.0,10:16,1,0,1,100.0,203,22,5,6,-1,0,0,0,210.0,0:2,0,0,0,1094.0,0:13,575000
8475671,Matt,Fraser,1990-05-20,RW,L,2013-14,14,2,0,2,0.14,0,13,15.38,10,8107.0,9:39,1,1,2,50.0,10,5,1,0,1,0,0,0,162.0,0:11,0,0,0,0.0,0:0,625000
8475690,Christopher,Tanev,1989-12-20,D,R,2013-14,64,6,11,17,0.27,12,65,9.23,8,79629.0,20:44,0,0,0,0.0,25,136,17,18,-1,0,0,0,812.0,0:12,1,0,1,11551.0,3:0,1500000
8475692,Mats,Zuccarello,1987-09-01,RW,L,2013-14,77,19,40,59,0.77,11,170,11.18,32,79185.0,17:8,3,5,8,37.5,116,41,44,38,6,4,13,17,12085.0,2:36,1,0,1,2612.0,0:33,1150000
8475714,Calle,Jarnkrok,1991-09-25,C,R,2013-14,12,2,7,9,0.75,7,13,15.38,4,10129.0,14:4,58,89,147,39.46,2,4,2,2,0,0,1,1,1008.0,1:24,0,0,0,68.0,0:5,715000
8475716,Martin,Marincin,1992-02-18,D,L,2013-14,44,0,6,6,0.14,-2,28,0.0,16,50590.0,19:9,0,0,0,0.0,17,60,17,33,-16,0,1,1,1319.0,0:29,0,1,1,6175.0,2:20,730000
8475722,Jason,Zucker,1992-01-16,LW,L,2013-14,21,4,1,5,0.24,2,40,10.0,2,16364.0,12:59,0,0,0,0.0,16,11,9,9,0,1,1,2,1044.0,0:49,0,0,0,149.0,0:7,771667
8475726,Tyler,Toffoli,1992-04-24,C,R,2013-14,62,12,17,29,0.47,21,124,9.68,10,48129.0,12:56,2,7,9,22.22,57,8,23,25,-2,1,3,4,5868.0,1:34,0,0,0,308.0,0:4,716667
8475727,Ryan,Spooner,1992-01-30,C,L,2013-14,23,0,11,11,0.48,0,42,0.0,6,17678.0,12:48,59,86,145,40.69,10,6,8,3,5,0,6,6,2509.0,1:49,0,0,0,592.0,0:25,760000
8475728,Johan,Larsson,1992-07-25,C,L,2013-14,28,0,4,4,0.14,0,21,0.0,19,22601.0,13:27,135,150,285,47.37,52,19,9,3,6,0,0,0,336.0,0:12,0,0,0,1813.0,1:4,763333
8475733,Max,Reinhart,1992-02-04,C,L,2013-14,8,0,2,2,0.25,1,7,0.0,2,5137.0,10:42,2,7,9,22.22,1,0,3,1,2,0,0,0,258.0,0:32,0,0,0,64.0,0:8,618333
8475735,Greg,McKegg,1992-06-17,C,L,2013-14,1,0,0,0,0.0,0,1,0.0,0,223.0,3:43,1,5,6,16.67,2,0,0,0,0,0,0,0,0.0,0:0,0,0,0,0.0,0:0,660000
8475739,Michael,Bournival,1992-05-31,LW,L,2013-14,60,7,7,14,0.23,-6,78,8.97,18,37147.0,10:19,28,33,61,45.9,67,42,15,10,5,1,2,3,941.0,0:15,0,0,0,2329.0,0:38,660000
8475744,Evgeny,Kuznetsov,1992-05-19,C,L,2013-14,17,3,6,9,0.53,-2,22,13.64,6,13743.0,13:28,5,22,27,18.52,7,2,3,7,-4,0,2,2,1061.0,1:2,1,0,1,21.0,0:1,900000
8475745,Charlie,Coyle,1992-03-02,C,R,2013-14,70,12,18,30,0.43,-7,135,8.89,33,71783.0,17:5,192,266,458,41.92,108,37,32,28,4,2,1,3,9434.0,2:14,0,0,0,621.0,0:8,900000
8475747,Patrik,Nemeth,1992-02-08,D,L,2013-14,8,0,0,0,0.0,-3,3,0.0,6,6608.0,13:46,0,0,0,0.0,16,11,1,5,-4,0,0,0,0.0,0:0,0,0,0,359.0,0:44,763333
8475749,Christian,Thomas,1992-05-26,LW,R,2013-14,2,0,0,0,0.0,-1,1,0.0,0,862.0,7:11,0,0,0,0.0,1,1,1,0,1,0,0,0,0.0,0:0,0,0,0,0.0,0:0,808333
8475750,Jon,Merrill,1992-02-03,D,L,2013-14,52,2,9,11,0.21,-3,45,4.44,12,59986.0,19:13,0,0,0,0.0,27,41,9,11,-2,0,2,2,4622.0,1:28,0,0,0,2083.0,0:40,840000
8475752,Tyler,Pitlick,1991-11-01,C,R,2013-14,10,1,0,1,0.1,-2,9,11.11,0,5383.0,8:58,1,2,3,33.33,26,4,2,1,1,0,0,0,15.0,0:1,0,0,0,30.0,0:3,888333
8475753,Justin,Faulk,1992-03-20,D,R,2013-14,76,5,27,32,0.42,-9,152,3.29,37,106757.0,23:24,0,0,0,0.0,94,102,41,47,-6,2,6,8,9657.0,2:7,0,1,1,11061.0,2:25,840000
8475754,Brock,Nelson,1991-10-15,C,L,2013-14,72,14,12,26,0.36,-10,132,10.61,12,61613.0,14:15,191,260,451,42.35,74,38,32,23,9,3,4,7,8010.0,1:51,0,0,0,3645.0,0:50,900000
8475755,Alex,Petrovic,1992-03-03,D,R,2013-14,7,0,1,1,0.14,3,4,0.0,8,5139.0,12:14,0,0,0,0.0,24,5,0,0,0,0,0,0,0.0,0:0,0,0,0,242.0,0:34,795000
8475757,Brett,Bulmer,1992-04-26,RW,R,2013-14,5,0,0,0,0.0,-2,7,0.0,2,3207.0,10:41,0,0,0,0.0,14,2,1,0,1,0,0,0,4.0,0:0,0,0,0,0.0,0:0,780000
8475758,Devante,Smith-Pelly,1992-06-14,RW,R,2013-14,19,2,8,10,0.53,5,23,8.7,2,14413.0,12:38,0,4,4,0.0,50,13,2,7,-5,0,0,0,769.0,0:40,0,0,0,242.0,0:12,720000
8475759,Brandon,Gormley,1992-02-18,D,L,2013-14,5,0,0,0,0.0,4,4,0.0,2,4363.0,14:32,0,0,0,0.0,5,8,1,1,0,0,0,0,99.0,0:19,0,0,0,143.0,0:28,840000
8475760,Nick,Bjugstad,1992-07-17,C,R,2013-14,76,16,22,38,0.5,-14,185,8.65,16,73959.0,16:13,549,574,1123,48.89,117,23,37,28,9,0,3,3,9768.0,2:8,1,1,2,1580.0,0:20,900000
8475761,Beau,Bennett,1991-11-27,RW,R,2013-14,21,3,4,7,0.33,-2,27,11.11,0,17444.0,13:50,2,0,2,100.0,32,7,2,4,-2,0,0,0,1623.0,1:17,0,0,0,2.0,0:0,900000
8475764,Cam,Fowler,1991-12-05,D,L,2013-14,70,6,30,36,0.51,15,100,6.0,14,100224.0,23:51,0,0,0,0.0,46,122,24,36,-12,4,11,15,14232.0,3:23,1,0,1,11296.0,2:41,4000000
8475765,Vladimir,Tarasenko,1991-12-13,RW,L,2013-14,64,21,22,43,0.67,20,136,15.44,16,58266.0,15:10,2,4,6,33.33,22,9,32,20,12,5,2,7,6453.0,1:40,0,0,0,1892.0,0:29,900000
8475768,Jaden,Schwartz,1992-06-25,LW,L,2013-14,80,25,31,56,0.7,28,188,13.3,27,84134.0,17:31,44,34,78,56.41,54,32,66,15,51,5,5,10,8505.0,1:46,3,0,3,7386.0,1:32,830000
8475769,Quinton,Howden,1992-01-21,C,L,2013-14,16,4,2,6,0.38,0,23,17.39,10,13170.0,13:43,2,6,8,25.0,32,11,9,0,9,0,0,0,52.0,0:3,1,0,1,1814.0,1:53,870000
8475770,Emerson,Etem,1992-06-16,RW,L,2013-14,29,7,4,11,0.38,3,44,15.91,4,22246.0,12:47,0,1,1,0.0,50,13,8,7,1,1,0,1,1137.0,0:39,1,0,1,1742.0,1:0,870000
8475772,Riley,Sheahan,1991-12-07,C,L,2013-14,42,9,15,24,0.57,8,59,15.25,6,36413.0,14:26,251,261,512,49.02,25,16,17,9,8,2,3,5,5326.0,2:6,0,0,0,25.0,0:0,785000
8475775,Tye,McGinn,1990-07-29,LW,L,2013-14,18,4,1,5,0.28,-1,16,25.0,4,12074.0,11:10,0,0,0,0.0,26,7,4,6,-2,0,0,0,831.0,0:46,0,0,0,9.0,0:0,775000
8475784,Jeff,Skinner,1992-05-16,LW,L,2013-14,71,33,21,54,0.76,-14,274,12.04,22,73246.0,17:11,23,28,51,45.1,22,8,48,43,5,11,9,20,13169.0,3:5,0,0,0,140.0,0:1,5725000
8475790,Erik,Gudbranson,1992-01-07,D,R,2013-14,65,3,6,9,0.14,-7,92,3.26,114,70126.0,17:58,0,0,0,0.0,158,91,14,19,-5,0,1,1,3349.0,0:51,0,0,0,7575.0,1:56,900000
8475791,Taylor,Hall,1991-11-14,LW,L,2013-14,75,27,53,80,1.07,-15,250,10.8,44,90062.0,20:0,37,44,81,45.68,54,41,76,100,-24,7,10,17,14295.0,3:10,0,1,1,1684.0,0:22,6000000
8475792,Brett,Connolly,1992-05-02,RW,R,2013-14,11,1,0,1,0.09,-5,12,8.33,4,7932.0,12:1,25,27,52,48.08,9,1,3,1,2,0,0,0,768.0,1:9,0,0,0,0.0,0:0,900000
8475793,Ryan,Johansen,1992-07-31,C,R,2013-14,82,33,30,63,0.77,3,237,13.92,43,86821.0,17:38,692,619,1311,52.78,114,39,39,40,-1,7,13,20,12979.0,2:38,0,0,0,3524.0,0:42,870000
8475794,Tyler,Seguin,1992-01-31,C,R,2013-14,80,37,47,84,1.05,16,294,12.59,18,92869.0,19:20,281,396,677,41.51,48,24,67,60,7,11,14,25,18063.0,3:45,0,0,0,255.0,0:3,5750000
8475796,Mark,Pysyk,1992-01-11,D,R,2013-14,44,1,6,7,0.16,-11,51,1.96,16,51802.0,19:37,0,0,0,0.0,37,57,12,19,-7,0,2,2,3201.0,1:12,0,0,0,5759.0,2:10,900000
8475797,Jarred,Tinordi,1992-02-20,D,L,2013-14,22,0,2,2,0.09,-2,10,0.0,40,19181.0,14:31,0,0,0,0.0,42,27,0,12,-12,0,0,0,146.0,0:6,0,0,0,2910.0,2:12,870000
8475798,Mikael,Granlund,1992-02-26,RW,L,2013-14,63,8,33,41,0.65,-3,104,7.69,22,65488.0,17:19,415,374,789,52.6,38,46,27,24,3,2,10,12,9579.0,2:32,0,0,0,1784.0,0:28,900000
8475799,Nino,Niederreiter,1992-09-08,RW,L,2013-14,81,14,22,36,0.44,12,143,9.79,44,68501.0,14:5,7,19,26,26.92,175,23,37,24,13,2,4,6,6624.0,1:21,0,0,0,35.0,0:0,870000
8475800,Teemu,Pulkkinen,1992-01-02,LW,R,2013-14,3,0,0,0,0.0,0,4,0.0,2,1344.0,7:28,0,0,0,0.0,2,0,0,0,0,0,0,0,386.0,2:8,0,0,0,0.0,0:0,698333
8475807,Joakim,Nordstrom,1992-02-25,LW,L,2013-14,16,1,2,3,0.19,-2,26,3.85,2,11218.0,11:41,10,17,27,37.04,17,7,9,2,7,0,0,0,73.0,0:4,0,0,0,1026.0,1:4,616667
8475808,Michael,Chaput,1992-04-09,C,L,2013-14,17,0,1,1,0.06,0,6,0.0,2,9072.0,8:53,42,56,98,42.86,34,10,5,1,4,0,0,0,59.0,0:3,0,0,0,139.0,0:8,706667
8475844,Kenny,Agostino,1992-04-30,LW,L,2013-14,8,1,1,2,0.25,-2,12,8.33,0,5324.0,11:5,0,0,0,0.0,9,3,3,3,0,0,0,0,131.0,0:16,0,0,0,0.0,0:0,845000
8475845,Justin,Florek,1990-05-18,LW,L,2013-14,4,1,1,2,0.5,1,5,20.0,0,2843.0,11:50,0,1,1,0.0,4,0,2,0,2,0,0,0,39.0,0:9,0,0,0,188.0,0:47,690000
8475848,Brendan,Gallagher,1992-05-06,RW,R,2013-14,81,19,22,41,0.51,4,211,9.0,73,77587.0,15:57,47,81,128,36.72,38,36,41,22,19,8,1,9,11853.0,2:26,0,0,0,390.0,0:4,685000
8475855,Jesper,Fast,1991-12-02,RW,R,2013-14,11,0,0,0,0.0,-5,7,0.0,2,7451.0,11:17,0,0,0,0.0,20,7,1,1,0,0,0,0,173.0,0:15,0,0,0,968.0,1:28,805000
8475878,Freddie,Hamilton,1992-01-01,C,R,2013-14,11,0,0,0,0.0,-5,13,0.0,2,6813.0,10:19,14,22,36,38.89,24,3,3,1,2,0,0,0,62.0,0:5,0,0,0,37.0,0:3,626667
8475889,Patrick,Holland,1992-01-07,RW,R,2013-14,5,0,0,0,0.0,0,2,0.0,0,2289.0,7:37,1,1,2,50.0,2,4,0,0,0,0,0,0,2.0,0:0,0,0,0,284.0,0:56,640000
8475902,Zach,Trotman,1990-08-26,D,R,2013-14,2,0,0,0,0.0,0,4,0.0,0,1800.0,15:0,0,0,0,0.0,2,0,0,1,-1,0,0,0,200.0,1:40,0,0,0,0.0,0:0,665000
8475913,Mark,Stone,1992-05-13,RW,R,2013-14,19,4,4,8,0.42,5,36,11.11,4,16502.0,14:28,1,0,1,100.0,10,7,18,6,12,1,0,1,1654.0,1:27,0,0,0,259.0,0:13,603333
8475917,Jason,Akeson,1990-06-03,RW,R,2013-14,1,0,1,1,1.0,1,2,0.0,0,802.0,13:22,0,0,0,0.0,1,0,0,0,0,0,0,0,34.0,0:34,0,0,0,32.0,0:32,715000
8476043,Ben,Street,1987-02-13,C,L,2013-14,13,0,1,1,0.08,-2,17,0.0,4,8262.0,10:35,63,74,137,45.99,14,6,5,3,2,0,0,0,402.0,0:30,0,0,0,898.0,1:9,575000
8476062,Mark,Arcobello,1988-08-12,RW,R,2013-14,41,4,14,18,0.44,-7,70,5.71,8,37081.0,15:4,206,198,404,50.99,78,23,18,13,5,1,2,3,2787.0,1:7,0,0,0,4054.0,1:38,600000
8476116,Ryan,Garbutt,1985-08-12,C,L,2013-14,75,17,15,32,0.43,10,165,10.3,106,58790.0,13:3,4,6,10,40.0,141,47,42,21,21,0,0,0,439.0,0:5,2,0,2,6148.0,1:21,575000
8476158,Harry,Zolnierczyk,1987-09-01,LW,L,2013-14,13,2,0,2,0.15,0,12,16.67,12,7900.0,10:7,2,0,2,100.0,14,5,3,4,-1,0,0,0,0.0,0:0,0,0,0,0.0,0:0,550000
8476162,Steve,Oleksy,1986-02-04,D,R,2013-14,33,2,8,10,0.3,7,27,7.41,53,30226.0,15:15,0,0,0,0.0,46,48,8,12,-4,0,0,0,40.0,0:1,0,0,0,3591.0,1:48,541667
8476166,Taylor,Fedun,1988-06-04,D,R,2013-14,4,2,0,2,0.5,-1,6,33.33,0,2930.0,12:12,0,0,0,0.0,1,3,1,1,0,0,0,0,0.0,0:0,0,0,0,298.0,1:14,675000
8476177,Matt,Read,1986-06-14,RW,R,2013-14,75,22,18,40,0.53,-4,151,14.57,16,84592.0,18:47,12,16,28,42.86,72,54,45,22,23,0,2,2,7188.0,1:35,4,0,4,13815.0,3:4,900000
8476179,Will,Acton,1987-07-16,C,L,2013-14,30,3,2,5,0.17,-2,18,16.67,21,14648.0,8:8,98,97,195,50.26,37,14,15,4,11,0,0,0,72.0,0:2,0,0,0,3611.0,2:0,680000
8476191,Kevan,Miller,1987-11-15,D,R,2013-14,47,1,5,6,0.13,20,41,2.44,38,49243.0,17:27,0,0,0,0.0,103,85,15,8,7,0,0,0,107.0,0:2,0,0,0,5553.0,1:58,550000
8476195,Cory,Conacher,1989-12-14,C,L,2013-14,79,7,19,26,0.33,1,100,7.0,50,61342.0,12:56,9,5,14,64.29,51,27,24,14,10,1,0,1,6878.0,1:27,0,0,0,39.0,0:0,871250
8476205,Stephane,Da Costa,1989-07-11,C,R,2013-14,12,3,1,4,0.33,2,20,15.0,2,7495.0,10:24,32,47,79,40.51,14,3,7,1,6,1,0,1,492.0,0:41,0,0,0,26.0,0:2,825000
8476206,Andy,Miele,1988-04-15,C,L,2013-14,7,0,2,2,0.29,4,6,0.0,5,3927.0,9:21,15,27,42,35.71,4,2,2,1,1,0,0,0,143.0,0:20,0,0,0,0.0,0:0,675000
8476207,Brian,Gibbons,1988-02-26,LW,L,2013-14,41,5,12,17,0.41,5,29,17.24,6,29384.0,11:56,9,13,22,40.91,24,19,10,11,-1,1,0,1,884.0,0:21,0,1,1,1599.0,0:39,550000
8476209,Mike,Sislo,1988-01-20,RW,R,2013-14,14,0,0,0,0.0,-1,20,0.0,0,7437.0,8:51,5,1,6,83.33,19,4,3,1,2,0,0,0,28.0,0:2,0,0,0,429.0,0:30,550000
8476235,Justin,Fontaine,1987-11-06,RW,R,2013-14,66,13,8,21,0.32,6,79,16.46,26,48541.0,12:15,2,0,2,100.0,9,23,24,14,10,1,1,2,3885.0,0:58,0,0,0,21.0,0:0,600000
8476244,Raphael,Diaz,1986-01-09,D,R,2013-14,63,2,13,15,0.24,-2,68,2.94,16,67946.0,17:58,0,1,1,0.0,36,127,8,22,-14,0,4,4,5839.0,1:32,0,1,1,7734.0,2:2,1225000
8476292,Ondrej,Palat,1991-03-28,LW,L,2013-14,81,23,36,59,0.73,32,165,13.94,20,87648.0,18:2,5,32,37,13.51,146,64,47,38,9,3,8,11,7914.0,1:37,2,2,4,10076.0,2:4,575000
8476302,Frank,Corrado,1993-03-26,D,R,2013-14,15,1,0,1,0.07,-2,20,5.0,4,11308.0,12:33,0,0,0,0.0,9,17,1,3,-2,0,0,0,491.0,0:32,0,0,0,236.0,0:15,591667
8476304,David,Broll,1993-01-04,LW,L,2013-14,5,0,1,1,0.2,1,3,0.0,5,2455.0,8:11,0,0,0,0.0,7,2,2,5,-3,0,0,0,19.0,0:3,0,0,0,0.0,0:0,590833
8476346,Johnny,Gaudreau,1993-08-13,LW,L,2013-14,1,1,0,1,1.0,1,1,100.0,0,911.0,15:11,0,0,0,0.0,0,0,1,0,1,0,0,0,91.0,1:31,0,0,0,0.0,0:0,925000
8476367,John,Persson,1992-05-18,LW,L,2013-14,10,1,0,1,0.1,-4,16,6.25,6,7222.0,12:2,0,2,2,0.0,18,6,1,0,1,0,0,0,13.0,0:1,0,0,0,0.0,0:0,626667
8476381,Andrew,Shaw,1991-07-20,RW,R,2013-14,80,20,19,39,0.49,12,149,13.42,76,75314.0,15:41,296,388,684,43.27,168,16,25,18,7,5,4,9,12564.0,2:37,0,0,0,1209.0,0:15,573333
8476389,Vincent,Trocheck,1993-07-11,C,R,2013-14,20,5,3,8,0.4,-11,38,13.16,6,22664.0,18:53,166,182,348,47.7,39,11,13,8,5,1,0,1,3067.0,2:33,1,0,1,2739.0,2:16,661667
8476410,Josh,Leivo,1993-05-26,LW,R,2013-14,7,1,1,2,0.29,0,4,25.0,0,4141.0,9:51,0,1,1,0.0,5,0,2,1,1,0,0,0,58.0,0:8,0,0,0,11.0,0:1,792500
8476419,Jean-Gabriel,Pageau,1992-11-11,C,R,2013-14,28,2,0,2,0.07,-5,31,6.45,12,17217.0,10:14,118,128,246,47.97,41,12,8,11,-3,0,0,0,6.0,0:0,0,0,0,2720.0,1:37,613333
8476423,Reid,Boucher,1993-09-08,C,L,2013-14,23,2,5,7,0.3,2,27,7.41,4,15670.0,11:21,1,2,3,33.33,17,5,6,3,3,0,0,0,1291.0,0:56,0,0,0,34.0,0:1,692500
8476427,Ty,Rattie,1993-02-05,RW,R,2013-14,2,0,0,0,0.0,-2,4,0.0,0,1326.0,11:3,0,0,0,0.0,1,0,0,1,-1,0,0,0,285.0,2:22,0,0,0,0.0,0:0,772500
8476429,Scott,Mayfield,1992-10-14,D,R,2013-14,5,0,0,0,0.0,-3,7,0.0,7,5210.0,17:22,0,0,0,0.0,7,8,2,2,0,0,0,0,10.0,0:2,0,0,0,548.0,1:49,925000
8476430,Tomas,Jurco,1992-12-28,LW,L,2013-14,36,8,7,15,0.42,0,77,10.39,14,29085.0,13:27,0,0,0,0.0,67,9,8,10,-2,2,1,3,4153.0,1:55,0,0,0,12.0,0:0,709167
8476432,Boone,Jenner,1993-06-15,C,L,2013-14,72,16,13,29,0.4,6,127,12.6,45,60823.0,14:4,14,16,30,46.67,212,37,28,26,2,4,3,7,3981.0,0:55,0,0,0,79.0,0:1,778333
8476435,Alex,Khokhlachev,1993-09-09,C,L,2013-14,1,0,0,0,0.0,0,2,0.0,2,914.0,15:14,8,9,17,47.06,1,0,1,0,1,0,0,0,30.0,0:30,0,0,0,0.0,0:0,786667
8476436,Dmitrij,Jaskin,1993-03-23,RW,L,2013-14,18,1,1,2,0.11,-3,18,5.56,8,11473.0,10:37,1,1,2,50.0,40,5,3,1,2,0,0,0,608.0,0:33,0,0,0,93.0,0:5,772500
8476438,Brandon,Saad,1992-10-27,LW,L,2013-14,78,19,28,47,0.6,20,159,11.95,20,76239.0,16:17,50,72,122,40.98,48,20,50,24,26,3,6,9,8479.0,1:48,0,2,2,3339.0,0:42,764167
8476440,Markus,Granlund,1993-04-16,C,L,2013-14,7,2,1,3,0.43,2,9,22.22,0,5075.0,12:5,28,26,54,51.85,3,1,2,2,0,0,0,0,592.0,1:24,1,0,1,246.0,0:35,767500
8476442,Matt,Nieto,1992-11-05,LW,L,2013-14,66,10,14,24,0.36,-4,124,8.06,16,55744.0,14:4,3,8,11,27.27,7,45,17,29,-12,1,3,4,3327.0,0:50,0,0,0,2263.0,0:34,759167
8476443,Xavier,Ouellet,1993-07-29,D,L,2013-14,4,0,0,0,0.0,0,4,0.0,2,3497.0,14:34,0,0,0,0.0,7,1,0,1,-1,0,0,0,21.0,0:5,0,0,0,240.0,1:0,670000
8476445,Johan,Sundstrom,1992-09-21,C,R,2013-14,11,0,1,1,0.09,0,13,0.0,6,5719.0,8:39,4,7,11,36.36,4,2,5,3,2,0,0,0,187.0,0:17,0,0,0,75.0,0:6,770000
8476450,Ryan,Sproul,1993-01-13,D,R,2013-14,1,0,0,0,0.0,0,3,0.0,0,1105.0,18:25,0,0,0,0.0,2,2,0,0,0,0,0,0,205.0,3:25,0,0,0,0.0,0:0,620000
8476451,Lucas,Lessio,1993-01-23,LW,L,2013-14,3,0,0,0,0.0,-2,4,0.0,2,2075.0,11:31,0,0,0,0.0,2,0,1,1,0,0,0,0,0.0,0:0,0,0,0,0.0,0:0,830833
8476452,Tyler,Wotherspoon,1993-03-12,D,L,2013-14,14,0,4,4,0.29,-3,3,0.0,4,11298.0,13:27,0,0,0,0.0,8,17,2,4,-2,0,0,0,2.0,0:0,0,0,0,28.0,0:2,925000
8476453,Nikita,Kucherov,1993-06-17,RW,L,2013-14,52,9,9,18,0.35,3,102,8.82,14,40919.0,13:6,1,0,1,100.0,15,19,17,17,0,3,1,4,3707.0,1:11,0,0,0,0.0,0:0,711667
8476454,Ryan,Nugent-Hopkins,1993-04-12,C,L,2013-14,80,19,37,56,0.7,-12,178,10.67,26,97890.0,20:23,543,737,1280,42.42,72,35,63,50,13,6,14,20,14368.0,2:59,0,0,0,5974.0,1:14,925000
8476455,Gabriel,Landeskog,1992-11-23,LW,L,2013-14,81,26,39,65,0.8,21,222,11.71,71,90769.0,18:40,13,5,18,72.22,176,52,64,35,29,5,5,10,11726.0,2:24,0,0,0,1021.0,0:12,925000
8476456,Jonathan,Huberdeau,1993-06-04,LW,L,2013-14,69,9,19,28,0.41,-5,108,8.33,37,64853.0,15:39,5,6,11,45.45,73,23,32,21,11,2,3,5,8226.0,1:59,0,0,0,89.0,0:1,894167
8476457,Adam,Larsson,1992-11-12,D,R,2013-14,26,1,2,3,0.12,-1,20,5.0,12,27744.0,17:47,0,0,0,0.0,41,37,4,10,-6,0,0,0,743.0,0:28,0,0,0,1406.0,0:54,925000
8476458,Ryan,Strome,1993-07-11,C,R,2013-14,37,7,11,18,0.49,-1,89,7.87,8,33720.0,15:11,165,209,374,44.12,29,8,21,22,-1,4,3,7,4988.0,2:14,0,0,0,84.0,0:2,863333
8476459,Mika,Zibanejad,1993-04-18,C,R,2013-14,69,16,17,33,0.48,-15,153,10.46,18,59323.0,14:19,183,214,397,46.1,118,28,31,18,13,3,5,8,8154.0,1:58,0,0,0,1325.0,0:19,894167
8476460,Mark,Scheifele,1993-03-15,C,R,2013-14,63,13,21,34,0.54,9,100,13.0,14,61834.0,16:21,331,454,785,42.17,63,39,31,22,9,1,3,4,7452.0,1:58,0,0,0,185.0,0:2,863333
8476461,Sean,Couturier,1992-12-07,C,L,2013-14,82,13,26,39,0.48,1,165,7.88,45,93907.0,19:5,646,707,1353,47.75,64,40,47,40,7,0,3,3,6284.0,1:16,1,4,5,16882.0,3:25,925000
8476462,Dougie,Hamilton,1993-06-17,D,R,2013-14,64,7,18,25,0.39,22,114,6.14,40,73355.0,19:6,0,0,0,0.0,73,53,18,31,-13,2,4,6,7401.0,1:55,0,0,0,2519.0,0:39,925000
8476463,Jonas,Brodin,1993-07-12,D,L,2013-14,79,8,11,19,0.24,0,74,10.81,22,113292.0,23:54,0,0,0,0.0,33,117,28,36,-8,3,4,7,6739.0,1:25,0,0,0,10768.0,2:16,925000
8476465,Ryan,Murphy,1993-03-31,D,R,2013-14,48,2,10,12,0.25,-9,81,2.47,10,52662.0,18:17,0,0,0,0.0,22,58,32,46,-14,1,2,3,7456.0,2:35,0,0,0,219.0,0:4,863333
8476466,Sven,Baertschi,1992-10-05,LW,L,2013-14,26,2,9,11,0.42,-4,30,6.67,6,22014.0,14:6,0,0,0,0.0,22,19,9,13,-4,1,3,4,1741.0,1:6,0,0,0,35.0,0:1,894167
8476467,Jamie,Oleksiak,1992-12-21,D,L,2013-14,7,0,0,0,0.0,-3,5,0.0,2,7472.0,17:47,0,0,0,0.0,16,14,1,7,-6,0,0,0,391.0,0:55,0,0,0,1054.0,2:30,894167
8476468,J.T.,Miller,1993-03-14,C,L,2013-14,30,3,3,6,0.2,-6,46,6.52,18,20615.0,11:27,26,25,51,50.98,44,17,11,7,4,0,2,2,1521.0,0:50,0,0,0,7.0,0:0,894167
8476470,Nathan,Beaulieu,1992-12-05,D,L,2013-14,17,0,2,2,0.12,6,15,0.0,8,13493.0,13:13,0,0,0,0.0,7,20,1,13,-12,0,0,0,1178.0,1:9,0,0,0,0.0,0:0,925000
8476472,Oscar,Klefbom,1993-07-20,D,L,2013-14,17,1,2,3,0.18,-6,14,7.14,0,16113.0,15:47,0,0,0,0.0,6,25,3,9,-6,0,0,0,154.0,0:9,0,0,0,634.0,0:37,894167
8476473,Connor,Murphy,1993-03-26,D,R,2013-14,30,1,7,8,0.27,5,30,3.33,10,32365.0,17:58,0,0,0,0.0,44,38,13,13,0,0,0,0,35.0,0:1,0,0,0,3273.0,1:49,863333
8476480,Vladislav,Namestnikov,1992-11-22,C,L,2013-14,4,0,0,0,0.0,-1,4,0.0,4,2273.0,9:28,12,14,26,46.15,3,1,1,1,0,0,0,0,0.0,0:0,0,0,0,0.0,0:0,925000
8476482,Nicklas,Jensen,1993-03-06,RW,L,2013-14,17,3,3,6,0.35,-1,30,10.0,10,15951.0,15:38,0,1,1,0.0,7,6,8,7,1,0,1,1,1785.0,1:45,0,0,0,66.0,0:3,863333
8476483,Rickard,Rakell,1993-05-05,C,R,2013-14,18,0,4,4,0.22,-3,22,0.0,2,12658.0,11:43,95,99,194,48.97,21,4,5,4,1,0,0,0,363.0,0:20,0,0,0,135.0,0:7,894167
8476522,Adam,Payerl,1991-03-04,C,R,2013-14,2,0,0,0,0.0,-1,4,0.0,2,1098.0,9:9,0,0,0,0.0,6,2,0,0,0,0,0,0,0.0,0:0,0,0,0,0.0,0:0,626666
8476765,Mike,Halmo,1991-05-15,LW,L,2013-14,20,1,0,1,0.05,-1,25,4.0,32,11390.0,9:29,4,16,20,20.0,52,4,4,2,2,0,0,0,231.0,0:11,0,0,0,92.0,0:4,864167
8476779,Brad,Hunt,1988-08-24,D,L,2013-14,3,0,0,0,0.0,-3,1,0.0,0,2268.0,12:36,0,0,0,0.0,0,2,1,1,0,0,0,0,183.0,1:1,0,0,0,0.0,0:0,550000
8476792,Torey,Krug,1991-04-12,D,L,2013-14,79,14,26,40,0.51,18,183,7.65,28,82997.0,17:30,1,1,2,50.0,50,77,24,35,-11,6,13,19,11923.0,2:30,0,0,0,1186.0,0:15,916667
8476798,Karl,Stollery,1987-11-21,D,L,2013-14,2,0,0,0,0.0,1,1,0.0,2,781.0,6:30,0,0,0,0.0,3,0,0,0,0,0,0,0,0.0,0:0,0,0,0,5.0,0:2,550000
8476799,Cameron,Schilling,1988-10-07,D,L,2013-14,1,0,0,0,0.0,-2,2,0.0,0,1065.0,17:45,0,0,0,0.0,2,0,0,0,0,0,0,0,0.0,0:0,0,0,0,0.0,0:0,925000
8476805,Spencer,Abbott,1988-04-30,LW,R,2013-14,1,0,0,0,0.0,-2,2,0.0,0,316.0,5:16,0,0,0,0.0,1,0,0,0,0,0,0,0,0.0,0:0,0,0,0,0.0,0:0,650000
8476806,J.T.,Brown,1990-07-02,RW,R,2013-14,63,4,15,19,0.3,-9,113,3.54,6,49268.0,13:2,7,15,22,31.82,70,32,19,12,7,0,2,2,1811.0,0:28,0,1,1,3626.0,0:57,874125
8476808,Brian,Flynn,1988-07-26,C,R,2013-14,79,6,7,13,0.16,-10,102,5.88,14,68346.0,14:25,184,205,389,47.3,51,55,28,15,13,0,0,0,572.0,0:7,1,0,1,11015.0,2:19,637500
8476819,Jeremy,Welsh,1988-04-30,C,L,2013-14,19,1,0,1,0.05,-1,13,7.69,6,7817.0,6:51,46,44,90,51.11,16,8,3,5,-2,0,0,0,62.0,0:3,0,0,0,62.0,0:3,850000
8476822,Luke,Glendening,1989-04-28,RW,R,2013-14,56,1,6,7,0.12,-8,54,1.85,22,46751.0,13:54,329,349,678,48.53,92,38,12,7,5,0,0,0,343.0,0:6,0,0,0,9136.0,2:43,575000
8476827,Chad,Billins,1989-05-26,D,L,2013-14,10,0,3,3,0.3,-3,3,0.0,0,7325.0,12:12,0,0,0,0.0,0,9,2,2,0,0,0,0,723.0,1:12,0,0,0,0.0,0:0,925000
8476850,Ryan,Murray,1993-09-27,D,L,2013-14,66,4,17,21,0.32,4,62,6.45,10,78688.0,19:52,0,0,0,0.0,26,97,12,26,-14,3,4,7,8161.0,2:3,0,1,1,6878.0,1:44,894167
8476851,Alex,Galchenyuk,1994-02-12,LW,L,2013-14,65,13,18,31,0.48,-12,110,11.82,26,56141.0,14:23,5,10,15,33.33,49,25,30,23,7,3,7,10,7940.0,2:2,0,0,0,76.0,0:1,925000
8476853,Morgan,Rielly,1994-03-09,D,L,2013-14,73,2,25,27,0.37,-13,96,2.08,12,77238.0,17:38,0,0,0,0.0,96,92,38,71,-33,1,11,12,8419.0,1:55,0,0,0,618.0,0:8,894167
8476854,Hampus,Lindholm,1994-01-20,D,L,2013-14,78,6,24,30,0.38,29,116,5.17,36,90940.0,19:25,0,1,1,0.0,54,61,22,45,-23,1,3,4,9792.0,2:5,0,0,0,1900.0,0:24,894167
8476855,Nail,Yakupov,1993-10-06,RW,L,2013-14,63,11,13,24,0.38,-33,122,9.02,36,54107.0,14:18,0,0,0,0.0,64,23,18,32,-14,4,2,6,8242.0,2:10,0,0,0,37.0,0:0,925000
8476856,Matt,Dumba,1994-07-25,D,R,2013-14,13,1,1,2,0.15,-5,12,8.33,2,9710.0,12:26,0,0,0,0.0,9,3,2,5,-3,1,1,2,1287.0,1:39,0,0,0,32.0,0:2,894167
8476871,Tanner,Pearson,1992-08-10,LW,L,2013-14,25,3,4,7,0.28,2,31,9.68,8,16213.0,10:48,1,1,2,50.0,35,9,9,9,0,1,0,1,952.0,0:38,0,0,0,179.0,0:7,735833
8476874,Olli,Maatta,1994-08-22,D,L,2013-14,78,9,20,29,0.37,8,119,7.56,14,86574.0,18:29,0,0,0,0.0,41,112,10,35,-25,3,3,6,5653.0,1:12,1,0,1,5192.0,1:6,894167
8476878,Zemgus,Girgensons,1994-01-05,C,L,2013-14,70,8,14,22,0.31,-6,115,6.96,14,64327.0,15:18,100,140,240,41.67,161,43,25,15,10,0,0,0,1589.0,0:22,1,1,2,7537.0,1:47,894167
8476879,Cody,Ceci,1993-12-21,D,R,2013-14,49,3,6,9,0.18,-5,82,3.66,14,50581.0,17:12,0,0,0,0.0,45,49,12,15,-3,0,0,0,4181.0,1:25,0,0,0,5148.0,1:45,894167
8476880,Tom,Wilson,1994-03-29,RW,R,2013-14,82,3,7,10,0.12,1,63,4.76,151,39057.0,7:56,0,3,3,0.0,197,13,17,10,7,1,0,1,477.0,0:5,0,0,0,3.0,0:0,894167
8476881,Tomas,Hertl,1993-11-12,C,L,2013-14,37,15,10,25,0.68,11,98,15.31,4,34029.0,15:19,29,22,51,56.86,39,13,18,18,0,3,0,3,4577.0,2:3,0,0,0,12.0,0:0,925000
8476882,Teuvo,Teravainen,1994-09-11,LW,L,2013-14,3,0,0,0,0.0,0,4,0.0,0,2537.0,14:5,13,12,25,52.0,1,0,4,1,3,0,0,0,298.0,1:39,0,0,0,0.0,0:0,925000
8476885,Jacob,Trouba,1994-02-26,D,R,2013-14,65,10,19,29,0.45,4,121,8.26,43,87502.0,22:26,0,0,0,0.0,95,132,31,88,-57,0,3,3,7694.0,1:58,1,0,1,11424.0,2:55,894167
8476887,Filip,Forsberg,1994-08-13,LW,R,2013-14,13,1,4,5,0.38,-8,20,5.0,4,8896.0,11:24,0,0,0,0.0,6,2,6,6,0,1,3,4,1510.0,1:56,0,0,0,0.0,0:0,894167
8476888,Mikhail,Grigorenko,1994-05-16,C,L,2013-14,18,2,1,3,0.17,-3,20,10.0,2,12344.0,11:25,53,50,103,51.46,6,5,7,7,0,0,1,1,1012.0,0:56,0,0,0,0.0,0:0,925000
8476925,Colton,Sissons,1993-11-05,C,R,2013-14,17,1,3,4,0.24,0,13,7.69,4,10830.0,10:37,70,74,144,48.61,9,9,6,2,4,0,0,0,2.0,0:0,0,0,0,715.0,0:42,635000
8476931,Jake,McCabe,1993-10-12,D,L,2013-14,7,0,1,1,0.14,-3,1,0.0,15,6390.0,15:12,0,0,0,0.0,5,10,2,0,2,0,0,0,21.0,0:3,0,0,0,365.0,0:52,925000
8476941,Connor,Carrick,1994-04-13,D,R,2013-14,34,1,5,6,0.18,-9,26,3.85,23,32584.0,15:58,0,0,0,0.0,25,56,6,18,-12,0,0,0,658.0,0:19,0,0,0,2430.0,1:11,636667
8476975,Cedric,Paquette,1993-08-13,C,L,2013-14,2,0,1,1,0.5,1,1,0.0,0,1745.0,14:32,16,13,29,55.17,2,4,0,0,0,0,0,0,0.0,0:0,0,0,0,43.0,0:21,633333
8477126,Jayson,Megna,1990-02-01,C,R,2013-14,36,5,4,9,0.25,1,36,13.89,6,22647.0,10:29,2,8,10,20.0,47,13,7,4,3,0,0,0,10.0,0:0,0,0,0,355.0,0:9,925000
8477201,Kellan,Lain,1989-08-11,LW,L,2013-14,9,1,0,1,0.11,1,7,14.29,21,2818.0,5:13,18,19,37,48.65,7,1,2,1,1,0,0,0,4.0,0:0,0,0,0,17.0,0:1,600000
8477205,Andrej,Sustr,1990-11-29,D,R,2013-14,43,1,7,8,0.19,3,39,2.56,16,40747.0,15:47,0,0,0,0.0,26,36,4,22,-18,0,0,0,246.0,0:5,0,2,2,3107.0,1:12,925000
8477214,Conor,Allen,1990-01-31,D,L,2013-14,3,0,0,0,0.0,-1,2,0.0,0,2599.0,14:26,0,0,0,0.0,1,1,0,0,0,0,0,0,0.0,0:0,0,0,0,0.0,0:0,925000
8477215,Danny,DeKeyser,1990-03-07,D,L,2013-14,65,4,19,23,0.35,10,84,4.76,30,84399.0,21:38,0,0,0,0.0,64,116,13,36,-23,1,3,4,6160.0,1:34,1,0,1,8702.0,2:13,925000
8477220,Nate,Schmidt,1991-07-16,D,L,2013-14,29,2,4,6,0.21,4,41,4.88,6,32528.0,18:41,0,0,0,0.0,18,35,10,21,-11,0,0,0,320.0,0:11,0,0,0,1018.0,0:35,925000
8477227,Eriah,Hayes,1988-07-07,RW,R,2013-14,15,1,0,1,0.07,-2,17,5.88,2,7051.0,7:50,9,12,21,42.86,40,10,2,3,-1,0,0,0,22.0,0:1,0,0,0,0.0,0:0,655000
8477244,Chad,Ruhwedel,1990-05-07,D,R,2013-14,21,0,1,1,0.05,-3,35,0.0,2,22527.0,17:52,0,0,0,0.0,20,29,6,6,0,0,1,1,1022.0,0:48,0,0,0,1483.0,1:10,925000
8477290,Michael,Raffl,1988-12-01,LW,L,2013-14,68,9,13,22,0.32,2,101,8.91,28,53003.0,12:59,52,41,93,55.91,113,44,25,21,4,0,0,0,763.0,0:11,0,0,0,7075.0,1:44,792500
8477492,Nathan,MacKinnon,1995-09-01,C,R,2013-14,82,24,39,63,0.77,20,241,9.96,26,85333.0,17:20,194,258,452,42.92,57,45,51,28,23,8,9,17,11491.0,2:20,0,0,0,341.0,0:4,925000
8477493,Aleksander,Barkov,1995-09-02,C,L,2013-14,54,8,16,24,0.44,-3,87,9.2,10,55393.0,17:5,400,419,819,48.84,16,27,30,17,13,3,3,6,8647.0,2:40,0,0,0,427.0,0:7,925000
8477495,Seth,Jones,1994-10-03,D,R,2013-14,77,6,19,25,0.32,-23,100,6.0,24,90646.0,19:37,0,0,0,0.0,55,99,25,57,-32,2,7,9,9107.0,1:58,0,0,0,7688.0,1:39,925000
8477496,Elias,Lindholm,1994-12-02,C,R,2013-14,58,9,12,21,0.36,-14,70,12.86,4,50550.0,14:31,106,123,229,46.29,51,17,37,28,9,4,3,7,8716.0,2:30,0,0,0,190.0,0:3,925000
8477497,Sean,Monahan,1994-10-12,C,L,2013-14,75,22,12,34,0.45,-20,140,15.71,8,71901.0,15:58,476,560,1036,45.95,42,23,26,31,-5,3,4,7,9442.0,2:5,0,0,0,1128.0,0:15,925000
8477499,Rasmus,Ristolainen,1994-10-27,D,R,2013-14,34,2,2,4,0.12,-15,52,3.85,6,38998.0,19:7,0,1,1,0.0,66,32,9,19,-10,0,0,0,3351.0,1:38,0,0,0,2807.0,1:22,925000
8477501,Valeri,Nichushkin,1995-03-04,RW,L,2013-14,79,14,20,34,0.43,20,128,10.94,8,70955.0,14:58,0,1,1,0.0,86,27,25,59,-34,2,1,3,6253.0,1:19,0,0,0,54.0,0:0,925000
8477507,Nikita,Zadorov,1995-04-16,D,L,2013-14,7,1,0,1,0.14,-4,4,25.0,4,7212.0,17:10,0,0,0,0.0,25,3,1,5,-4,0,0,0,77.0,0:11,0,0,0,415.0,0:59,925000
8477814,Kevin,Czuczman,1991-01-09,D,L,2013-14,13,0,2,2,0.15,-5,24,0.0,14,15244.0,19:32,1,0,1,100.0,15,13,6,6,0,0,0,0,452.0,0:34,0,0,0,1288.0,1:39,925000
8477816,Michael,Zalewski,1992-08-18,LW,L,2013-14,2,0,1,1,0.5,2,2,0.0,0,1455.0,12:7,0,0,0,0.0,0,0,1,0,1,0,1,1,69.0,0:34,0,0,0,0.0,0:0,925000
8477832,Cody,Kunyk,1990-05-20,RW,L,2013-14,1,0,0,0,0.0,0,2,0.0,0,612.0,10:12,1,4,5,20.0,1,1,0,0,0,0,0,0,0.0,0:0,0,0,0,0.0,0:0,1584063
8477836,Matt,Carey,1992-02-28,LW,L,2013-14,2,1,0,1,0.5,-1,1,100.0,2,1156.0,9:38,10,11,21,47.62,2,0,0,0,0,0,0,0,52.0,0:26,0,0,0,0.0,0:0,925000
8477847,Bryce,Van Brabant,1991-11-12,LW,L,2013-14,6,0,0,0,0.0,-1,4,0.0,2,3297.0,9:9,0,0,0,0.0,17,4,2,1,1,0,0,0,4.0,0:0,0,0,0,0.0,0:0,912500
8448208,Jaromir,Jagr,1972-02-15,RW,L,2014-15,77,17,30,47,0.61,-3,169,10.06,48,81174.0,17:34,1,0,1,100.0,30,14,38,46,-8,4,7,11,10925.0,2:21,0,0,0,38.0,0:0,3500000
8458951,Sergei,Gonchar,1974-04-13,D,L,2014-15,48,1,13,14,0.29,6,46,2.17,18,50942.0,17:41,1,0,1,100.0,45,71,5,29,-24,0,4,4,5848.0,2:1,0,0,0,1157.0,0:24,5000000
8459670,Kimmo,Timonen,1975-03-18,D,L,2014-15,16,0,0,0,0.0,-3,10,0.0,2,11496.0,11:58,0,0,0,0.0,15,15,0,6,-6,0,0,0,443.0,0:27,0,0,0,44.0,0:2,2000000
8460542,Patrik,Elias,1976-04-13,C,L,2014-15,69,13,21,34,0.49,-20,114,11.4,12,73038.0,17:38,263,410,673,39.08,23,25,18,40,-22,5,4,9,8489.0,2:3,0,2,2,7487.0,1:48,5500000
8460626,Bryce,Salvador,1976-02-11,D,L,2014-15,15,0,2,2,0.13,-5,13,0.0,20,16652.0,18:30,0,0,0,0.0,22,19,1,7,-6,0,0,0,4.0,0:0,0,0,0,3633.0,4:2,3166667
8460720,Eric,Boulton,1976-08-17,LW,L,2014-15,10,2,0,2,0.2,-1,9,22.22,30,4318.0,7:11,0,0,0,0.0,10,4,1,1,0,0,0,0,19.0,0:1,0,0,0,0.0,0:0,650000
8462038,Shane,Doan,1976-10-10,RW,R,2014-15,79,14,22,36,0.46,-29,189,7.41,65,89506.0,18:52,3,8,11,27.27,189,26,43,42,1,5,5,10,12529.0,2:38,0,0,0,3241.0,0:41,5300000
8462042,Jarome,Iginla,1977-07-01,RW,R,2014-15,82,29,30,59,0.72,0,189,15.34,42,89227.0,18:8,57,71,128,44.53,99,47,31,30,1,8,5,13,13686.0,2:46,0,0,0,586.0,0:7,5333333
8462196,Stephane,Robidas,1977-03-03,D,R,2014-15,52,1,6,7,0.13,8,34,2.94,34,53257.0,17:4,0,0,0,0.0,141,75,8,16,-8,0,0,0,478.0,0:9,0,1,1,6816.0,2:11,3000000
8464956,Chris,Phillips,1978-03-09,D,L,2014-15,36,0,3,3,0.08,0,29,0.0,12,45136.0,20:53,0,0,0,0.0,70,54,7,26,-19,0,1,1,636.0,0:17,0,0,0,6456.0,2:59,2500000
8464975,Daniel,Briere,1977-10-06,C,R,2014-15,57,8,4,12,0.21,-7,69,11.59,18,41457.0,12:7,13,11,24,54.17,19,9,23,9,14,0,0,0,4327.0,1:15,0,0,0,108.0,0:1,6500000
8464977,Dainius,Zubrus,1978-06-16,C,L,2014-15,74,4,6,10,0.14,-9,72,5.56,42,65086.0,14:39,37,49,86,43.02,99,41,19,19,0,0,1,1,1220.0,0:16,0,1,1,6111.0,1:22,3100000
8464989,Matt,Cullen,1976-11-02,C,L,2014-15,62,7,18,25,0.4,8,90,7.78,16,48409.0,13:0,155,132,287,54.01,10,18,26,22,4,0,4,4,1840.0,0:29,0,0,0,2997.0,0:48,3500000
8465009,Zdeno,Chara,1977-03-18,D,L,2014-15,63,8,12,20,0.32,0,138,5.8,42,88255.0,23:20,1,0,1,100.0,125,99,14,55,-41,4,1,5,7909.0,2:5,0,3,3,11570.0,3:3,6916667
8465058,Michal,Rozsival,1978-09-03,D,R,2014-15,65,1,12,13,0.2,0,56,1.79,22,66339.0,17:0,0,0,0,0.0,103,87,17,36,-19,0,0,0,1723.0,0:26,0,0,0,2101.0,0:32,2200000
8465166,Craig,Adams,1977-04-26,RW,R,2014-15,70,1,6,7,0.1,-1,51,1.96,44,40931.0,9:44,17,23,40,42.5,183,29,6,7,-1,0,0,0,141.0,0:2,0,1,1,10728.0,2:33,700000
8465185,Willie,Mitchell,1977-04-23,D,L,2014-15,66,3,5,8,0.12,1,78,3.85,25,85848.0,21:40,0,0,0,0.0,99,144,17,34,-17,0,0,0,535.0,0:8,0,1,1,12970.0,3:16,4250000
8465951,Matt,Cooke,1978-09-07,LW,L,2014-15,29,4,6,10,0.34,0,24,16.67,13,21924.0,12:36,3,6,9,33.33,39,22,11,7,4,0,0,0,115.0,0:3,0,0,0,3605.0,2:4,2500000
8465978,Shawn,Thornton,1977-07-23,LW,R,2014-15,46,1,4,5,0.11,-13,53,1.89,50,26452.0,9:35,3,9,12,25.0,93,5,10,5,5,0,0,0,214.0,0:4,0,0,0,60.0,0:1,1200000
8466138,Joe,Thornton,1979-07-02,C,L,2014-15,78,16,49,65,0.83,-4,131,12.21,30,86225.0,18:25,554,401,955,58.01,39,26,60,91,-31,4,18,22,14724.0,3:8,0,0,0,1741.0,0:22,6750000
8466139,Patrick,Marleau,1979-09-15,C,L,2014-15,82,19,38,57,0.7,-17,233,8.15,12,96386.0,19:35,171,185,356,48.03,85,28,44,75,-31,7,17,24,16152.0,3:16,0,0,0,6897.0,1:24,6666667
8466140,Olli,Jokinen,1978-12-05,C,L,2014-15,62,4,6,10,0.16,6,110,3.64,28,49342.0,13:15,134,196,330,40.61,64,19,11,11,0,0,0,0,1502.0,0:24,0,0,0,4889.0,1:18,2500000
8466142,Eric,Brewer,1979-04-17,D,L,2014-15,44,3,8,11,0.25,-5,33,9.09,36,49328.0,18:41,0,0,0,0.0,87,72,8,16,-8,0,0,0,416.0,0:9,0,1,1,5645.0,2:8,3875000
8466148,Marian,Hossa,1979-01-12,RW,L,2014-15,82,22,39,61,0.74,17,247,8.91,32,91288.0,18:33,4,3,7,57.14,62,26,68,30,38,6,11,17,12201.0,2:28,1,0,1,7529.0,1:31,5275000
8466149,Daniel,Cleary,1978-12-18,RW,L,2014-15,17,1,1,2,0.12,-4,17,5.88,6,9316.0,9:8,2,2,4,50.0,21,9,2,1,1,0,0,0,86.0,0:5,0,0,0,387.0,0:22,1500000
8466158,Scott,Hannan,1979-01-23,D,L,2014-15,58,2,5,7,0.12,0,53,3.77,26,56767.0,16:18,0,0,0,0.0,32,69,8,16,-8,0,0,0,137.0,0:2,0,0,0,6062.0,1:44,1000000
8466160,Brenden,Morrow,1979-01-16,LW,L,2014-15,70,3,5,8,0.11,-1,28,10.71,64,39176.0,9:19,0,0,0,0.0,112,16,11,20,-9,0,0,0,457.0,0:6,0,0,0,129.0,0:1,1550000
8466251,Jason,Chimera,1979-05-02,LW,L,2014-15,77,7,12,19,0.25,-1,96,7.29,51,59763.0,12:56,43,33,76,56.58,132,18,27,15,12,0,0,0,866.0,0:11,0,0,0,6464.0,1:23,2000000
8466285,Brian,Campbell,1979-05-23,D,L,2014-15,82,3,24,27,0.33,4,118,2.54,22,114185.0,23:12,0,0,0,0.0,44,85,16,34,-18,1,11,12,14916.0,3:1,0,0,0,4967.0,1:0,7142875
8466333,Andrew,Ference,1979-03-17,D,L,2014-15,70,3,11,14,0.2,-17,58,5.17,39,79283.0,18:52,0,2,2,0.0,156,86,12,38,-26,0,0,0,370.0,0:5,0,1,1,7850.0,1:52,3250000
8466378,Martin,St. Louis,1975-06-18,RW,L,2014-15,74,21,31,52,0.7,12,144,14.58,20,77979.0,17:33,51,59,110,46.36,13,37,41,43,-2,5,8,13,12761.0,2:52,0,0,0,485.0,0:6,5625000
8466393,Pascal,Dupuis,1979-04-07,RW,L,2014-15,16,6,5,11,0.69,2,44,13.64,4,15981.0,16:38,1,0,1,100.0,20,8,6,5,1,2,1,3,1705.0,1:46,0,1,1,2083.0,2:10,3750000
8467096,Dan,Boyle,1976-07-12,D,R,2014-15,65,9,11,20,0.31,18,116,7.76,20,78953.0,20:14,0,0,0,0.0,49,79,20,33,-13,3,5,8,10280.0,2:38,0,0,0,3383.0,0:52,4500000
8467329,Vincent,Lecavalier,1980-04-21,C,L,2014-15,57,8,12,20,0.35,-7,103,7.77,36,43254.0,12:38,95,96,191,49.74,40,15,11,16,-5,1,3,4,6599.0,1:55,0,0,0,11.0,0:0,7727272
8467330,David,Legwand,1980-08-17,C,L,2014-15,80,9,18,27,0.34,1,91,9.89,32,66705.0,13:53,451,517,968,46.59,43,25,30,25,5,6,6,12,11150.0,2:19,0,2,2,8135.0,1:41,3000000
8467331,Brad,Stuart,1979-11-06,D,L,2014-15,65,3,10,13,0.2,-4,64,4.69,16,79375.0,20:21,1,0,1,100.0,177,134,15,22,-7,0,1,1,1241.0,0:19,0,0,0,9996.0,2:33,3600000
8467332,Bryan,Allen,1980-08-21,D,L,2014-15,11,0,2,2,0.18,-2,6,0.0,6,10377.0,15:43,0,0,0,0.0,20,15,0,8,-8,0,0,0,0.0,0:0,0,0,0,948.0,1:26,3500000
8467334,Manny,Malhotra,1980-05-18,C,L,2014-15,58,1,3,4,0.07,-6,46,2.17,12,37769.0,10:51,537,369,906,59.27,37,62,14,23,-9,0,0,0,148.0,0:2,0,0,0,8326.0,2:23,850000
8467338,Alex,Tanguay,1979-11-21,LW,L,2014-15,80,22,33,55,0.69,-1,104,21.15,40,87172.0,18:9,12,16,28,42.86,45,39,34,33,1,2,12,14,11467.0,2:23,1,0,1,6870.0,1:25,3500000
8467344,Robyn,Regehr,1980-04-19,D,L,2014-15,67,3,10,13,0.19,10,63,4.76,45,81713.0,20:19,0,0,0,0.0,203,83,12,34,-22,0,0,0,528.0,0:7,0,1,1,10430.0,2:35,3000000
8467346,Simon,Gagne,1980-02-29,LW,L,2014-15,23,3,1,4,0.17,0,27,11.11,4,15604.0,11:18,1,8,9,11.11,20,7,3,7,-4,0,0,0,52.0,0:2,0,0,0,566.0,0:24,600000
8467351,Scott,Gomez,1979-12-23,C,L,2014-15,58,7,27,34,0.59,-10,70,10.0,23,57466.0,16:30,367,421,788,46.57,24,15,22,37,-15,0,14,14,6620.0,1:54,0,0,0,214.0,0:3,550000
8467370,Mike,Fisher,1980-06-05,C,R,2014-15,59,19,20,39,0.66,4,111,17.12,39,65256.0,18:26,601,548,1149,52.31,125,60,27,16,11,7,3,10,9668.0,2:43,1,0,1,5828.0,1:38,4200000
8467371,Mike,Ribeiro,1980-02-10,C,L,2014-15,82,15,47,62,0.76,11,96,15.62,52,92232.0,18:44,582,766,1348,43.18,42,19,32,47,-15,1,11,12,14308.0,2:54,0,0,0,141.0,0:1,5500000
8467389,Brad,Richards,1980-05-02,C,L,2014-15,76,12,25,37,0.49,3,199,6.03,12,67889.0,14:53,399,426,825,48.36,32,27,22,31,-9,2,5,7,9318.0,2:2,0,0,0,97.0,0:1,6666666
8467396,Erik,Cole,1978-11-06,LW,L,2014-15,68,21,18,39,0.57,2,122,17.21,14,59353.0,14:32,5,11,16,31.25,134,20,24,28,-4,3,6,9,7480.0,1:50,1,0,1,1479.0,0:21,4500000
8467400,Francois,Beauchemin,1980-06-04,D,L,2014-15,64,11,12,23,0.36,17,110,10.0,48,87338.0,22:44,1,0,1,100.0,105,107,18,40,-22,2,1,3,5911.0,1:32,0,1,1,8550.0,2:13,3500000
8467407,Brian,Gionta,1979-01-18,RW,R,2014-15,69,13,22,35,0.51,-13,153,8.5,18,74745.0,18:3,69,100,169,40.83,61,31,31,20,11,3,6,9,8561.0,2:4,1,0,1,5330.0,1:17,4250000
8467423,Shawn,Horcoff,1978-09-17,C,L,2014-15,76,11,18,29,0.38,9,82,13.41,27,59369.0,13:1,237,235,472,50.21,80,25,20,22,-2,4,1,5,7430.0,1:37,0,0,0,4096.0,0:53,5500000
8467452,Rob,Scuderi,1978-12-30,D,L,2014-15,82,1,9,10,0.12,9,52,1.92,17,94198.0,19:8,0,0,0,0.0,41,110,8,44,-36,0,0,0,306.0,0:3,0,1,1,15527.0,3:9,3375000
8467493,Chris,Neil,1979-06-18,RW,R,2014-15,38,4,3,7,0.18,5,23,17.39,78,22198.0,9:44,3,2,5,60.0,136,11,4,2,2,1,0,1,342.0,0:9,0,0,0,45.0,0:1,1900000
8467496,Andrei,Markov,1978-12-20,D,L,2014-15,81,10,40,50,0.62,22,135,7.41,38,121064.0,24:54,0,0,0,0.0,53,173,46,79,-33,4,21,25,15761.0,3:14,0,1,1,12190.0,2:30,5750000
8467514,Pavel,Datsyuk,1978-07-20,C,L,2014-15,63,26,39,65,1.03,12,165,15.76,8,72014.0,19:3,601,521,1122,53.57,51,28,59,29,30,8,16,24,10852.0,2:52,0,0,0,398.0,0:6,7500000
8467545,Michael,Ryder,1980-03-31,RW,R,2014-15,47,6,13,19,0.4,-1,89,6.74,30,40835.0,14:28,2,4,6,33.33,53,14,10,15,-5,0,2,2,4175.0,1:28,0,0,0,55.0,0:1,3500000
8467875,Daniel,Sedin,1980-09-26,LW,L,2014-15,82,20,56,76,0.93,5,226,8.85,18,90316.0,18:21,2,3,5,40.0,21,16,19,36,-17,4,21,25,14772.0,3:0,0,0,0,3603.0,0:43,7000000
8467876,Henrik,Sedin,1980-09-26,C,L,2014-15,82,18,55,73,0.89,11,101,17.82,22,91570.0,18:36,704,861,1565,44.98,25,24,33,38,-5,5,20,25,14651.0,2:58,0,0,0,4023.0,0:49,7000000
8467890,Barret,Jackman,1981-03-05,D,L,2014-15,80,2,13,15,0.19,3,86,2.33,47,80717.0,16:48,0,0,0,0.0,108,126,17,30,-13,0,0,0,68.0,0:0,0,1,1,10949.0,2:16,3166667
8467899,Martin,Havlat,1981-04-19,RW,L,2014-15,40,5,9,14,0.35,-11,49,10.2,10,35538.0,14:48,0,0,0,0.0,11,11,20,12,8,3,3,6,3874.0,1:36,0,0,0,91.0,0:2,1500000
8467917,Jordan,Leopold,1980-08-03,D,L,2014-15,43,1,3,4,0.09,-6,39,2.56,19,38501.0,14:55,0,0,0,0.0,33,50,9,8,1,1,0,1,686.0,0:15,0,0,0,1065.0,0:24,2250000
8467967,Chris,Kelly,1980-11-11,C,L,2014-15,80,7,21,28,0.35,6,112,6.25,48,72676.0,15:8,262,277,539,48.61,126,61,28,16,12,0,0,0,407.0,0:5,1,1,2,8450.0,1:45,3000000
8467977,Brian,McGrattan,1981-09-02,RW,R,2014-15,8,0,0,0,0.0,-2,10,0.0,4,3186.0,6:38,0,0,0,0.0,11,1,3,0,3,0,0,0,18.0,0:2,0,0,0,0.0,0:0,750000
8467988,Ryan,Malone,1979-12-01,LW,L,2014-15,6,0,0,0,0.0,-4,6,0.0,4,3610.0,10:1,1,0,1,100.0,14,2,0,3,-3,0,0,0,800.0,2:13,0,0,0,0.0,0:0,4500000
8468001,Derek,MacKenzie,1981-06-11,C,L,2014-15,82,5,6,11,0.13,-17,72,6.94,45,61258.0,12:27,543,479,1022,53.13,273,51,26,12,14,1,0,1,906.0,0:11,0,0,0,11769.0,2:23,1300000
8468064,Martin,Erat,1981-08-29,RW,L,2014-15,79,9,23,32,0.41,-16,91,9.89,48,75203.0,15:51,0,6,6,0.0,96,25,27,26,1,3,3,6,7881.0,1:39,0,0,0,2413.0,0:30,4500000
8468083,Henrik,Zetterberg,1980-10-09,C,L,2014-15,77,17,49,66,0.86,-6,227,7.49,32,88293.0,19:6,541,523,1064,50.85,55,26,37,29,8,4,24,28,14901.0,3:13,0,0,0,407.0,0:5,6083333
8468085,Radim,Vrbata,1981-06-13,RW,R,2014-15,79,31,32,63,0.8,6,267,11.61,20,78740.0,16:36,5,4,9,55.56,44,25,33,26,7,12,11,23,13820.0,2:54,0,0,0,404.0,0:5,5000000
8468208,Joel,Ward,1980-12-02,RW,R,2014-15,82,19,15,34,0.41,-4,138,13.77,30,82960.0,16:51,60,67,127,47.24,53,38,39,19,20,6,5,11,7488.0,1:31,0,0,0,8193.0,1:39,3000000
8468309,Mark,Streit,1977-12-11,D,L,2014-15,81,9,43,52,0.64,-8,144,6.25,36,108708.0,22:22,0,0,0,0.0,63,103,16,41,-25,4,26,30,17440.0,3:35,0,0,0,1712.0,0:21,5250000
8468478,Mike,Weaver,1978-05-02,D,R,2014-15,31,0,4,4,0.13,0,8,0.0,6,26345.0,14:9,0,0,0,0.0,35,61,5,17,-12,0,0,0,3.0,0:0,0,0,0,5522.0,2:58,1750000
8468482,Dany,Heatley,1981-01-21,LW,L,2014-15,6,0,0,0,0.0,-3,8,0.0,0,4365.0,12:7,0,0,0,0.0,5,3,1,0,1,0,0,0,342.0,0:57,0,0,0,0.0,0:0,1000000
8468483,Marian,Gaborik,1982-02-14,RW,L,2014-15,69,27,20,47,0.68,7,174,15.52,16,70028.0,16:54,1,0,1,100.0,39,6,18,43,-25,11,7,18,11390.0,2:45,0,0,0,189.0,0:2,4875000
8468486,Scott,Hartnell,1982-04-18,LW,L,2014-15,77,28,32,60,0.78,1,204,13.73,100,79912.0,17:17,7,7,14,50.0,160,38,36,40,-4,8,8,16,12298.0,2:39,0,0,0,246.0,0:3,4750000
8468493,Ron,Hainsey,1981-03-24,D,L,2014-15,81,2,8,10,0.12,-14,83,2.41,16,102530.0,21:5,1,0,1,100.0,110,120,22,48,-26,0,1,1,1308.0,0:16,0,0,0,9876.0,2:1,2833333
8468498,Brooks,Orpik,1980-09-26,D,L,2014-15,78,0,19,19,0.24,5,66,0.0,66,101989.0,21:47,0,0,0,0.0,306,192,11,37,-26,0,0,0,175.0,0:2,0,0,0,13049.0,2:47,5500000
8468501,Anton,Volchenkov,1982-02-25,D,L,2014-15,46,0,7,7,0.15,4,35,0.0,14,36372.0,13:10,0,0,0,0.0,93,48,3,13,-10,0,0,0,72.0,0:1,0,0,0,3032.0,1:5,4250000
8468504,Brad,Boyes,1982-04-17,RW,R,2014-15,78,14,24,38,0.49,11,151,9.27,20,73244.0,15:39,97,76,173,56.07,60,38,41,31,10,5,4,9,9463.0,2:1,0,0,0,253.0,0:3,2625000
8468505,Steve,Ott,1982-08-19,C,L,2014-15,78,3,9,12,0.15,-8,49,6.12,86,54448.0,11:38,160,124,284,56.34,184,14,21,8,13,0,0,0,894.0,0:11,0,0,0,6886.0,1:28,2600000
8468508,Justin,Williams,1981-10-04,RW,R,2014-15,81,18,23,41,0.51,8,174,10.34,29,76885.0,15:49,3,3,6,50.0,29,24,25,57,-32,4,9,13,7875.0,1:37,0,0,0,688.0,0:8,3825000
8468509,Niklas,Kronwall,1981-01-12,D,L,2014-15,80,9,35,44,0.55,-4,101,8.91,40,114423.0,23:50,1,0,1,100.0,91,106,11,52,-41,3,20,23,15444.0,3:13,0,0,0,13702.0,2:51,4750000
8468513,Nick,Schultz,1982-08-25,D,L,2014-15,80,2,13,15,0.19,2,69,2.9,47,91425.0,19:2,0,0,0,0.0,113,166,6,23,-17,0,1,1,970.0,0:12,0,0,0,12956.0,2:41,1250000
8468518,Tomas,Kopecky,1982-02-05,RW,L,2014-15,64,2,6,8,0.12,-19,106,1.89,28,49550.0,12:54,3,1,4,75.0,88,22,11,12,-1,0,0,0,464.0,0:7,0,0,0,8819.0,2:17,3000000
8468526,Jarret,Stoll,1982-06-24,C,R,2014-15,73,6,11,17,0.23,3,83,7.23,58,67845.0,15:29,592,569,1161,50.99,167,57,11,17,-6,3,1,4,4591.0,1:2,0,2,2,6585.0,1:30,3250000
8468535,Antoine,Vermette,1982-07-20,C,L,2014-15,82,13,25,38,0.46,-25,109,11.93,40,87782.0,17:50,872,705,1577,55.29,80,50,30,36,-6,6,8,14,11192.0,2:16,0,0,0,7105.0,1:26,3750000
8468542,Paul,Martin,1981-03-05,D,L,2014-15,74,3,17,20,0.27,17,61,4.92,20,101191.0,22:47,0,0,0,0.0,60,139,24,37,-13,0,1,1,7221.0,1:37,0,0,0,11505.0,2:35,5000000
8468575,Dominic,Moore,1980-08-03,C,L,2014-15,82,10,17,27,0.33,5,116,8.62,28,67944.0,13:48,585,489,1074,54.47,55,45,30,19,11,0,1,1,204.0,0:2,2,0,2,10417.0,2:7,1500000
8468598,Lubomir,Visnovsky,1976-08-11,D,L,2014-15,53,5,15,20,0.38,-3,85,5.88,8,62097.0,19:31,0,1,1,0.0,38,61,46,46,0,2,3,5,8481.0,2:40,0,0,0,167.0,0:3,4750000
8468611,Matt,Hendricks,1981-06-17,C,L,2014-15,71,8,8,16,0.23,-14,103,7.77,76,56028.0,13:9,98,100,198,49.49,220,72,31,15,16,0,1,1,1099.0,0:15,1,0,1,9265.0,2:10,1850000
8468635,Travis,Moen,1982-04-06,LW,L,2014-15,44,3,6,9,0.2,0,34,8.82,18,24768.0,9:22,0,4,4,0.0,62,24,7,7,0,0,0,0,8.0,0:0,0,0,0,1957.0,0:44,1850000
8468639,John-Michael,Liles,1980-11-25,D,L,2014-15,57,2,20,22,0.39,-9,90,2.22,14,65489.0,19:8,0,0,0,0.0,71,74,19,38,-19,0,7,7,6598.0,1:55,0,0,0,1199.0,0:21,3875000
8468674,Deryk,Engelland,1982-04-03,D,R,2014-15,76,2,9,11,0.14,-16,51,3.92,53,65591.0,14:23,0,0,0,0.0,132,141,20,38,-18,0,0,0,39.0,0:0,0,1,1,3971.0,0:52,2916667
8468700,Paul,Gaustad,1982-02-03,C,L,2014-15,73,4,10,14,0.19,7,54,7.41,60,54459.0,12:26,619,478,1097,56.43,143,58,19,10,9,0,0,0,395.0,0:5,0,0,0,9862.0,2:15,3250000
8469455,Jason,Spezza,1983-06-13,C,R,2014-15,82,17,45,62,0.76,-7,204,8.33,28,84735.0,17:13,682,580,1262,54.04,16,26,51,75,-24,4,22,26,17996.0,3:39,0,0,0,287.0,0:3,7000000
8469457,Stephen,Weiss,1983-04-03,C,L,2014-15,52,9,16,25,0.48,-2,52,17.31,16,35391.0,11:20,10,11,21,47.62,19,12,9,18,-9,3,6,9,6626.0,2:7,0,0,0,0.0,0:0,4900000
8469459,Mikko,Koivu,1983-03-12,C,L,2014-15,80,14,34,48,0.6,2,179,7.82,38,92498.0,19:16,989,802,1791,55.22,40,41,60,26,34,4,11,15,15671.0,3:15,0,0,0,6479.0,1:20,6750000
8469462,Tuomo,Ruutu,1983-02-16,LW,L,2014-15,77,7,6,13,0.17,-3,74,9.46,28,50196.0,10:51,4,5,9,44.44,174,23,15,22,-7,0,0,0,531.0,0:6,0,0,0,1257.0,0:16,4750000
8469465,Dan,Hamhuis,1982-12-13,D,L,2014-15,59,1,22,23,0.39,0,82,1.22,44,76221.0,21:31,0,0,0,0.0,82,71,18,47,-29,1,2,3,6221.0,1:45,0,0,0,7940.0,2:14,4500000
8469466,Ales,Hemsky,1983-08-13,RW,R,2014-15,76,11,21,32,0.42,-8,140,7.86,16,62201.0,13:38,0,0,0,0.0,22,35,30,37,-7,1,7,8,9004.0,1:58,0,0,0,33.0,0:0,4000000
8469469,R.J.,Umberger,1982-05-03,C,L,2014-15,67,9,6,15,0.22,-9,96,9.38,19,55551.0,13:49,9,13,22,40.91,114,40,9,11,-2,2,0,2,5303.0,1:19,0,0,0,3935.0,0:58,4600000
8469470,Carlo,Colaiacovo,1983-01-27,D,L,2014-15,33,2,6,8,0.24,0,42,4.76,10,32640.0,16:29,0,0,0,0.0,46,33,10,18,-8,0,2,2,1383.0,0:41,0,0,0,136.0,0:4,625000
8469473,Marcel,Goc,1983-08-24,C,L,2014-15,74,3,6,9,0.12,-3,77,3.9,8,51868.0,11:40,372,313,685,54.31,87,35,18,13,5,0,0,0,1252.0,0:16,0,1,1,10166.0,2:17,1200000
8469476,Tim,Gleason,1983-01-29,D,L,2014-15,72,1,8,9,0.12,-13,54,1.85,55,70555.0,16:19,0,0,0,0.0,167,108,11,22,-11,0,0,0,117.0,0:1,0,0,0,7584.0,1:45,4000000
8469485,Derek,Roy,1983-05-04,C,L,2014-15,72,12,20,32,0.44,-13,113,10.62,24,67702.0,15:40,407,502,909,44.77,32,43,42,34,8,4,3,7,7014.0,1:37,0,0,0,1411.0,0:19,1000000
8469490,Tim,Jackman,1981-11-14,RW,R,2014-15,55,5,2,7,0.13,-4,55,9.09,86,27656.0,8:22,10,4,14,71.43,110,19,6,6,0,0,0,0,156.0,0:2,0,0,0,89.0,0:1,637500
8469492,Fedor,Tyutin,1983-07-19,D,L,2014-15,67,3,12,15,0.22,8,56,5.36,40,80094.0,19:55,0,0,0,0.0,106,117,10,23,-13,0,1,1,1335.0,0:19,0,2,2,11474.0,2:51,4500000
8469500,Michael,Cammalleri,1982-06-08,LW,L,2014-15,68,27,15,42,0.62,2,156,17.31,28,74791.0,18:19,119,163,282,42.2,30,17,29,33,-4,9,2,11,8901.0,2:10,2,0,2,5444.0,1:20,5000000
8469501,Chris,Thorburn,1983-06-03,RW,R,2014-15,81,7,7,14,0.17,-5,67,10.45,76,39301.0,8:5,36,20,56,64.29,126,29,9,12,-3,0,0,0,510.0,0:6,0,0,0,105.0,0:1,1200000
8469506,Jason,Pominville,1982-11-30,RW,R,2014-15,82,18,36,54,0.66,9,252,7.14,8,89964.0,18:17,39,48,87,44.83,44,32,35,21,14,3,11,14,16495.0,3:21,0,0,0,119.0,0:1,5600000
8469508,Jay,McClement,1983-03-02,C,L,2014-15,82,7,14,21,0.26,-7,68,10.29,17,66803.0,13:34,549,441,990,55.45,79,53,42,14,28,0,0,0,867.0,0:10,0,0,0,10738.0,2:10,1000000
8469521,Tomas,Plekanec,1982-10-31,C,L,2014-15,82,26,34,60,0.73,8,248,10.48,46,94246.0,19:9,777,780,1557,49.9,47,55,30,42,-12,7,9,16,10774.0,2:11,3,1,4,9438.0,1:55,5000000
8469531,Jay,Harrison,1982-11-03,D,L,2014-15,55,3,6,9,0.16,-1,50,6.0,65,52577.0,15:55,0,0,0,0.0,76,74,16,32,-16,1,1,2,1800.0,0:32,0,0,0,5266.0,1:35,1500000
8469542,Stephane,Veilleux,1981-11-16,LW,L,2014-15,12,1,1,2,0.17,0,9,11.11,10,5540.0,7:41,0,1,1,0.0,9,8,2,0,2,0,0,0,1.0,0:0,0,0,0,927.0,1:17,587500
8469544,Patrick,Sharp,1981-12-27,LW,R,2014-15,68,16,27,43,0.63,-8,230,6.96,33,68588.0,16:48,53,55,108,49.07,74,15,38,25,13,8,6,14,11683.0,2:51,0,0,0,126.0,0:1,5900000
8469547,Jordin,Tootoo,1983-02-02,RW,R,2014-15,68,10,5,15,0.22,1,75,13.33,72,42667.0,10:27,1,0,1,100.0,127,8,17,29,-12,1,0,1,3412.0,0:50,0,0,0,77.0,0:1,550000
8469555,Christian,Ehrhoff,1982-07-06,D,L,2014-15,49,3,11,14,0.29,8,110,2.73,26,63971.0,21:45,0,0,0,0.0,73,49,12,21,-9,0,2,2,5958.0,2:1,0,0,0,5434.0,1:50,4000000
8469591,Cody,McCormick,1983-04-18,C,R,2014-15,33,1,3,4,0.12,-9,31,3.23,40,23193.0,11:42,147,147,294,50.0,77,29,3,10,-7,0,0,0,90.0,0:2,1,0,1,4383.0,2:12,1500000
8469598,Kevin,Bieksa,1981-06-16,D,R,2014-15,60,4,10,14,0.23,0,99,4.04,77,74999.0,20:49,0,0,0,0.0,109,93,19,64,-45,0,1,1,5138.0,1:25,0,1,1,6761.0,1:52,4600000
8469619,Dennis,Seidenberg,1981-07-18,D,L,2014-15,82,3,11,14,0.17,-1,103,2.91,34,108736.0,22:6,0,0,0,0.0,212,146,8,24,-16,0,0,0,1036.0,0:12,0,0,0,12594.0,2:33,4000000
8469622,Ryane,Clowe,1982-09-30,LW,L,2014-15,13,1,3,4,0.31,-1,15,6.67,4,12224.0,15:40,0,1,1,0.0,21,1,3,3,0,0,0,0,2147.0,2:45,0,0,0,19.0,0:1,4850000
8469623,Marek,Zidlicky,1977-02-03,D,R,2014-15,84,7,27,34,0.4,-9,130,5.38,56,105619.0,20:57,0,1,1,0.0,95,92,20,44,-24,6,14,20,13235.0,2:37,0,0,0,735.0,0:8,3000000
8469638,Jussi,Jokinen,1983-04-01,LW,L,2014-15,81,8,36,44,0.54,-2,134,5.97,34,81347.0,16:44,126,124,250,50.4,52,50,29,26,3,2,7,9,10820.0,2:13,0,0,0,8447.0,1:44,4000000
8469639,Brooks,Laich,1983-06-23,C,L,2014-15,66,7,13,20,0.3,-2,106,6.6,24,58304.0,14:43,87,111,198,43.94,107,53,25,25,0,0,1,1,1507.0,0:22,0,1,1,8635.0,2:10,4500000
8469664,David,Moss,1981-12-28,RW,R,2014-15,60,4,8,12,0.2,-18,96,4.17,24,46491.0,12:54,6,7,13,46.15,115,36,18,10,8,1,1,2,1415.0,0:23,0,1,1,4902.0,1:21,800000
8469665,Johnny,Oduya,1981-10-01,D,L,2014-15,76,2,8,10,0.13,5,76,2.63,26,92504.0,20:17,0,0,0,0.0,69,123,22,44,-22,0,0,0,417.0,0:5,0,0,0,8095.0,1:46,3375000
8469707,PA,Parenteau,1983-03-24,RW,R,2014-15,56,8,14,22,0.39,0,97,8.25,30,50360.0,14:59,10,16,26,38.46,32,19,18,13,5,3,1,4,7479.0,2:13,0,0,0,78.0,0:1,4000000
8469759,Vernon,Fiddler,1980-05-09,C,L,2014-15,80,13,16,29,0.36,-5,132,9.85,34,63007.0,13:7,569,528,1097,51.87,43,61,32,21,11,3,0,3,2372.0,0:29,1,1,2,10193.0,2:7,1250000
8469760,Zbynek,Michalek,1982-12-23,D,R,2014-15,68,4,8,12,0.18,-3,86,4.65,18,84704.0,20:45,0,0,0,0.0,85,160,16,26,-10,0,0,0,178.0,0:2,0,0,0,11722.0,2:52,4000000
8469770,Dennis,Wideman,1983-03-20,D,R,2014-15,80,15,41,56,0.7,6,173,8.67,34,118284.0,24:38,0,0,0,0.0,94,184,51,92,-41,6,15,21,14814.0,3:5,0,0,0,6582.0,1:22,5250000
8470018,Matt,Ellis,1981-08-31,LW,L,2014-15,39,1,1,2,0.05,-12,29,3.45,4,19478.0,8:19,100,105,205,48.78,10,16,12,2,10,0,0,0,59.0,0:1,0,0,0,2660.0,1:8,550000
8470039,Tomas,Fleischmann,1984-05-16,LW,L,2014-15,66,8,19,27,0.41,12,131,6.11,12,58223.0,14:42,4,10,14,28.57,64,15,30,15,15,0,1,1,4555.0,1:9,0,0,0,3222.0,0:48,4500000
8470041,Rick,Nash,1984-06-16,LW,L,2014-15,79,42,27,69,0.87,29,304,13.82,36,82727.0,17:27,2,2,4,50.0,45,33,74,42,32,6,6,12,12721.0,2:41,4,1,5,6369.0,1:20,7800000
8470047,Valtteri,Filppula,1984-03-20,C,L,2014-15,82,12,36,48,0.59,-14,91,13.19,24,93562.0,19:1,621,564,1185,52.41,25,29,50,27,23,2,15,17,16664.0,3:23,0,0,0,6024.0,1:13,5000000
8470054,Keith,Ballard,1982-11-26,D,L,2014-15,14,0,1,1,0.07,-3,5,0.0,26,10126.0,12:3,0,0,0,0.0,15,20,2,5,-3,0,0,0,31.0,0:2,0,0,0,610.0,0:43,1500000
8470063,Adam,Burish,1983-01-06,RW,R,2014-15,20,1,2,3,0.15,-6,22,4.55,33,13374.0,11:8,57,50,107,53.27,11,19,4,2,2,0,0,0,79.0,0:3,0,0,0,1806.0,1:30,1850000
8470065,Ryan,Craig,1982-01-06,C,L,2014-15,2,0,0,0,0.0,0,2,0.0,0,873.0,7:16,0,0,0,0.0,2,0,0,0,0,0,0,0,0.0,0:0,0,0,0,0.0,0:0,600000
8470104,Tom,Gilbert,1983-01-10,D,R,2014-15,72,4,8,12,0.17,10,70,5.71,30,83546.0,19:20,0,0,0,0.0,55,164,11,53,-42,0,0,0,3335.0,0:46,0,0,0,8325.0,1:55,2800000
8470105,Scottie,Upshall,1983-10-07,RW,L,2014-15,63,8,7,15,0.24,-8,93,8.6,28,47938.0,12:40,34,31,65,52.31,128,27,19,7,12,0,1,1,1737.0,0:27,0,0,0,4805.0,1:16,3500000
8470110,Trevor,Daley,1983-10-09,D,L,2014-15,68,16,22,38,0.56,-13,113,14.16,34,93331.0,22:52,0,0,0,0.0,29,123,29,32,-3,6,6,12,11211.0,2:44,2,0,2,11863.0,2:54,3300000
8470120,Alexander,Semin,1984-03-03,RW,R,2014-15,57,6,13,19,0.33,-10,93,6.45,32,54459.0,15:55,3,6,9,33.33,30,17,48,34,14,0,4,4,5151.0,1:30,0,0,0,44.0,0:0,7000000
8470121,Matt,Greene,1983-05-13,D,R,2014-15,82,3,6,9,0.11,1,69,4.35,54,77741.0,15:48,0,0,0,0.0,209,129,8,48,-40,0,0,0,345.0,0:4,0,0,0,9781.0,1:59,2500000
8470144,Frans,Nielsen,1984-04-24,C,L,2014-15,78,14,29,43,0.55,8,157,8.92,12,77593.0,16:34,506,544,1050,48.19,48,80,56,38,18,4,14,18,13358.0,2:51,1,2,3,8173.0,1:44,2750000
8470151,Jay,Bouwmeester,1983-09-27,D,L,2014-15,72,2,11,13,0.18,7,92,2.17,24,97913.0,22:39,0,0,0,0.0,42,99,14,18,-4,0,4,4,5362.0,1:14,0,0,0,12192.0,2:49,5400000
8470152,Joakim,Lindstrom,1983-12-05,C,L,2014-15,53,4,6,10,0.19,-15,61,6.56,12,34584.0,10:52,7,16,23,30.43,14,5,20,13,7,2,3,5,2771.0,0:52,0,0,0,33.0,0:0,700000
8470159,Boyd,Gordon,1983-10-19,C,R,2014-15,68,6,7,13,0.19,-5,65,9.23,17,54368.0,13:19,681,537,1218,55.91,31,80,21,19,2,1,0,1,2074.0,0:30,1,1,2,9812.0,2:24,3000000
8470162,Matt,Stajan,1983-12-19,C,L,2014-15,59,7,10,17,0.29,7,46,15.22,28,42472.0,11:59,303,299,602,50.33,72,21,33,30,3,0,0,0,299.0,0:5,0,1,1,4821.0,1:21,3125000
8470169,Gregory,Campbell,1983-12-17,C,L,2014-15,70,6,6,12,0.17,1,64,9.38,45,50967.0,12:8,339,293,632,53.64,119,41,13,12,1,0,0,0,317.0,0:4,1,0,1,6389.0,1:31,1600000
8470171,Max,Talbot,1984-02-11,C,L,2014-15,81,5,13,18,0.22,-1,97,5.15,29,66147.0,13:36,76,82,158,48.1,132,51,44,16,28,0,0,0,1285.0,0:15,0,0,0,9966.0,2:3,1800000
8470176,Sean,Bergenheim,1984-02-08,LW,L,2014-15,56,9,10,19,0.34,-2,108,8.33,40,44074.0,13:7,2,4,6,33.33,73,13,34,10,24,0,2,2,1395.0,0:24,0,0,0,386.0,0:6,2750000
8470180,Eric,Nystrom,1983-02-14,LW,L,2014-15,60,7,5,12,0.2,0,60,11.67,15,47501.0,13:11,4,8,12,33.33,104,29,9,11,-2,0,0,0,183.0,0:3,1,0,1,8184.0,2:16,2500000
8470187,Johnny,Boychuk,1984-01-19,D,R,2014-15,72,9,26,35,0.49,15,192,4.69,14,93660.0,21:40,2,0,2,100.0,171,149,24,48,-24,5,10,15,11523.0,2:40,0,1,1,8828.0,2:2,3366667
8470189,David,Van Der Gulik,1983-04-20,LW,L,2014-15,1,0,0,0,0.0,0,1,0.0,0,315.0,5:15,0,0,0,0.0,1,0,0,1,-1,0,0,0,7.0,0:7,0,0,0,0.0,0:0,550000
8470201,Jiri,Hudler,1984-01-04,RW,L,2014-15,78,31,45,76,0.97,17,158,19.62,14,84284.0,18:0,21,25,46,45.65,27,14,43,32,11,6,10,16,13945.0,2:58,0,0,0,193.0,0:2,4000000
8470207,Joffrey,Lupul,1983-09-23,LW,R,2014-15,55,10,11,21,0.38,-10,97,10.31,26,51118.0,15:29,4,2,6,66.67,78,20,36,22,14,2,1,3,7135.0,2:9,0,0,0,115.0,0:2,5250000
8470222,James,Wisniewski,1984-02-21,D,R,2014-15,69,8,26,34,0.49,-13,147,5.44,44,87728.0,21:11,0,0,0,0.0,115,81,12,33,-21,7,8,15,12619.0,3:2,0,0,0,7379.0,1:46,5500000
8470230,Daniel,Paille,1984-04-15,LW,L,2014-15,71,6,7,13,0.18,-9,66,9.09,12,49046.0,11:30,2,5,7,28.57,77,34,29,26,3,0,0,0,203.0,0:2,1,1,2,5761.0,1:21,1300000
8470257,Alexander,Steen,1984-03-01,LW,L,2014-15,74,24,40,64,0.86,8,223,10.76,33,88714.0,19:58,218,215,433,50.35,32,37,39,32,7,8,16,24,14647.0,3:17,0,0,0,7773.0,1:45,5800000
8470274,Chris,Higgins,1983-06-02,LW,L,2014-15,77,12,24,36,0.47,8,171,7.02,16,72955.0,15:47,3,6,9,33.33,73,34,28,19,9,3,2,5,7872.0,1:42,0,0,0,8068.0,1:44,2500000
8470281,Duncan,Keith,1983-07-16,D,L,2014-15,80,10,35,45,0.56,12,171,5.85,20,122700.0,25:33,0,0,0,0.0,16,113,43,63,-20,3,13,16,16075.0,3:20,0,1,1,11259.0,2:20,5538462
8470289,Jim,Slater,1982-12-09,C,L,2014-15,82,5,8,13,0.16,-4,51,9.8,58,45312.0,9:12,448,303,751,59.65,134,52,13,14,-1,0,0,0,383.0,0:4,0,1,1,11144.0,2:15,1600000
8470302,Patrick,Dwyer,1983-06-22,RW,R,2014-15,71,5,7,12,0.17,-12,77,6.49,10,54413.0,12:46,5,14,19,26.32,145,38,26,14,12,0,0,0,503.0,0:7,0,1,1,8733.0,2:3,900000
8470317,Nate,Guenin,1982-12-10,D,R,2014-15,76,2,13,15,0.2,-1,38,5.26,32,76814.0,16:50,0,0,0,0.0,94,162,19,28,-9,0,0,0,153.0,0:2,0,0,0,10230.0,2:14,800000
8470318,Jonathan,Ericsson,1984-03-02,D,L,2014-15,82,3,12,15,0.18,-5,82,3.66,70,96336.0,19:34,0,0,0,0.0,114,55,13,58,-45,0,0,0,845.0,0:10,0,1,1,13160.0,2:40,4250000
8470324,Josh,Gorges,1984-08-14,D,L,2014-15,46,0,6,6,0.13,-28,28,0.0,16,61723.0,22:21,0,0,0,0.0,75,148,7,20,-13,0,0,0,2684.0,0:58,0,1,1,8179.0,2:57,3900000
8470358,Alexandre,Burrows,1981-04-11,RW,L,2014-15,70,18,15,33,0.47,0,145,12.41,68,65005.0,15:28,6,8,14,42.86,73,33,33,24,9,4,4,8,8632.0,2:3,1,0,1,5105.0,1:12,4500000
8470378,Andre,Benoit,1984-01-06,D,L,2014-15,59,1,8,9,0.15,-19,45,2.22,20,64250.0,18:8,0,0,0,0.0,38,98,10,20,-10,0,1,1,4382.0,1:14,1,0,1,4478.0,1:15,800000
8470543,Chris,Kunitz,1979-09-26,LW,L,2014-15,74,17,23,40,0.54,2,170,10.0,56,79427.0,17:53,7,6,13,53.85,211,29,31,24,7,9,7,16,13722.0,3:5,1,0,1,630.0,0:8,3850000
8470595,Eric,Staal,1984-10-29,C,L,2014-15,77,23,31,54,0.7,-13,244,9.43,41,87078.0,18:50,343,326,669,51.27,65,27,38,47,-9,7,10,17,12046.0,2:36,0,0,0,474.0,0:6,8250000
8470598,Thomas,Vanek,1984-01-19,LW,R,2014-15,80,21,31,52,0.65,-6,171,12.28,37,77801.0,16:12,10,10,20,50.0,32,13,28,52,-24,5,12,17,14425.0,3:0,0,0,0,60.0,0:0,6500000
8470599,Milan,Michalek,1984-12-07,LW,L,2014-15,66,13,21,34,0.52,3,130,10.0,33,64828.0,16:22,11,12,23,47.83,64,40,23,12,11,5,5,10,7947.0,2:0,1,0,1,6798.0,1:43,4000000
8470600,Ryan,Suter,1985-01-21,D,L,2014-15,77,2,36,38,0.49,7,150,1.33,48,134255.0,29:3,0,0,0,0.0,69,127,33,46,-13,1,10,11,17651.0,3:49,0,1,1,9532.0,2:3,7538462
8470601,Braydon,Coburn,1985-02-27,D,L,2014-15,43,1,10,11,0.26,2,46,2.17,25,51444.0,19:56,0,0,0,0.0,62,66,10,22,-12,0,0,0,342.0,0:7,0,0,0,7395.0,2:51,4500000
8470602,Dion,Phaneuf,1985-04-10,D,L,2014-15,70,3,26,29,0.41,-11,138,2.17,108,99614.0,23:43,0,0,0,0.0,166,126,30,43,-13,2,13,15,14929.0,3:33,0,1,1,11651.0,2:46,7000000
8470604,Jeff,Carter,1985-01-01,C,R,2014-15,82,28,34,62,0.76,7,218,12.84,28,88416.0,17:58,627,566,1193,52.56,76,33,29,44,-15,10,5,15,13652.0,2:46,1,1,2,6923.0,1:24,5272727
8470606,Dustin,Brown,1984-11-04,RW,R,2014-15,82,11,16,27,0.33,-17,189,5.82,26,81263.0,16:31,15,20,35,42.86,242,24,29,46,-17,1,5,6,7440.0,1:30,0,0,0,6533.0,1:19,5875000
8470607,Brent,Seabrook,1985-04-20,D,R,2014-15,82,8,23,31,0.38,-3,181,4.42,27,109122.0,22:10,0,0,0,0.0,135,141,27,65,-38,4,11,15,12007.0,2:26,0,1,1,8948.0,1:49,5800000
8470609,Steve,Bernier,1985-03-31,RW,R,2014-15,67,16,16,32,0.48,2,107,14.95,28,52004.0,12:56,1,1,2,50.0,123,47,17,14,3,4,4,8,5333.0,1:19,0,0,0,16.0,0:0,600000
8470610,Zach,Parise,1984-07-28,LW,L,2014-15,74,33,29,62,0.84,21,259,12.74,41,85197.0,19:11,2,10,12,16.67,86,56,47,24,23,11,5,16,14639.0,3:17,0,0,0,1787.0,0:24,7538462
8470611,Eric,Fehr,1985-09-07,C,R,2014-15,75,19,14,33,0.44,8,142,13.38,20,66825.0,14:51,449,414,863,52.03,84,47,48,21,27,1,0,1,809.0,0:10,1,0,1,6256.0,1:23,1500000
8470612,Ryan,Getzlaf,1985-05-10,C,R,2014-15,77,25,45,70,0.91,15,191,13.09,62,92857.0,20:5,632,617,1249,50.6,100,95,55,71,-16,3,10,13,14042.0,3:2,0,2,2,7895.0,1:42,8250000
8470613,Brent,Burns,1985-03-09,D,R,2014-15,82,17,43,60,0.73,-9,245,6.94,65,117862.0,23:57,0,0,0,0.0,148,124,46,101,-55,7,17,24,16725.0,3:23,0,0,0,9517.0,1:56,5760000
8470614,Mark,Stuart,1984-04-27,D,L,2014-15,70,2,12,14,0.2,5,51,3.92,69,80702.0,19:12,0,1,1,0.0,166,142,13,48,-35,0,0,0,112.0,0:1,0,2,2,13752.0,3:16,2625000
8470616,Ryan,Kesler,1984-08-31,C,R,2014-15,81,20,27,47,0.58,-5,205,9.76,75,94830.0,19:30,937,727,1664,56.31,169,69,47,27,20,5,6,11,12361.0,2:32,1,2,3,10734.0,2:12,5000000
8470617,Mike,Richards,1985-02-11,C,L,2014-15,53,5,11,16,0.3,-10,63,7.94,39,42503.0,13:21,289,304,593,48.74,62,10,22,32,-10,1,2,3,3999.0,1:15,0,0,0,2340.0,0:44,5750000
8470619,Brian,Boyle,1984-12-18,C,L,2014-15,82,15,9,24,0.29,3,140,10.71,54,63926.0,12:59,460,445,905,50.83,136,68,33,14,19,0,0,0,1206.0,0:14,3,0,3,11836.0,2:24,2000000
8470621,Corey,Perry,1985-05-16,RW,R,2014-15,67,33,22,55,0.82,13,193,17.1,67,72765.0,18:6,3,9,12,25.0,64,27,25,46,-21,4,3,7,11183.0,2:46,0,0,0,1000.0,0:14,8625000
8470622,Patrick,Eaves,1984-05-01,RW,R,2014-15,47,14,13,27,0.57,12,91,15.38,8,38683.0,13:43,2,3,5,40.0,69,27,18,10,8,6,3,9,5347.0,1:53,0,0,0,738.0,0:15,650000
8470626,Loui,Eriksson,1985-07-17,LW,L,2014-15,81,22,25,47,0.58,1,169,13.02,14,89798.0,18:28,4,8,12,33.33,29,23,45,24,21,6,5,11,11696.0,2:24,0,1,1,7805.0,1:36,4250000
8470630,Kevin,Klein,1984-12-13,D,R,2014-15,65,9,17,26,0.4,24,76,11.84,25,72110.0,18:29,0,1,1,0.0,126,115,15,44,-29,0,0,0,387.0,0:5,0,0,0,7079.0,1:48,2900000
8470638,Patrice,Bergeron,1985-07-24,C,R,2014-15,81,23,32,55,0.68,2,234,9.83,44,88117.0,18:7,1175,776,1951,60.23,57,60,48,29,19,4,10,14,11387.0,2:20,1,1,2,8484.0,1:44,6875000
8470640,Matt,Carle,1984-09-25,D,L,2014-15,59,4,14,18,0.31,12,73,5.48,26,72527.0,20:29,0,0,0,0.0,26,104,13,41,-28,1,0,1,2434.0,0:41,0,0,0,7218.0,2:2,5500000
8470642,Shea,Weber,1985-08-14,D,R,2014-15,78,15,30,45,0.58,15,237,6.33,72,123408.0,26:22,0,0,0,0.0,166,147,23,53,-30,5,10,15,14436.0,3:5,1,0,1,11506.0,2:27,7857143
8470644,Colin,McDonald,1984-09-30,RW,R,2014-15,18,2,6,8,0.44,-3,29,6.9,0,11348.0,10:30,2,2,4,50.0,72,6,2,5,-3,0,0,0,139.0,0:7,0,0,0,11.0,0:0,637500
8470647,B.J.,Crombeen,1985-07-10,RW,R,2014-15,58,3,3,6,0.1,-6,43,6.98,79,28169.0,8:5,1,0,1,100.0,68,12,7,5,2,0,0,0,94.0,0:1,0,0,0,48.0,0:0,1150000
8470654,Maxim,Lapierre,1985-03-29,C,R,2014-15,80,2,9,11,0.14,-15,86,2.33,32,51407.0,10:42,305,277,582,52.41,153,36,11,8,3,0,0,0,222.0,0:2,0,0,0,9431.0,1:57,1100000
8470655,David,Backes,1984-05-01,RW,R,2014-15,80,26,32,58,0.72,7,183,14.21,104,89477.0,18:38,617,513,1130,54.6,227,87,38,29,9,10,6,16,11609.0,2:25,0,0,0,8716.0,1:48,4500000
8470662,Colin,Fraser,1985-01-28,C,L,2014-15,1,0,0,0,0.0,-1,1,0.0,0,282.0,4:42,0,0,0,0.0,1,1,0,0,0,0,0,0,0.0,0:0,0,0,0,0.0,0:0,650000
8470666,Daniel,Carcillo,1985-01-28,LW,L,2014-15,39,4,4,8,0.21,3,42,9.52,54,19163.0,8:11,0,1,1,0.0,36,7,6,5,1,0,0,0,97.0,0:2,0,0,0,0.0,0:0,550000
8470667,Clarke,MacArthur,1985-04-06,LW,L,2014-15,62,16,20,36,0.58,-6,140,11.43,36,63257.0,17:0,8,14,22,36.36,70,17,31,36,-5,6,4,10,11049.0,2:58,0,0,0,1277.0,0:20,3250000
8470699,Jan,Hejda,1978-06-18,D,L,2014-15,81,1,12,13,0.16,-12,84,1.19,42,100377.0,20:39,0,0,0,0.0,170,140,22,30,-8,0,0,0,461.0,0:5,0,1,1,10876.0,2:14,3250000
8470714,Corey,Potter,1984-01-05,D,R,2014-15,6,0,0,0,0.0,-1,2,0.0,0,3478.0,9:39,0,0,0,0.0,6,5,1,4,-3,0,0,0,42.0,0:7,0,0,0,113.0,0:18,700000
8470719,Alexandre,Bolduc,1985-06-26,C,L,2014-15,3,0,0,0,0.0,-1,3,0.0,2,1919.0,10:39,10,9,19,52.63,17,1,0,0,0,0,0,0,0.0,0:0,0,0,0,0.0,0:0,600000
8470724,Kyle,Quincey,1985-08-12,D,L,2014-15,73,3,15,18,0.25,10,90,3.33,77,85315.0,19:28,0,0,0,0.0,104,82,15,24,-9,0,0,0,878.0,0:12,0,1,1,9655.0,2:12,4250000
8470729,Tyson,Strachan,1984-10-30,D,R,2014-15,46,0,5,5,0.11,-30,38,0.0,44,52397.0,18:59,0,0,0,0.0,67,105,13,24,-11,0,0,0,326.0,0:7,0,1,1,5921.0,2:8,650000
8470740,Lee,Stempniak,1983-02-04,RW,R,2014-15,71,15,13,28,0.39,8,115,13.04,20,54192.0,12:43,12,20,32,37.5,78,23,17,29,-12,0,1,1,3981.0,0:56,0,0,0,1968.0,0:27,900000
8470750,John,Mitchell,1985-01-22,C,L,2014-15,68,11,15,26,0.38,-9,105,10.48,32,64695.0,15:51,374,361,735,50.88,143,56,38,18,20,3,1,4,4023.0,0:59,1,0,1,2381.0,0:35,1800000
8470755,Brad,Richardson,1985-02-04,C,L,2014-15,45,8,13,21,0.47,0,66,12.12,34,39073.0,14:28,276,302,578,47.75,58,20,12,6,6,0,1,1,369.0,0:8,1,0,1,5297.0,1:57,1150000
8470760,Marc,Methot,1985-06-21,D,L,2014-15,45,1,10,11,0.24,22,49,2.04,18,61201.0,22:40,0,1,1,0.0,94,70,12,24,-12,0,0,0,504.0,0:11,0,0,0,4776.0,1:46,3000000
8470775,Nate,Thompson,1984-10-05,C,L,2014-15,80,5,13,18,0.22,0,87,5.75,39,63956.0,13:19,557,499,1056,52.75,204,52,26,21,5,0,0,0,696.0,0:8,1,0,1,8706.0,1:48,1600000
8470778,Drew,Miller,1984-02-17,LW,L,2014-15,82,5,8,13,0.16,-3,98,5.1,25,66123.0,13:26,6,13,19,31.58,119,99,24,11,13,0,1,1,506.0,0:6,1,0,1,15432.0,3:8,1350000
8470794,Joe,Pavelski,1984-07-11,C,R,2014-15,82,37,33,70,0.85,12,261,14.18,29,99015.0,20:7,642,505,1147,55.97,97,86,57,64,-7,19,12,31,16110.0,3:16,0,0,0,7548.0,1:32,6000000
8470798,Dylan,Reese,1984-08-29,D,R,2014-15,1,0,0,0,0.0,-1,3,0.0,0,1198.0,19:58,0,0,0,0.0,2,2,2,1,1,0,0,0,0.0,0:0,0,0,0,69.0,1:9,550000
8470803,Kyle,Brodziak,1984-05-25,C,R,2014-15,73,9,11,20,0.27,-6,86,10.47,47,57134.0,13:2,338,349,687,49.2,56,63,28,10,18,0,0,0,208.0,0:2,1,0,1,10437.0,2:22,2833333
8470828,Toby,Enstrom,1984-11-05,D,L,2014-15,60,4,19,23,0.38,13,58,6.9,36,84850.0,23:34,0,0,0,0.0,27,93,12,37,-25,1,6,7,11041.0,3:4,0,0,0,6569.0,1:49,5750000
8470834,Dustin,Byfuglien,1985-03-27,D,R,2014-15,69,18,27,45,0.65,5,209,8.61,124,93928.0,22:41,0,3,3,0.0,203,59,47,56,-9,5,12,17,15921.0,3:50,0,1,1,4989.0,1:12,5200000
8470839,Shane,O'Brien,1983-08-09,D,L,2014-15,9,0,1,1,0.11,-4,4,0.0,5,7279.0,13:28,0,0,0,0.0,36,12,0,3,-3,0,0,0,59.0,0:6,0,0,0,338.0,0:37,2000000
8470852,Matt,Moulson,1983-11-01,LW,L,2014-15,77,13,28,41,0.53,-11,156,8.33,4,81718.0,17:41,13,9,22,59.09,34,49,26,21,5,3,8,11,12685.0,2:44,0,0,0,846.0,0:10,5000000
8470854,Tanner,Glass,1983-11-29,LW,L,2014-15,66,1,5,6,0.09,-12,53,1.89,98,40562.0,10:14,7,14,21,33.33,213,32,8,15,-7,0,0,0,105.0,0:1,0,0,0,4036.0,1:1,1450000
8470867,Troy,Bodie,1985-01-25,RW,R,2014-15,5,0,0,0,0.0,0,1,0.0,5,1385.0,4:37,0,0,0,0.0,4,0,0,0,0,0,0,0,0.0,0:0,0,0,0,0.0,0:0,600000
8470871,Chris,Porter,1984-05-29,LW,L,2014-15,24,1,1,2,0.08,-3,24,4.17,6,13758.0,9:33,4,5,9,44.44,63,1,1,1,0,0,0,0,94.0,0:3,0,0,0,229.0,0:9,675000
8470877,David,Jones,1984-08-10,RW,R,2014-15,67,14,16,30,0.45,-3,114,12.28,18,57644.0,14:20,15,16,31,48.39,125,45,24,26,-2,2,0,2,3847.0,0:57,0,0,0,67.0,0:1,4000000
8470886,Clayton,Stoner,1985-02-19,D,L,2014-15,69,1,7,8,0.12,-2,68,1.47,68,73040.0,17:38,0,0,0,0.0,128,84,10,40,-30,0,0,0,425.0,0:6,0,0,0,7555.0,1:49,3250000
8470920,David,Clarkson,1984-03-31,RW,R,2014-15,61,10,5,15,0.25,-12,95,10.53,106,50507.0,13:47,25,48,73,34.25,133,19,11,12,-1,1,0,1,7007.0,1:54,0,0,0,26.0,0:0,5250000
8470966,Mark,Giordano,1983-10-03,D,L,2014-15,61,11,37,48,0.79,13,157,7.01,37,92133.0,25:10,0,0,0,0.0,59,128,35,51,-16,2,12,14,11609.0,3:10,1,0,1,7806.0,2:7,4020000
8471185,Curtis,Glencross,1982-12-28,LW,L,2014-15,71,13,22,35,0.49,2,108,12.04,45,66661.0,15:38,8,10,18,44.44,124,50,34,52,-18,4,7,11,8161.0,1:54,0,0,0,572.0,0:8,2550000
8471214,Alex,Ovechkin,1985-09-17,LW,R,2014-15,81,53,28,81,1.0,10,395,13.42,58,98784.0,20:19,2,3,5,40.0,259,32,45,58,-13,25,9,34,18556.0,3:49,0,0,0,85.0,0:1,9538462
8471215,Evgeni,Malkin,1986-07-31,C,L,2014-15,69,28,42,70,1.01,-2,212,13.21,60,78554.0,18:58,322,433,755,42.65,24,18,45,53,-8,9,17,26,15077.0,3:38,0,0,0,375.0,0:5,9500000
8471217,Andrew,Ladd,1985-12-12,LW,L,2014-15,81,24,38,62,0.77,9,224,10.71,72,97552.0,20:4,7,13,20,35.0,212,38,26,50,-24,9,10,19,15583.0,3:12,0,1,1,8716.0,1:47,4400000
8471218,Blake,Wheeler,1986-08-31,RW,R,2014-15,79,26,35,61,0.77,26,244,10.66,73,93196.0,19:39,22,26,48,45.83,128,54,35,35,0,2,10,12,15425.0,3:15,4,1,5,8223.0,1:44,5600000
8471222,Ladislav,Smid,1986-02-01,D,L,2014-15,31,0,1,1,0.03,-12,21,0.0,13,25978.0,13:58,0,0,0,0.0,51,54,4,10,-6,0,0,0,26.0,0:0,0,0,0,2090.0,1:7,3500000
8471226,Drew,Stafford,1985-10-30,RW,R,2014-15,76,18,25,43,0.57,-12,147,12.24,47,75234.0,16:29,86,88,174,49.43,81,15,21,17,4,4,5,9,10734.0,2:21,0,1,1,1840.0,0:24,4000000
8471231,Kyle,Chipchura,1986-02-19,C,L,2014-15,70,4,10,14,0.2,-23,81,4.94,82,56279.0,13:23,473,443,916,51.64,130,29,41,22,19,1,0,1,627.0,0:8,0,0,0,4308.0,1:1,875000
8471232,Lauri,Korpikoski,1986-07-28,LW,L,2014-15,69,6,15,21,0.3,-27,82,7.32,12,63128.0,15:14,11,22,33,33.33,141,48,26,15,11,5,3,8,3920.0,0:56,0,1,1,6980.0,1:41,2500000
8471233,Travis,Zajac,1985-05-13,C,R,2014-15,74,11,14,25,0.34,-3,112,9.82,29,84652.0,19:3,641,559,1200,53.42,70,35,51,32,19,4,3,7,8823.0,1:59,2,0,2,8100.0,1:49,5750000
8471236,Andrej,Meszaros,1985-10-13,D,L,2014-15,60,7,7,14,0.23,-13,67,10.45,36,64476.0,17:54,0,0,0,0.0,67,94,8,18,-10,1,0,1,5501.0,1:31,0,0,0,3206.0,0:53,4125000
8471240,Jeff,Schultz,1986-02-25,D,L,2014-15,9,0,1,1,0.11,1,7,0.0,4,9043.0,16:44,0,0,0,0.0,10,9,0,5,-5,0,0,0,20.0,0:2,0,0,0,793.0,1:28,850000
8471241,Mark,Fistric,1986-06-01,D,L,2014-15,9,0,0,0,0.0,-3,1,0.0,4,7983.0,14:47,0,0,0,0.0,28,21,4,2,2,0,0,0,18.0,0:2,0,0,0,543.0,1:0,1266666
8471242,Mike,Green,1985-10-12,D,R,2014-15,72,10,35,45,0.62,15,159,6.29,34,82544.0,19:6,0,0,0,0.0,82,93,30,61,-31,1,16,17,11925.0,2:45,0,0,0,2391.0,0:33,6083333
8471245,Dave,Bolland,1986-06-05,C,R,2014-15,53,6,17,23,0.43,4,76,7.89,48,51998.0,16:21,414,517,931,44.47,88,21,26,10,16,0,5,5,4267.0,1:20,1,0,1,5662.0,1:46,5500000
8471254,Bryan,Bickell,1986-03-09,LW,L,2014-15,80,14,14,28,0.35,5,113,12.39,38,57961.0,12:4,0,2,2,0.0,205,13,26,20,6,1,2,3,3526.0,0:44,0,0,0,3.0,0:0,4000000
8471260,Blake,Comeau,1986-02-18,LW,R,2014-15,61,16,15,31,0.51,6,147,10.88,65,55940.0,15:17,7,2,9,77.78,188,11,16,19,-3,0,1,1,3475.0,0:56,0,0,0,1094.0,0:17,700000
8471262,Carl,Soderberg,1985-10-12,C,L,2014-15,82,13,31,44,0.54,10,163,7.98,26,82705.0,16:48,369,397,766,48.17,76,36,33,27,6,5,3,8,9866.0,2:0,0,0,0,208.0,0:2,1008333
8471266,David,Booth,1984-11-24,LW,L,2014-15,59,7,6,13,0.22,-8,107,6.54,25,42272.0,11:56,6,7,13,46.15,87,8,27,12,15,0,0,0,332.0,0:5,0,1,1,4671.0,1:19,4250000
8471269,Nicklas,Grossmann,1985-01-22,D,L,2014-15,68,5,9,14,0.21,8,43,11.63,32,72037.0,17:39,0,0,0,0.0,132,89,10,23,-13,0,0,0,121.0,0:1,0,0,0,8790.0,2:9,3500000
8471273,Brandon,Dubinsky,1986-04-29,C,L,2014-15,47,13,23,36,0.77,11,100,13.0,43,50933.0,18:3,436,423,859,50.76,152,11,19,19,0,0,7,7,5606.0,1:59,1,0,1,6793.0,2:24,4200000
8471274,Alex,Goligoski,1985-07-30,D,L,2014-15,81,4,32,36,0.44,0,122,3.28,24,115723.0,23:48,0,0,0,0.0,100,157,30,83,-53,0,8,8,10167.0,2:5,0,2,2,14321.0,2:56,4600000
8471276,David,Krejci,1986-04-28,C,R,2014-15,47,7,24,31,0.66,7,70,10.0,22,51231.0,18:10,316,278,594,53.2,35,29,20,21,-1,1,7,8,6245.0,2:12,1,0,1,1638.0,0:34,5250000
8471283,Brandon,Prust,1984-03-16,LW,L,2014-15,82,4,14,18,0.22,6,78,5.13,134,63794.0,12:57,16,15,31,51.61,122,34,15,27,-12,0,0,0,664.0,0:8,0,1,1,8643.0,1:45,2500000
8471284,Andrej,Sekera,1986-06-08,D,L,2014-15,73,3,20,23,0.32,-3,100,3.0,14,96307.0,21:59,0,0,0,0.0,59,118,43,56,-13,1,5,6,8090.0,1:50,0,1,1,7495.0,1:42,2750000
8471296,Alexei,Emelin,1986-04-25,D,L,2014-15,68,3,11,14,0.21,5,43,6.98,59,80854.0,19:49,0,0,0,0.0,204,116,16,56,-40,0,0,0,345.0,0:5,0,0,0,9569.0,2:20,4100000
8471299,Peter,Regin,1986-04-16,C,L,2014-15,4,0,1,1,0.25,1,3,0.0,0,2000.0,8:20,1,1,2,50.0,3,0,3,0,3,0,0,0,61.0,0:15,0,0,0,0.0,0:0,650000
8471303,Alexander,Edler,1986-04-21,D,L,2014-15,74,8,23,31,0.42,13,175,4.57,54,106467.0,23:58,0,1,1,0.0,94,126,24,72,-48,5,9,14,13004.0,2:55,0,0,0,11536.0,2:35,5000000
8471309,Johan,Franzen,1979-12-23,RW,L,2014-15,33,7,15,22,0.67,-12,74,9.46,30,31801.0,16:3,5,10,15,33.33,45,13,4,17,-13,4,7,11,6382.0,3:13,0,0,0,63.0,0:1,3954545
8471311,Tyler,Kennedy,1986-07-15,C,R,2014-15,38,6,8,14,0.37,-2,79,7.59,10,25458.0,11:9,13,15,28,46.43,49,8,20,6,14,0,0,0,325.0,0:8,0,0,0,70.0,0:1,2350000
8471338,Torrey,Mitchell,1985-01-30,C,R,2014-15,65,6,8,14,0.22,-8,55,10.91,34,55373.0,14:11,399,415,814,49.02,58,61,25,23,2,0,0,0,442.0,0:6,0,0,0,7728.0,1:58,1900000
8471339,Ryan,Callahan,1985-03-21,RW,R,2014-15,77,24,30,54,0.7,9,191,12.57,41,81937.0,17:44,15,16,31,48.39,184,46,43,25,18,10,6,16,14078.0,3:2,0,0,0,827.0,0:10,5800000
8471346,Kris,Versteeg,1986-05-13,RW,R,2014-15,61,14,20,34,0.56,11,134,10.45,35,58009.0,15:50,15,33,48,31.25,31,22,31,24,7,2,3,5,6535.0,1:47,0,0,0,391.0,0:6,4400000
8471348,Nikita,Nikitin,1986-06-16,D,L,2014-15,42,4,6,10,0.24,-12,80,5.0,12,49490.0,19:38,0,0,0,0.0,21,49,17,35,-18,2,1,3,4359.0,1:43,0,0,0,4399.0,1:44,4500000
8471362,Mikhail,Grabovski,1984-01-31,C,L,2014-15,51,9,10,19,0.37,3,81,11.11,8,43678.0,14:16,38,45,83,45.78,11,19,26,31,-5,0,1,1,4316.0,1:24,0,0,0,27.0,0:0,5500000
8471371,Mike,Brown,1985-06-24,RW,R,2014-15,12,0,0,0,0.0,0,11,0.0,22,5907.0,8:12,4,3,7,57.14,42,7,1,0,1,0,0,0,6.0,0:0,0,0,0,0.0,0:0,1200000
8471385,Adam,Pardy,1984-03-29,D,L,2014-15,55,0,9,9,0.16,9,29,0.0,40,49562.0,15:1,0,0,0,0.0,74,59,10,35,-25,0,0,0,295.0,0:5,0,1,1,7993.0,2:25,700000
8471388,Patrick,Kaleta,1986-06-08,RW,R,2014-15,42,0,3,3,0.07,-11,25,0.0,36,22346.0,8:52,3,5,8,37.5,88,25,8,3,5,0,0,0,90.0,0:2,0,1,1,2997.0,1:11,1250000
8471390,Mike,Santorelli,1985-12-14,C,R,2014-15,79,12,21,33,0.42,0,145,8.28,14,68198.0,14:23,86,100,186,46.24,55,34,44,25,19,0,2,2,1755.0,0:22,1,1,2,2644.0,0:33,1500000
8471392,Roman,Polak,1986-04-28,D,R,2014-15,56,5,4,9,0.16,-22,61,8.2,48,70857.0,21:5,1,0,1,100.0,225,128,23,28,-5,0,0,0,285.0,0:5,0,0,0,10468.0,3:6,2750000
8471426,Troy,Brouwer,1985-08-17,RW,R,2014-15,82,21,22,43,0.52,11,145,14.48,53,86214.0,17:31,251,190,441,56.92,206,39,44,41,3,8,6,14,14642.0,2:58,2,0,2,10342.0,2:6,3666667
8471436,Matt,Hunwick,1985-05-21,D,L,2014-15,55,2,9,11,0.2,17,72,2.78,16,52192.0,15:48,0,0,0,0.0,55,43,15,27,-12,0,2,2,1854.0,0:33,0,0,0,892.0,0:16,600000
8471474,Travis,Morin,1984-01-09,C,L,2014-15,6,0,0,0,0.0,1,10,0.0,0,4355.0,12:5,28,32,60,46.67,3,0,2,1,1,0,0,0,474.0,1:19,0,0,0,0.0,0:0,550000
8471476,Daniel,Winnik,1985-03-06,LW,L,2014-15,79,9,25,34,0.43,23,97,9.28,27,78882.0,16:38,107,121,228,46.93,124,69,44,25,19,0,0,0,284.0,0:3,0,1,1,15521.0,3:16,1300000
8471482,Grant,Clitsome,1985-04-14,D,L,2014-15,24,0,4,4,0.17,4,22,0.0,8,23565.0,16:21,0,0,0,0.0,46,20,5,23,-18,0,0,0,759.0,0:31,0,0,0,1688.0,1:10,2066667
8471490,Adam,Cracknell,1985-07-15,RW,R,2014-15,17,0,1,1,0.06,-8,17,0.0,2,10146.0,9:56,20,38,58,34.48,43,6,5,3,2,0,0,0,78.0,0:4,0,0,0,570.0,0:33,600000
8471498,Jannik,Hansen,1986-03-15,RW,R,2014-15,81,16,17,33,0.41,-6,145,11.03,27,67905.0,13:58,1,5,6,16.67,80,30,42,15,27,0,0,0,2177.0,0:26,1,2,3,6387.0,1:18,2500000
8471504,Rene,Bourque,1981-12-10,RW,L,2014-15,51,6,8,14,0.27,-15,85,7.06,22,38661.0,12:38,4,6,10,40.0,71,11,6,13,-7,2,1,3,2783.0,0:54,0,0,0,161.0,0:3,3333333
8471636,Tim,Sestito,1984-08-28,LW,L,2014-15,15,0,2,2,0.13,-1,10,0.0,33,8899.0,9:53,48,58,106,45.28,22,3,3,2,1,0,0,0,5.0,0:0,0,0,0,1727.0,1:55,562500
8471657,Cody,McLeod,1984-06-26,LW,L,2014-15,82,7,5,12,0.15,-2,94,7.45,191,55024.0,11:11,1,8,9,11.11,268,43,11,6,5,0,0,0,2178.0,0:26,1,0,1,6642.0,1:21,1150000
8471664,Mason,Raymond,1985-09-17,LW,L,2014-15,57,12,11,23,0.4,-8,123,9.76,8,50663.0,14:48,0,3,3,0.0,7,13,24,28,-4,0,1,1,7031.0,2:3,0,0,0,367.0,0:6,3150000
8471669,Paul,Stastny,1985-12-27,C,L,2014-15,74,16,30,46,0.62,5,143,11.19,40,78266.0,17:37,671,487,1158,57.94,22,30,28,9,19,7,8,15,10477.0,2:21,0,0,0,4071.0,0:55,7000000
8471675,Sidney,Crosby,1987-08-07,C,L,2014-15,77,28,56,84,1.09,5,237,11.81,47,92265.0,19:58,797,800,1597,49.91,66,29,37,53,-16,10,21,31,16684.0,3:36,0,0,0,1695.0,0:22,8700000
8471676,Bobby,Ryan,1987-03-17,RW,R,2014-15,78,18,36,54,0.69,5,221,8.14,24,81772.0,17:28,4,7,11,36.36,110,33,59,41,18,4,10,14,14521.0,3:6,0,0,0,742.0,0:9,5100000
8471677,Jack,Johnson,1987-01-13,D,L,2014-15,79,8,32,40,0.51,-13,141,5.67,44,114546.0,24:9,0,0,0,0.0,157,131,18,30,-12,3,18,21,12845.0,2:42,0,0,0,14898.0,3:8,4357143
8471678,Benoit,Pouliot,1986-09-29,LW,L,2014-15,58,19,15,34,0.59,-1,105,18.1,28,57845.0,16:37,13,21,34,38.24,71,31,40,36,4,4,3,7,7097.0,2:2,1,0,1,3979.0,1:8,4000000
8471681,Jack,Skille,1987-05-19,RW,R,2014-15,45,6,2,8,0.18,-18,95,6.32,16,33813.0,12:31,3,5,8,37.5,96,15,17,2,15,0,0,0,300.0,0:6,0,0,0,194.0,0:4,750000
8471682,Devin,Setoguchi,1987-01-01,RW,R,2014-15,12,0,0,0,0.0,-7,12,0.0,4,8747.0,12:8,1,1,2,50.0,12,5,0,1,-1,0,0,0,995.0,1:22,0,0,0,50.0,0:4,750000
8471685,Anze,Kopitar,1987-08-24,C,L,2014-15,79,16,48,64,0.81,-2,134,11.94,10,91909.0,19:23,752,678,1430,52.59,105,46,29,48,-19,6,18,24,13463.0,2:50,0,0,0,7962.0,1:40,6800000
8471686,Marc,Staal,1987-01-13,D,L,2014-15,80,5,15,20,0.25,18,97,5.15,42,101459.0,21:8,1,1,2,50.0,99,123,43,43,0,0,0,0,571.0,0:7,0,2,2,10561.0,2:12,3975000
8471691,Martin,Hanzal,1987-02-20,C,L,2014-15,37,8,16,24,0.65,-1,85,9.41,31,39374.0,17:44,346,266,612,56.54,105,18,17,12,5,1,3,4,4655.0,2:5,0,1,1,2956.0,1:19,3100000
8471693,Jakub,Kindl,1987-02-10,D,L,2014-15,35,5,8,13,0.37,2,54,9.26,22,33413.0,15:54,0,0,0,0.0,31,25,2,22,-20,2,5,7,3980.0,1:53,0,0,0,139.0,0:3,2400000
8471698,T.J.,Oshie,1986-12-23,RW,R,2014-15,72,19,36,55,0.76,17,162,11.73,51,81362.0,18:50,3,10,13,23.08,99,39,48,31,17,3,10,13,10193.0,2:21,0,0,0,5717.0,1:19,4175000
8471699,Andrew,Cogliano,1987-06-14,LW,L,2014-15,82,15,14,29,0.35,5,134,11.19,14,71837.0,14:36,16,33,49,32.65,139,30,30,33,-3,0,0,0,447.0,0:5,3,0,3,8201.0,1:40,3000000
8471702,Matt,Niskanen,1986-12-06,D,R,2014-15,82,4,27,31,0.38,7,117,3.42,47,109981.0,22:21,0,0,0,0.0,143,106,34,76,-42,2,8,10,5237.0,1:3,0,1,1,11257.0,2:17,5750000
8471703,Steve,Downie,1987-04-03,RW,R,2014-15,72,14,14,28,0.39,2,104,13.46,238,53714.0,12:26,4,4,8,50.0,108,34,16,24,-8,3,2,5,6133.0,1:25,0,0,0,163.0,0:2,1000000
8471707,James,Neal,1987-09-03,LW,L,2014-15,67,23,14,37,0.55,12,221,10.41,57,72712.0,18:5,7,10,17,41.18,71,30,37,31,6,3,1,4,11609.0,2:53,0,0,0,57.0,0:0,5000000
8471709,Marc-Edouard,Vlasic,1987-03-30,D,L,2014-15,70,9,14,23,0.33,12,98,9.18,23,92869.0,22:6,0,0,0,0.0,51,112,11,31,-20,0,3,3,5902.0,1:24,0,0,0,10058.0,2:23,4250000
8471710,Taylor,Chorney,1987-04-27,D,L,2014-15,7,0,0,0,0.0,-1,4,0.0,0,5112.0,12:10,0,0,0,0.0,5,3,0,4,-4,0,0,0,355.0,0:50,0,0,0,0.0,0:0,550000
8471716,Justin,Abdelkader,1987-02-25,LW,L,2014-15,71,23,21,44,0.62,3,154,14.94,72,76296.0,17:54,7,8,15,46.67,153,28,16,29,-13,8,6,14,11969.0,2:48,0,0,0,3964.0,0:55,1800000
8471717,Adam,McQuaid,1986-10-12,D,R,2014-15,63,1,6,7,0.11,-2,60,1.67,85,69688.0,18:26,0,1,1,0.0,141,91,7,22,-15,0,0,0,271.0,0:4,0,0,0,7196.0,1:54,1566667
8471718,Marc-Andre,Cliche,1987-03-23,C,R,2014-15,74,2,5,7,0.09,-2,68,2.94,17,47091.0,10:36,377,358,735,51.29,27,28,31,16,15,0,0,0,174.0,0:2,0,0,0,9202.0,2:4,700000
8471724,Kris,Letang,1987-04-24,D,R,2014-15,69,11,43,54,0.78,12,197,5.58,79,105525.0,25:29,0,1,1,0.0,131,117,39,60,-21,2,22,24,15730.0,3:47,1,0,1,11522.0,2:46,7250000
8471729,Kris,Russell,1987-05-02,D,L,2014-15,79,4,30,34,0.43,18,111,3.6,17,113519.0,23:56,0,0,0,0.0,61,283,51,66,-15,1,13,14,11461.0,2:25,0,0,0,6238.0,1:18,2600000
8471735,Keith,Yandle,1986-09-09,D,L,2014-15,84,6,46,52,0.62,-26,232,2.59,40,115482.0,22:54,0,0,0,0.0,53,101,35,81,-46,2,27,29,20898.0,4:8,0,0,0,662.0,0:7,5250000
8471742,Cody,Franson,1987-08-08,D,R,2014-15,78,7,29,36,0.46,-7,127,5.51,28,91860.0,19:37,0,0,0,0.0,177,132,46,69,-23,5,12,17,11823.0,2:31,0,0,0,7562.0,1:36,3300000
8471748,Mark,Fraser,1986-09-29,D,L,2014-15,34,0,4,4,0.12,2,19,0.0,55,33201.0,16:16,0,0,0,0.0,85,49,1,13,-12,0,0,0,20.0,0:0,0,1,1,3724.0,1:49,550000
8471761,Chris,Butler,1986-10-27,D,L,2014-15,33,3,6,9,0.27,8,54,5.56,23,34038.0,17:11,0,0,0,0.0,31,38,5,9,-4,0,0,0,721.0,0:21,1,0,1,767.0,0:23,650000
8471762,Chris,VandeVelde,1987-03-15,C,L,2014-15,72,9,6,15,0.21,-6,70,12.86,28,50672.0,11:43,21,35,56,37.5,121,46,13,5,8,0,0,0,414.0,0:5,0,0,0,7311.0,1:41,575000
8471766,Jared,Boll,1986-05-13,RW,R,2014-15,72,1,4,5,0.07,-13,28,3.57,109,31427.0,7:16,0,2,2,0.0,131,17,5,7,-2,0,0,0,43.0,0:0,0,0,0,0.0,0:0,1700000
8471769,Niklas,Hjalmarsson,1987-06-06,D,L,2014-15,82,3,16,19,0.23,25,97,3.09,44,107675.0,21:53,0,0,0,0.0,39,127,41,70,-29,0,0,0,700.0,0:8,0,0,0,11914.0,2:25,4100000
8471794,Darren,Helm,1987-01-21,LW,L,2014-15,75,15,18,33,0.44,7,160,9.38,12,71251.0,15:50,223,198,421,52.97,132,25,33,22,11,3,4,7,6587.0,1:27,2,0,2,6907.0,1:32,2125000
8471804,Nathan,Gerbe,1987-07-24,C,L,2014-15,78,10,18,28,0.36,-14,235,4.26,34,76958.0,16:26,9,6,15,60.0,73,23,51,38,13,2,6,8,7121.0,1:31,0,0,0,4937.0,1:3,1750000
8471816,Mark,Fayne,1987-05-15,D,R,2014-15,74,2,6,8,0.11,-21,78,2.56,14,79639.0,17:56,0,0,0,0.0,81,125,21,49,-28,0,0,0,905.0,0:12,0,2,2,11084.0,2:29,3625000
8471817,Ryan,Reaves,1987-01-20,RW,R,2014-15,81,6,6,12,0.15,-3,55,10.91,116,41404.0,8:31,0,0,0,0.0,276,14,14,6,8,0,0,0,187.0,0:2,0,0,0,22.0,0:0,1125000
8471840,Brett,Sutter,1987-06-02,LW,L,2014-15,6,0,3,3,0.5,1,6,0.0,4,3351.0,9:18,0,0,0,0.0,16,1,0,0,0,0,0,0,26.0,0:4,0,0,0,267.0,0:44,600000
8471856,Joe,Vitale,1985-08-20,C,R,2014-15,70,3,6,9,0.13,-11,55,5.45,36,47163.0,11:13,354,379,733,48.29,104,65,30,11,19,0,0,0,108.0,0:1,0,0,0,9104.0,2:10,1116667
8471862,Colin,Greening,1986-03-09,C,L,2014-15,26,1,0,1,0.04,-5,39,2.56,29,15322.0,9:49,6,3,9,66.67,85,14,8,6,2,0,0,0,89.0,0:3,0,0,0,0.0,0:0,2650000
8471873,Anton,Stralman,1986-08-01,D,R,2014-15,82,9,30,39,0.48,22,138,6.52,26,107975.0,21:56,0,0,0,0.0,104,77,23,40,-17,2,12,14,12199.0,2:28,0,0,0,12705.0,2:34,4500000
8471879,Kyle,Cumiskey,1986-12-02,D,L,2014-15,7,0,0,0,0.0,-1,5,0.0,0,5584.0,13:17,0,0,0,0.0,3,11,1,2,-1,0,0,0,103.0,0:14,0,0,0,271.0,0:38,600000
8471887,Patric,Hornqvist,1987-01-01,RW,R,2014-15,64,25,26,51,0.8,12,220,11.36,38,67791.0,17:39,2,5,7,28.57,87,33,31,9,22,6,9,15,12724.0,3:18,0,0,0,222.0,0:3,4250000
8471956,Andrew,Desjardins,1986-07-27,LW,L,2014-15,69,5,5,10,0.14,-1,59,8.47,57,44460.0,10:44,158,154,312,50.64,128,35,14,18,-4,0,0,0,231.0,0:3,0,0,0,4568.0,1:6,750000
8471958,Dan,Girardi,1984-04-29,D,R,2014-15,82,4,16,20,0.24,12,111,3.6,22,111645.0,22:41,0,0,0,0.0,224,184,33,60,-27,1,2,3,7269.0,1:28,0,1,1,13694.0,2:47,5500000
8471976,David,Desharnais,1986-09-14,C,L,2014-15,82,14,34,48,0.59,22,90,15.56,24,84865.0,17:14,629,560,1189,52.9,43,49,27,20,7,2,9,11,11734.0,2:23,0,0,0,144.0,0:1,3500000
8472368,Chris,Conner,1983-12-23,RW,L,2014-15,2,0,0,0,0.0,1,3,0.0,4,1058.0,8:49,0,0,0,0.0,0,0,1,0,1,0,0,0,0.0,0:0,0,0,0,0.0,0:0,550000
8472382,Andy,Greene,1982-10-30,D,L,2014-15,82,3,19,22,0.27,1,83,3.61,20,115837.0,23:32,0,0,0,0.0,82,172,21,39,-18,0,1,1,2542.0,0:31,0,1,1,19591.0,3:58,3000000
8472394,Peter,Harrold,1983-06-08,D,R,2014-15,43,3,2,5,0.12,-10,31,9.68,4,39328.0,15:14,0,0,0,0.0,40,39,6,12,-6,0,0,0,745.0,0:17,0,0,0,4061.0,1:34,800000
8472410,Stephen,Gionta,1983-10-09,RW,R,2014-15,61,5,8,13,0.21,4,84,5.95,12,48257.0,13:11,159,235,394,40.36,92,41,19,11,8,0,0,0,332.0,0:5,0,2,2,8087.0,2:12,850000
8472424,Ryan,Hamilton,1985-04-15,LW,L,2014-15,16,1,1,2,0.12,-8,12,8.33,6,12681.0,13:12,1,3,4,25.0,27,13,2,3,-1,1,0,1,1013.0,1:3,0,0,0,180.0,0:11,600000
8473412,Bryan,Little,1987-11-12,C,R,2014-15,70,24,28,52,0.74,8,148,16.22,24,83662.0,19:55,762,789,1551,49.13,56,32,25,22,3,9,9,18,13458.0,3:12,1,0,1,8556.0,2:2,4700000
8473415,Alex,Biega,1988-04-04,D,R,2014-15,7,1,0,1,0.14,-2,7,14.29,0,6634.0,15:47,0,0,0,0.0,34,8,1,3,-2,0,0,0,80.0,0:11,0,0,0,118.0,0:16,600000
8473419,Brad,Marchand,1988-05-11,LW,L,2014-15,77,24,18,42,0.55,5,180,13.33,95,78080.0,16:54,13,20,33,39.39,72,28,52,45,7,2,0,2,4560.0,0:59,2,1,3,6408.0,1:23,4500000
8473422,Nick,Foligno,1987-10-31,LW,L,2014-15,79,31,42,73,0.92,16,182,17.03,50,89253.0,18:49,125,138,263,47.53,193,52,51,23,28,11,15,26,11989.0,2:31,0,0,0,6367.0,1:20,3083333
8473426,Mike,Weber,1987-12-16,D,L,2014-15,64,1,6,7,0.11,-22,41,2.44,68,71970.0,18:44,0,0,0,0.0,172,168,10,40,-30,0,0,0,298.0,0:4,0,1,1,9204.0,2:23,1666667
8473432,Derek,Dorsett,1986-12-20,RW,R,2014-15,79,7,18,25,0.32,4,89,7.87,175,57095.0,12:2,7,9,16,43.75,166,37,18,12,6,0,0,0,1743.0,0:22,2,0,2,2283.0,0:28,1633333
8473446,Erik,Johnson,1988-03-21,D,R,2014-15,47,12,11,23,0.49,2,115,10.43,33,68863.0,24:25,0,0,0,0.0,93,107,26,38,-12,3,3,6,7447.0,2:38,0,1,1,7021.0,2:29,3750000
8473449,Kyle,Okposo,1988-04-16,RW,R,2014-15,60,18,33,51,0.85,-8,195,9.23,12,70396.0,19:33,80,81,161,49.69,53,23,30,45,-15,6,12,18,13570.0,3:46,0,0,0,109.0,0:1,2800000
8473453,Trevor,Lewis,1987-01-08,C,R,2014-15,73,9,16,25,0.34,8,143,6.29,14,61788.0,14:6,76,101,177,42.94,192,19,16,7,9,0,0,0,1284.0,0:17,1,0,1,6244.0,1:25,1525000
8473463,Leo,Komarov,1987-01-23,C,L,2014-15,62,8,18,26,0.42,0,84,9.52,18,54683.0,14:41,95,97,192,49.48,250,25,51,18,33,0,1,1,485.0,0:7,1,2,3,9554.0,2:34,2950000
8473465,Jamie,McGinn,1988-08-05,LW,L,2014-15,19,4,2,6,0.32,-9,36,11.11,6,16838.0,14:46,1,0,1,100.0,29,7,9,7,2,1,0,1,2302.0,2:1,0,0,0,137.0,0:7,2950000
8473466,Ryan,White,1988-03-17,C,R,2014-15,34,6,6,12,0.35,4,45,13.33,30,23915.0,11:43,65,58,123,52.85,108,14,8,8,0,0,0,0,1319.0,0:38,0,1,1,735.0,0:21,575000
8473468,Eric,Gryba,1988-04-14,D,R,2014-15,75,0,12,12,0.16,11,64,0.0,97,70432.0,15:39,0,0,0,0.0,171,58,12,40,-28,0,0,0,144.0,0:1,0,0,0,11223.0,2:29,1250000
8473473,Milan,Lucic,1988-06-07,LW,L,2014-15,81,18,26,44,0.54,13,141,12.77,81,79498.0,16:21,34,42,76,44.74,259,23,31,46,-15,2,6,8,8881.0,1:49,0,0,0,251.0,0:3,6000000
8473482,Jiri,Tlusty,1988-03-16,LW,L,2014-15,72,14,17,31,0.43,-18,123,11.38,20,69210.0,16:1,5,10,15,33.33,80,37,30,21,9,6,4,10,8204.0,1:53,0,0,0,2719.0,0:37,2950000
8473485,Chris,Stewart,1987-10-30,RW,R,2014-15,81,14,22,36,0.44,-26,155,9.03,88,77182.0,15:52,10,31,41,24.39,110,16,21,33,-12,5,5,10,9479.0,1:57,0,0,0,35.0,0:0,4150000
8473492,Matt,Beleskey,1988-06-07,LW,L,2014-15,65,22,10,32,0.49,13,145,15.17,39,56462.0,14:28,8,11,19,42.11,159,25,9,32,-23,4,0,4,6000.0,1:32,0,0,0,1033.0,0:15,1350000
8473504,Cal,Clutterbuck,1987-11-18,RW,R,2014-15,76,7,9,16,0.21,1,124,5.65,60,58040.0,12:43,6,3,9,66.67,343,31,25,24,1,0,1,1,654.0,0:8,2,1,3,6601.0,1:26,2750000
8473507,Jeff,Petry,1987-12-09,D,R,2014-15,78,7,15,22,0.28,-28,126,5.56,42,99454.0,21:15,0,0,0,0.0,145,109,43,83,-40,1,3,4,6020.0,1:17,0,1,1,7998.0,1:42,3075000
8473512,Claude,Giroux,1988-01-12,C,R,2014-15,81,25,48,73,0.9,-3,279,8.96,36,99946.0,20:33,1063,815,1878,56.6,110,28,40,36,4,14,23,37,16056.0,3:18,0,0,0,3710.0,0:45,8275000
8473514,Jesse,Joensuu,1987-10-05,LW,L,2014-15,20,2,2,4,0.2,-8,18,11.11,14,12754.0,10:37,0,0,0,0.0,37,9,9,4,5,0,0,0,239.0,0:11,1,0,1,840.0,0:42,950000
8473533,Jordan,Staal,1988-09-10,C,L,2014-15,46,6,18,24,0.52,-6,92,6.52,14,51204.0,18:33,499,386,885,56.38,85,15,39,24,15,1,6,7,5506.0,1:59,0,0,0,563.0,0:12,6000000
8473534,Patrik,Berglund,1988-06-02,C,L,2014-15,77,12,15,27,0.35,-2,145,8.28,26,67345.0,14:34,160,169,329,48.63,93,26,37,13,24,0,1,1,3647.0,0:47,0,0,0,3990.0,0:51,3700000
8473536,James,Sheppard,1988-04-25,C,L,2014-15,71,7,11,18,0.25,-4,79,8.86,37,56473.0,13:15,278,277,555,50.09,121,43,42,33,9,0,1,1,2877.0,0:40,0,0,0,188.0,0:2,1300000
8473537,Viktor,Stalberg,1986-01-17,LW,L,2014-15,25,2,8,10,0.4,0,27,7.41,18,17827.0,11:53,1,0,1,100.0,54,10,7,5,2,0,0,0,48.0,0:1,0,0,0,48.0,0:1,3000000
8473542,Tom,Sestito,1987-09-28,LW,L,2014-15,3,0,1,1,0.33,1,1,0.0,7,1123.0,6:14,0,0,0,0.0,10,0,0,0,0,0,0,0,0.0,0:0,0,0,0,0.0,0:0,750000
8473544,Derick,Brassard,1987-09-22,C,L,2014-15,80,19,41,60,0.75,9,168,11.31,34,83496.0,17:23,671,705,1376,48.76,106,13,42,38,4,6,12,18,13186.0,2:44,0,0,0,1161.0,0:14,5000000
8473546,Michael,Grabner,1987-10-05,RW,L,2014-15,34,8,5,13,0.38,4,63,12.7,4,26388.0,12:56,0,2,2,0.0,62,21,25,17,8,0,0,0,72.0,0:2,0,0,0,2597.0,1:16,3000000
8473548,Phil,Kessel,1987-10-02,RW,R,2014-15,82,25,36,61,0.74,-34,280,8.93,30,92463.0,18:47,2,3,5,40.0,18,13,34,64,-30,8,17,25,18175.0,3:41,0,0,0,53.0,0:0,8000000
8473560,Korbinian,Holzer,1988-02-16,D,R,2014-15,34,0,6,6,0.18,3,32,0.0,25,34890.0,17:6,0,0,0,0.0,117,53,11,26,-15,0,0,0,53.0,0:1,0,0,0,4811.0,2:21,787500
8473563,Nicklas,Backstrom,1987-11-23,C,L,2014-15,82,18,60,78,0.95,5,153,11.76,40,101008.0,20:31,862,747,1609,53.57,91,52,55,36,19,3,30,33,15243.0,3:5,0,0,0,4743.0,0:57,6700000
8473564,Michael,Frolik,1988-02-17,RW,L,2014-15,82,19,23,42,0.51,4,206,9.22,18,86125.0,17:30,14,27,41,34.15,63,41,58,34,24,3,4,7,7955.0,1:37,3,0,3,7805.0,1:35,3300000
8473565,Brian,Strait,1988-01-04,D,L,2014-15,52,2,5,7,0.13,-1,59,3.39,32,57315.0,18:22,0,1,1,0.0,124,85,14,24,-10,0,0,0,162.0,0:3,0,1,1,5460.0,1:45,775000
8473571,Jamie,McBain,1988-02-25,D,R,2014-15,26,3,6,9,0.35,4,18,16.67,4,19792.0,12:41,0,0,0,0.0,21,28,3,6,-3,1,2,3,2729.0,1:44,0,0,0,0.0,0:0,550000
8473573,Artem,Anisimov,1988-05-24,C,L,2014-15,52,7,20,27,0.52,-6,88,7.95,8,51108.0,16:22,102,127,229,44.54,33,26,24,21,3,0,4,4,5022.0,1:36,0,3,3,6265.0,2:0,3283333
8473574,Shawn,Matthias,1988-02-19,LW,L,2014-15,78,18,9,27,0.35,-3,132,13.64,16,61332.0,13:6,84,103,187,44.92,66,33,36,18,18,1,0,1,435.0,0:5,0,1,1,5824.0,1:14,1750000
8473579,Nikolay,Kulemin,1986-07-14,LW,L,2014-15,82,15,16,31,0.38,7,115,13.04,21,73162.0,14:52,7,17,24,29.17,129,58,53,29,24,0,0,0,1205.0,0:14,3,1,4,8654.0,1:45,4187500
8473584,Andrew,MacDonald,1986-09-07,D,L,2014-15,58,2,10,12,0.21,-5,62,3.23,41,69647.0,20:0,0,0,0,0.0,35,86,12,25,-13,1,4,5,4886.0,1:24,0,0,0,5620.0,1:36,5000000
8473588,Erik,Condra,1986-08-06,RW,R,2014-15,68,9,14,23,0.34,13,106,8.49,30,58969.0,14:27,2,7,9,22.22,33,53,37,19,18,0,0,0,425.0,0:6,1,1,2,9111.0,2:13,1250000
8473589,Chris,Summers,1988-02-05,D,L,2014-15,20,0,3,3,0.15,-12,15,0.0,8,17095.0,14:14,0,0,0,0.0,49,26,1,6,-5,0,0,0,40.0,0:2,0,0,0,1768.0,1:28,600000
8473604,Jonathan,Toews,1988-04-29,C,L,2014-15,81,28,38,66,0.81,30,192,14.58,36,95076.0,19:33,947,728,1675,56.54,56,16,45,34,11,6,11,17,16437.0,3:22,2,1,3,6720.0,1:22,6300000
8473618,Mathieu,Perreault,1988-01-05,C,L,2014-15,62,18,23,41,0.66,7,129,13.95,38,60471.0,16:15,226,212,438,51.6,78,13,43,21,22,5,7,12,11247.0,3:1,0,0,0,190.0,0:3,3000000
8473646,Ryan,Carter,1983-08-03,LW,L,2014-15,53,3,10,13,0.25,3,47,6.38,55,32089.0,10:5,29,41,70,41.43,77,30,14,2,12,0,0,0,132.0,0:2,1,0,1,5276.0,1:39,725000
8473658,Victor,Bartley,1988-02-17,D,L,2014-15,37,0,10,10,0.27,1,28,0.0,26,29825.0,13:26,0,0,0,0.0,77,53,2,9,-7,0,0,0,26.0,0:0,0,0,0,1316.0,0:35,666667
8473673,David,Schlemko,1987-05-07,D,L,2014-15,44,1,3,4,0.09,1,45,2.22,12,40474.0,15:19,0,0,0,0.0,45,84,6,19,-13,0,2,2,1232.0,0:28,0,0,0,2942.0,1:6,1187500
8473682,Andrew,Ebbett,1983-01-02,C,L,2014-15,24,1,5,6,0.25,1,21,4.76,2,12968.0,9:0,39,47,86,45.35,10,12,6,3,3,0,0,0,123.0,0:5,0,0,0,1252.0,0:52,550000
8473700,Ryan,Wilson,1987-02-03,D,L,2014-15,3,0,0,0,0.0,-3,3,0.0,0,2017.0,11:12,0,0,0,0.0,6,3,0,3,-3,0,0,0,10.0,0:3,0,0,0,240.0,1:20,2250000
8473722,John,Scott,1982-09-26,LW,L,2014-15,38,3,1,4,0.11,0,19,15.79,87,16990.0,7:27,0,0,0,0.0,94,14,7,11,-4,0,0,0,3.0,0:0,0,0,0,0.0,0:0,700000
8473911,Steven,Pinizzotto,1984-04-26,RW,R,2014-15,18,2,2,4,0.22,1,15,13.33,30,8563.0,7:55,0,0,0,0.0,32,2,2,1,1,0,0,0,18.0,0:1,0,0,0,283.0,0:15,650000
8473914,Mark,Letestu,1985-02-04,C,R,2014-15,54,7,6,13,0.24,-9,63,11.11,0,43216.0,13:20,319,284,603,52.9,51,24,21,7,14,0,1,1,1577.0,0:29,1,0,1,8729.0,2:41,1250000
8473933,Ben,Lovejoy,1984-02-20,D,R,2014-15,60,2,12,14,0.23,-4,86,2.33,25,69986.0,19:26,0,0,0,0.0,170,105,15,22,-7,0,0,0,824.0,0:13,0,2,2,6914.0,1:55,1100000
8473942,Trevor,Smith,1985-02-08,C,L,2014-15,54,2,3,5,0.09,-9,46,4.35,12,35847.0,11:3,293,268,561,52.23,75,25,18,8,10,0,0,0,462.0,0:8,0,0,0,5252.0,1:37,550000
8473962,Teddy,Purcell,1985-09-08,LW,R,2014-15,82,12,22,34,0.41,-33,146,8.22,24,84430.0,17:9,4,3,7,57.14,24,19,46,35,11,5,7,12,11164.0,2:16,0,0,0,5486.0,1:6,4500000
8473970,Rob,Klinkhammer,1986-08-12,LW,L,2014-15,69,5,4,9,0.13,-4,64,7.81,27,46441.0,11:13,10,27,37,27.03,236,12,13,12,1,0,0,0,301.0,0:4,0,0,0,208.0,0:3,625000
8473986,Alex,Killorn,1989-09-14,LW,L,2014-15,71,15,23,38,0.54,8,130,11.54,36,72105.0,16:55,35,45,80,43.75,60,21,29,39,-10,1,2,3,8703.0,2:2,1,0,1,3615.0,0:50,2550000
8473989,Luke,Gazdic,1989-07-25,LW,L,2014-15,40,2,1,3,0.08,-4,26,7.69,43,17739.0,7:23,0,0,0,0.0,76,15,1,7,-6,0,0,0,37.0,0:0,0,0,0,0.0,0:0,800000
8473991,Karl,Alzner,1988-09-24,D,L,2014-15,82,5,16,21,0.26,14,72,6.94,20,95607.0,19:25,0,0,0,0.0,120,165,15,35,-20,0,0,0,94.0,0:1,0,0,0,10747.0,2:11,2800000
8473992,Justin,Falk,1988-10-11,D,L,2014-15,18,1,1,2,0.11,-9,18,5.56,14,11685.0,10:49,0,0,0,0.0,12,19,1,7,-6,0,0,0,12.0,0:0,0,0,0,1037.0,0:57,700000
8473994,Jamie,Benn,1989-07-18,LW,L,2014-15,82,35,52,87,1.06,1,253,13.83,64,98144.0,19:56,298,278,576,51.74,120,50,76,50,26,10,13,23,17549.0,3:34,2,3,5,7274.0,1:28,5250000
8474000,Steven,Kampfer,1988-09-24,D,R,2014-15,25,2,2,4,0.16,-4,28,7.14,12,25795.0,17:11,0,0,0,0.0,49,33,6,6,0,0,1,1,642.0,0:25,0,0,0,1583.0,1:3,550000
8474001,TJ,Galiardi,1988-04-22,LW,L,2014-15,38,1,0,1,0.03,-8,35,2.86,2,23850.0,10:27,2,9,11,18.18,38,14,11,7,4,0,0,0,195.0,0:5,0,0,0,4962.0,2:10,700000
8474008,Paul,Carey,1988-09-24,C,L,2014-15,10,0,1,1,0.1,2,5,0.0,0,4727.0,7:52,0,3,3,0.0,12,2,3,0,3,0,0,0,0.0,0:0,0,0,0,0.0,0:0,715000
8474009,Nick,Bonino,1988-04-20,C,L,2014-15,75,15,24,39,0.52,7,149,10.07,22,76143.0,16:55,590,655,1245,47.39,31,90,54,24,30,1,4,5,8402.0,1:52,0,0,0,8844.0,1:57,1900000
8474013,Ian,Cole,1989-02-21,D,L,2014-15,74,5,12,17,0.23,14,83,6.02,51,70962.0,15:58,0,0,0,0.0,73,99,12,23,-11,0,1,1,2335.0,0:31,0,0,0,1385.0,0:18,825000
8474025,Eric,Tangradi,1989-02-10,LW,L,2014-15,7,0,0,0,0.0,-3,5,0.0,17,3245.0,7:43,1,0,1,100.0,12,4,0,2,-2,0,0,0,0.0,0:0,0,0,0,0.0,0:0,675000
8474027,Justin,Braun,1987-02-10,D,R,2014-15,70,1,22,23,0.33,8,94,1.06,48,88335.0,21:1,0,0,0,0.0,79,130,19,36,-17,0,2,2,2167.0,0:30,0,0,0,9125.0,2:10,1250000
8474031,Kevin,Shattenkirk,1989-01-29,D,R,2014-15,56,8,36,44,0.79,19,135,5.93,52,75800.0,22:33,0,0,0,0.0,42,86,25,35,-10,4,21,25,11568.0,3:26,0,0,0,5941.0,1:46,4250000
8474034,Patrick,Maroon,1988-04-23,LW,L,2014-15,71,9,25,34,0.48,-5,120,7.5,82,60845.0,14:16,7,14,21,33.33,120,10,16,25,-9,1,6,7,9299.0,2:10,0,0,0,28.0,0:0,575000
8474037,James,van Riemsdyk,1989-05-04,LW,L,2014-15,82,27,29,56,0.68,-33,248,10.89,43,93893.0,19:5,21,33,54,38.89,83,29,46,27,19,9,10,19,17499.0,3:33,1,0,1,3133.0,0:38,4250000
8474038,Paul,Byron,1989-04-27,LW,L,2014-15,57,6,13,19,0.33,-2,62,9.68,8,49481.0,14:28,34,63,97,35.05,101,24,46,23,23,1,0,1,1700.0,0:29,0,2,2,4486.0,1:18,600000
8474040,Sam,Gagner,1989-08-10,C,R,2014-15,81,15,26,41,0.51,-28,183,8.2,28,83796.0,17:14,361,410,771,46.82,63,19,36,34,2,6,6,12,11010.0,2:15,0,0,0,108.0,0:1,4800000
8474048,Keith,Aulie,1989-06-11,D,L,2014-15,31,0,1,1,0.03,-3,25,0.0,66,26605.0,14:18,0,0,0,0.0,59,37,4,12,-8,0,0,0,69.0,0:2,0,0,0,1286.0,0:41,800000
8474052,Chris,Terry,1989-04-07,LW,L,2014-15,57,11,9,20,0.35,-4,71,15.49,14,43509.0,12:43,6,5,11,54.55,44,17,21,20,1,3,1,4,4051.0,1:11,0,0,0,2.0,0:0,600000
8474053,Logan,Couture,1989-03-28,C,L,2014-15,82,27,40,67,0.82,-6,263,10.27,12,93836.0,19:4,477,513,990,48.18,85,71,56,72,-16,6,18,24,15817.0,3:12,2,0,2,7190.0,1:27,6000000
8474056,P.K.,Subban,1989-05-13,D,R,2014-15,82,15,45,60,0.73,21,170,8.82,74,128920.0,26:12,0,0,0,0.0,97,142,29,112,-83,8,13,21,18132.0,3:41,0,0,0,10637.0,2:9,9000000
8474061,Anthony,Peluso,1989-04-18,RW,R,2014-15,49,1,1,2,0.04,-3,23,4.35,86,17278.0,5:52,0,1,1,0.0,100,5,4,11,-7,0,0,0,111.0,0:2,0,0,0,10.0,0:0,562500
8474062,Riley,Nash,1989-05-09,C,R,2014-15,68,8,17,25,0.37,-10,94,8.51,12,66556.0,16:18,488,470,958,50.94,88,46,52,29,23,1,5,6,6805.0,1:40,0,0,0,6872.0,1:41,575000
8474066,Thomas,Hickey,1989-02-08,D,L,2014-15,81,2,20,22,0.27,-12,82,2.44,26,91984.0,18:55,1,1,2,50.0,117,136,39,55,-16,0,0,0,1050.0,0:12,0,2,2,9130.0,1:52,675000
8474068,Kyle,Turris,1989-08-14,C,R,2014-15,82,24,40,64,0.78,5,215,11.16,36,94544.0,19:12,737,735,1472,50.07,48,40,48,46,2,4,12,16,14912.0,3:1,1,0,1,3611.0,0:44,3500000
8474074,Paul,Postma,1989-02-22,D,R,2014-15,42,2,4,6,0.14,1,40,5.0,16,35605.0,14:7,0,0,0,0.0,17,28,17,22,-5,2,0,2,2653.0,1:3,0,0,0,252.0,0:6,712500
8474089,Brad,Malone,1989-05-20,C,L,2014-15,65,7,8,15,0.23,-8,65,10.77,74,39587.0,10:9,30,19,49,61.22,162,16,16,19,-3,0,0,0,354.0,0:5,0,0,0,1476.0,0:22,650000
8474090,Brendan,Smith,1989-02-08,D,L,2014-15,76,4,9,13,0.17,-2,88,4.55,68,81583.0,17:53,0,0,0,0.0,60,68,19,47,-28,0,2,2,1058.0,0:13,0,0,0,5588.0,1:13,1262500
8474091,Brandon,Sutter,1989-02-14,C,R,2014-15,80,21,12,33,0.41,6,180,11.67,14,83155.0,17:19,688,671,1359,50.63,86,48,41,33,8,3,2,5,7298.0,1:31,4,0,4,11061.0,2:18,3300000
8474094,Matt,Halischuk,1988-06-01,RW,R,2014-15,47,3,5,8,0.17,5,59,5.08,6,27480.0,9:44,1,0,1,100.0,55,24,11,9,2,0,0,0,321.0,0:6,0,0,0,948.0,0:20,725000
8474095,Dana,Tyrell,1989-04-23,C,L,2014-15,3,0,0,0,0.0,-1,1,0.0,0,1249.0,6:56,0,0,0,0.0,5,3,0,0,0,0,0,0,0.0,0:0,0,0,0,0.0,0:0,655000
8474096,Nick,Spaling,1988-09-19,C,L,2014-15,82,9,18,27,0.33,-2,90,10.0,26,74974.0,15:14,84,90,174,48.28,134,45,24,13,11,1,0,1,1301.0,0:15,0,0,0,9127.0,1:51,2200000
8474098,Colton,Sceviour,1989-04-20,C,R,2014-15,71,9,17,26,0.37,1,113,7.96,13,54172.0,12:42,30,41,71,42.25,77,41,24,21,3,0,4,4,4471.0,1:2,0,0,0,1289.0,0:18,650000
8474100,Dwight,King,1989-07-05,LW,L,2014-15,81,13,13,26,0.32,-3,127,10.24,21,69962.0,14:23,3,2,5,60.0,124,14,20,23,-3,0,1,1,2226.0,0:27,0,1,1,4214.0,0:52,1950000
8474102,David,Perron,1988-05-28,LW,R,2014-15,81,17,24,41,0.51,-25,196,8.67,62,84214.0,17:19,3,9,12,25.0,171,21,35,35,0,3,6,9,12824.0,2:38,0,0,0,63.0,0:0,3812500
8474113,TJ,Brennan,1989-04-03,D,L,2014-15,6,0,1,1,0.17,-7,11,0.0,9,6052.0,16:48,0,0,0,0.0,2,5,1,5,-4,0,1,1,1297.0,3:36,0,0,0,165.0,0:27,600000
8474125,Carl,Gunnarsson,1986-11-09,D,L,2014-15,61,2,10,12,0.2,10,54,3.7,2,66117.0,18:3,0,0,0,0.0,42,114,11,13,-2,0,1,1,1070.0,0:17,0,0,0,4588.0,1:15,3150000
8474130,Corey,Tropp,1989-07-25,RW,R,2014-15,61,1,7,8,0.13,-14,22,4.55,76,32038.0,8:45,1,1,2,50.0,80,28,12,10,2,0,0,0,160.0,0:2,0,0,0,19.0,0:0,625000
8474134,Yannick,Weber,1988-09-23,D,R,2014-15,65,11,10,21,0.32,4,117,9.4,30,67032.0,17:11,0,0,0,0.0,66,62,14,35,-21,5,3,8,5663.0,1:27,0,0,0,2547.0,0:39,850000
8474135,Brett,Bellemore,1988-06-25,D,R,2014-15,49,2,8,10,0.2,1,26,7.69,27,48149.0,16:22,0,0,0,0.0,148,54,9,28,-19,0,0,0,100.0,0:2,0,0,0,2892.0,0:59,600000
8474141,Patrick,Kane,1988-11-19,RW,L,2014-15,61,27,37,64,1.05,10,186,14.52,10,72654.0,19:51,3,4,7,42.86,22,14,36,30,6,6,16,22,13460.0,3:40,0,0,0,147.0,0:2,6300000
8474145,Robert,Bortuzzo,1989-03-18,D,R,2014-15,51,3,5,8,0.16,-9,56,5.36,93,46249.0,15:6,1,0,1,100.0,157,61,3,9,-6,0,0,0,419.0,0:8,0,0,0,3052.0,0:59,600000
8474150,Mikael,Backlund,1989-03-17,C,L,2014-15,52,10,17,27,0.52,4,103,9.71,14,55363.0,17:44,423,452,875,48.34,41,32,58,42,16,0,1,1,5259.0,1:41,2,0,2,4517.0,1:26,1500000
8474151,Ryan,McDonagh,1989-06-13,D,L,2014-15,71,8,25,33,0.46,23,148,5.41,26,98545.0,23:7,0,0,0,0.0,77,139,40,60,-20,3,9,12,9846.0,2:18,0,3,3,11148.0,2:37,4700000
8474157,Max,Pacioretty,1988-11-20,LW,L,2014-15,80,37,30,67,0.84,38,302,12.25,32,93091.0,19:23,2,7,9,22.22,106,38,43,43,0,7,4,11,12381.0,2:34,3,2,5,7504.0,1:33,4500000
8474161,Jakub,Voracek,1989-08-15,RW,L,2014-15,82,22,59,81,0.99,1,221,9.95,78,91478.0,18:35,6,3,9,66.67,55,28,34,42,-8,11,22,33,16064.0,3:15,0,0,0,180.0,0:2,4250000
8474162,Jake,Muzzin,1989-02-21,D,L,2014-15,76,10,31,41,0.54,-4,173,5.78,22,103511.0,22:41,0,0,0,0.0,186,108,18,68,-50,4,10,14,11649.0,2:33,0,1,1,4197.0,0:55,1000000
8474164,Jonathon,Blum,1989-01-30,D,R,2014-15,4,0,1,1,0.25,-3,3,0.0,2,2368.0,9:52,0,0,0,0.0,1,2,0,1,-1,0,0,0,21.0,0:5,0,0,0,57.0,0:14,675000
8474166,Alec,Martinez,1987-07-26,D,L,2014-15,56,6,16,22,0.39,9,103,5.83,10,66967.0,19:55,0,0,0,0.0,95,117,11,38,-27,1,3,4,6533.0,1:56,0,0,0,5374.0,1:35,1100000
8474168,Joakim,Andersson,1989-02-05,C,L,2014-15,68,3,5,8,0.12,-4,74,4.05,22,47445.0,11:37,192,183,375,51.2,27,24,8,13,-5,0,0,0,420.0,0:6,0,0,0,8833.0,2:9,732500
8474176,Carl,Hagelin,1988-08-23,LW,L,2014-15,82,17,18,35,0.43,18,185,9.19,46,74941.0,15:13,6,11,17,35.29,85,36,51,43,8,1,0,1,434.0,0:5,0,1,1,9641.0,1:57,2250000
8474189,Lars,Eller,1989-05-08,C,L,2014-15,77,15,12,27,0.35,-6,150,10.0,42,71607.0,15:29,405,379,784,51.66,76,37,29,30,-1,1,1,2,2160.0,0:28,0,2,2,6221.0,1:20,3500000
8474190,Wayne,Simmonds,1988-08-26,RW,R,2014-15,75,28,22,50,0.67,-5,188,14.89,66,75635.0,16:48,4,1,5,80.0,168,36,33,29,4,14,10,24,14188.0,3:9,0,0,0,35.0,0:0,3975000
8474192,Matt,Frattin,1988-01-03,RW,R,2014-15,9,0,0,0,0.0,0,6,0.0,4,3810.0,7:3,1,0,1,100.0,4,4,0,1,-1,0,0,0,11.0,0:1,0,0,0,13.0,0:1,800000
8474207,Nick,Holden,1987-05-15,D,L,2014-15,78,5,9,14,0.18,-11,94,5.32,28,92697.0,19:48,0,0,0,0.0,156,96,24,34,-10,2,4,6,8658.0,1:51,0,0,0,9019.0,1:55,600000
8474218,Jason,Demers,1988-06-09,D,R,2014-15,81,5,20,25,0.31,-3,99,5.05,71,92952.0,19:7,0,0,0,0.0,118,85,37,49,-12,2,3,5,7835.0,1:36,0,0,0,8262.0,1:42,3400000
8474230,Micheal,Haley,1986-03-30,C,L,2014-15,4,0,0,0,0.0,-1,1,0.0,11,1802.0,7:30,2,0,2,100.0,6,1,0,0,0,0,0,0,0.0,0:0,0,0,0,0.0,0:0,600000
8474250,Zack,Smith,1988-04-05,LW,L,2014-15,37,2,1,3,0.08,-8,38,5.26,18,26714.0,12:2,103,128,231,44.59,64,13,15,7,8,0,0,0,434.0,0:11,0,0,0,2141.0,0:57,1887500
8474291,Jay,Beagle,1985-10-16,C,R,2014-15,62,10,10,20,0.32,6,84,11.9,20,47649.0,12:48,217,167,384,56.51,73,33,30,6,24,0,0,0,110.0,0:1,0,1,1,6937.0,1:51,900000
8474497,Michael,Kostka,1985-11-28,D,R,2014-15,7,0,1,1,0.14,1,7,0.0,0,6462.0,15:23,0,0,0,0.0,6,9,2,5,-3,0,0,0,27.0,0:3,0,0,0,284.0,0:40,650000
8474516,Bryan,Lerg,1986-01-20,C,L,2014-15,2,1,0,1,0.5,-1,8,12.5,0,1512.0,12:36,4,0,4,100.0,3,0,0,1,-1,0,0,0,122.0,1:1,0,0,0,2.0,0:1,575000
8474519,Jack,Hillen,1986-01-24,D,L,2014-15,38,0,5,5,0.13,-1,24,0.0,10,29322.0,12:51,0,0,0,0.0,38,53,6,9,-3,0,0,0,66.0,0:1,0,0,0,125.0,0:3,700000
8474520,Jason,Garrison,1984-11-13,D,L,2014-15,70,4,26,30,0.43,27,111,3.6,19,84041.0,20:0,0,0,0,0.0,46,94,21,29,-8,1,10,11,7034.0,1:40,0,0,0,9384.0,2:14,4600000
8474535,Chris,Mueller,1986-03-06,C,R,2014-15,7,1,1,2,0.29,-1,10,10.0,0,4390.0,10:27,38,26,64,59.38,3,1,1,2,-1,1,0,1,789.0,1:52,0,0,0,0.0,0:0,600000
8474563,Drew,Doughty,1989-12-08,D,R,2014-15,82,7,39,46,0.56,3,219,3.2,56,142660.0,28:59,0,1,1,0.0,152,144,12,80,-68,1,16,17,16931.0,3:26,0,1,1,13031.0,2:38,7000000
8474564,Steven,Stamkos,1990-02-07,C,R,2014-15,82,43,29,72,0.88,2,268,16.04,49,95289.0,19:22,469,474,943,49.73,91,35,34,37,-3,13,12,25,17468.0,3:33,0,0,0,1010.0,0:12,7500000
8474565,Alex,Pietrangelo,1990-01-18,D,R,2014-15,81,7,39,46,0.57,-2,195,3.59,28,123487.0,25:24,0,0,0,0.0,70,161,33,38,-5,1,11,12,11864.0,2:26,0,0,0,14974.0,3:4,6500000
8474567,Zach,Bogosian,1990-07-15,D,R,2014-15,62,3,17,20,0.32,-6,125,2.4,78,88015.0,23:39,0,0,0,0.0,189,90,14,38,-24,0,2,2,5943.0,1:35,0,0,0,9339.0,2:30,5142857
8474568,Luke,Schenn,1989-11-02,D,R,2014-15,58,3,11,14,0.24,-2,67,4.48,18,62883.0,18:4,0,0,0,0.0,194,89,7,39,-32,0,0,0,270.0,0:4,0,0,0,8010.0,2:18,3600000
8474569,Colin,Wilson,1989-10-20,C,L,2014-15,77,20,22,42,0.55,19,172,11.63,22,74897.0,16:12,71,107,178,39.89,52,33,29,32,-3,3,4,7,11460.0,2:28,0,0,0,97.0,0:1,2000000
8474570,Cody,Hodgson,1990-02-18,C,R,2014-15,78,6,7,13,0.17,-28,127,4.72,12,60120.0,12:50,173,204,377,45.89,40,21,24,16,8,0,1,1,6247.0,1:20,0,0,0,36.0,0:0,4250000
8474571,Mikkel,Boedker,1989-12-16,LW,L,2014-15,45,14,14,28,0.62,-10,79,17.72,6,47206.0,17:29,0,2,2,0.0,66,9,24,14,10,3,9,12,7659.0,2:50,0,0,0,240.0,0:5,2550000
8474573,Josh,Bailey,1989-10-02,RW,L,2014-15,70,15,26,41,0.59,3,140,10.71,12,70479.0,16:46,30,36,66,45.45,66,36,53,47,6,2,2,4,6905.0,1:38,0,0,0,682.0,0:9,3300000
8474574,Tyler,Myers,1990-02-01,D,R,2014-15,71,7,21,28,0.39,-6,124,5.65,77,104963.0,24:38,0,0,0,0.0,65,132,44,54,-10,2,4,6,12374.0,2:54,0,2,2,11096.0,2:36,5500000
8474576,Zach,Boychuk,1989-10-04,LW,L,2014-15,31,3,3,6,0.19,0,35,8.57,4,19764.0,10:37,0,0,0,0.0,40,9,9,3,6,0,0,0,487.0,0:15,0,0,0,3.0,0:0,600000
8474577,Joe,Colborne,1990-01-30,C,L,2014-15,64,8,20,28,0.44,7,67,11.94,43,59214.0,15:25,176,160,336,52.38,158,35,25,33,-8,1,4,5,5571.0,1:27,1,0,1,2817.0,0:44,1275000
8474578,Erik,Karlsson,1990-05-31,D,R,2014-15,82,21,45,66,0.8,7,292,7.19,42,134095.0,27:15,0,0,0,0.0,93,89,59,99,-40,6,24,30,23624.0,4:48,0,0,0,2763.0,0:33,6500000
8474579,Luca,Sbisa,1990-01-30,D,L,2014-15,76,3,8,11,0.14,-8,79,3.8,46,85623.0,18:46,0,0,0,0.0,151,128,14,46,-32,0,0,0,424.0,0:5,0,0,0,9211.0,2:1,2175000
8474581,Jake,Gardiner,1990-07-04,D,L,2014-15,79,4,20,24,0.3,-23,100,4.0,24,99415.0,20:58,0,0,0,0.0,109,83,39,66,-27,0,8,8,11847.0,2:29,0,0,0,1085.0,0:13,4050000
8474584,Michael,Del Zotto,1990-06-24,D,L,2014-15,64,10,22,32,0.5,-5,119,8.4,34,84189.0,21:55,0,0,0,0.0,153,128,14,36,-22,1,7,8,6668.0,1:44,1,0,1,7407.0,1:55,1300000
8474586,Jordan,Eberle,1990-05-15,C,R,2014-15,81,24,39,63,0.78,-16,183,13.11,24,92545.0,19:2,1,5,6,16.67,62,36,37,73,-36,6,15,21,12744.0,2:37,0,0,0,394.0,0:4,6000000
8474589,Tyler,Ennis,1989-10-06,LW,L,2014-15,78,20,26,46,0.59,-19,185,10.81,37,89459.0,19:6,67,116,183,36.61,87,35,30,21,9,6,11,17,14257.0,3:2,1,0,1,1302.0,0:16,4600000
8474590,John,Carlson,1990-01-10,D,R,2014-15,82,12,43,55,0.67,11,193,6.22,28,113518.0,23:4,0,0,0,0.0,74,200,41,88,-47,3,13,16,8552.0,1:44,1,0,1,14554.0,2:57,3966667
8474594,Slava,Voynov,1990-01-15,D,R,2014-15,6,0,2,2,0.33,0,5,0.0,2,8347.0,23:11,0,0,0,0.0,11,8,1,8,-7,0,1,1,978.0,2:43,0,1,1,986.0,2:44,4166666
8474597,Cody,Goloubef,1989-11-30,D,R,2014-15,36,0,9,9,0.25,12,23,0.0,19,33621.0,15:33,0,0,0,0.0,44,32,3,14,-11,0,0,0,113.0,0:3,0,1,1,1853.0,0:51,625000
8474600,Roman,Josi,1990-06-01,D,L,2014-15,81,15,40,55,0.68,15,201,7.46,26,128665.0,26:28,0,1,1,0.0,53,209,25,45,-20,3,12,15,15099.0,3:6,0,3,3,11860.0,2:26,4000000
8474602,Justin,Schultz,1990-07-06,D,R,2014-15,81,6,25,31,0.38,-17,122,4.92,12,109891.0,22:36,1,0,1,100.0,41,114,20,69,-49,0,12,12,13602.0,2:47,0,0,0,1678.0,0:20,3675000
8474603,Eric,O'Dell,1990-06-21,C,R,2014-15,11,0,1,1,0.09,0,6,0.0,19,4906.0,7:26,18,23,41,43.9,14,0,8,4,4,0,0,0,81.0,0:7,0,0,0,0.0,0:0,650000
8474605,Patrick,Wiercioch,1990-09-12,D,L,2014-15,56,3,10,13,0.23,3,79,3.8,28,60669.0,18:3,0,0,0,0.0,50,44,10,47,-37,1,4,5,8059.0,2:23,0,0,0,558.0,0:9,2000000
8474606,Colby,Robak,1990-04-24,D,L,2014-15,12,0,1,1,0.08,2,8,0.0,2,10021.0,13:55,0,0,0,0.0,16,10,2,8,-6,0,0,0,49.0,0:4,0,0,0,516.0,0:43,675000
8474610,Zac,Dalpe,1989-11-01,C,R,2014-15,21,1,2,3,0.14,-11,29,3.45,4,11689.0,9:16,20,13,33,60.61,15,8,5,3,2,0,0,0,75.0,0:3,0,0,0,0.0,0:0,700000
8474612,Travis,Hamonic,1990-08-16,D,R,2014-15,71,5,28,33,0.46,15,132,3.79,85,92827.0,21:47,0,0,0,0.0,213,131,27,56,-29,1,7,8,5076.0,1:11,0,0,0,8009.0,1:52,3857143
8474613,Derek,Stepan,1990-06-18,C,R,2014-15,68,16,39,55,0.81,26,155,10.32,22,74178.0,18:10,543,689,1232,44.07,36,27,46,32,14,3,7,10,10881.0,2:40,2,3,5,6503.0,1:35,3075000
8474618,Marco,Scandella,1990-02-23,D,L,2014-15,64,11,12,23,0.36,8,112,9.82,56,83420.0,21:43,0,0,0,0.0,90,100,30,31,-1,1,4,5,2167.0,0:33,0,1,1,9211.0,2:23,1025000
8474625,Jimmy,Hayes,1989-11-21,RW,R,2014-15,72,19,16,35,0.49,-4,166,11.45,20,65416.0,15:8,4,5,9,44.44,147,12,22,19,3,4,7,11,8608.0,1:59,0,0,0,178.0,0:2,925000
8474627,Jori,Lehtera,1987-12-23,C,L,2014-15,75,14,30,44,0.59,21,103,13.59,48,72948.0,16:12,543,518,1061,51.18,43,35,40,17,23,2,5,7,10434.0,2:19,1,1,2,1866.0,0:24,2750000
8474628,Michael,Stone,1990-06-07,D,R,2014-15,81,3,15,18,0.22,-24,144,2.08,60,101418.0,20:52,1,0,1,100.0,202,189,12,23,-11,0,5,5,5378.0,1:6,0,0,0,8195.0,1:41,1150000
8474638,Andrew,Campbell,1988-02-04,D,L,2014-15,33,0,1,1,0.03,-13,28,0.0,10,34723.0,17:32,0,0,0,0.0,67,58,2,6,-4,0,0,0,16.0,0:0,0,0,0,5812.0,2:56,550000
8474641,Adam,Henrique,1990-02-06,C,L,2014-15,75,16,27,43,0.57,-6,127,12.6,34,79846.0,17:44,270,249,519,52.02,59,44,31,21,10,5,11,16,7778.0,1:43,0,1,1,8341.0,1:51,4000000
8474642,Lance,Bouma,1990-03-25,LW,L,2014-15,78,16,18,34,0.44,10,104,15.38,54,65567.0,14:0,29,45,74,39.19,264,82,22,25,-3,0,1,1,268.0,0:3,0,1,1,8302.0,1:46,775000
8474646,Brandon,McMillan,1990-03-22,LW,L,2014-15,58,1,3,4,0.07,-19,51,1.96,16,36429.0,10:28,10,13,23,43.48,91,23,15,2,13,0,0,0,133.0,0:2,0,0,0,4774.0,1:22,625000
8474659,Matt,Donovan,1990-05-09,D,L,2014-15,12,0,3,3,0.25,4,12,0.0,0,12653.0,17:34,0,0,0,0.0,22,16,3,11,-8,0,0,0,803.0,1:6,0,0,0,174.0,0:14,826875
8474660,David,Warsofsky,1990-05-30,D,L,2014-15,4,0,1,1,0.25,1,7,0.0,0,4262.0,17:45,0,0,0,0.0,2,2,0,1,-1,0,0,0,469.0,1:57,0,0,0,317.0,1:19,600000
8474661,Michal,Jordan,1990-07-17,D,L,2014-15,38,2,4,6,0.16,-7,44,4.55,4,36355.0,15:56,0,0,0,0.0,35,61,8,19,-11,2,0,2,2344.0,1:1,0,0,0,174.0,0:4,550000
8474668,Dale,Weise,1988-08-05,RW,R,2014-15,79,10,19,29,0.37,21,91,10.99,34,57741.0,12:10,5,7,12,41.67,145,34,26,12,14,0,0,0,459.0,0:5,0,0,0,2874.0,0:36,1025000
8474673,TJ,Brodie,1990-06-07,D,L,2014-15,81,11,30,41,0.51,15,133,8.27,30,122510.0,25:12,0,0,0,0.0,27,178,71,88,-17,3,6,9,10656.0,2:11,1,2,3,9998.0,2:3,2125000
8474679,Gustav,Nyquist,1989-09-01,RW,L,2014-15,82,27,27,54,0.66,-11,195,13.85,26,81951.0,16:39,1,8,9,11.11,43,31,34,32,2,14,10,24,14804.0,3:0,0,0,0,84.0,0:1,950000
8474685,Matt,Calvert,1989-12-24,LW,L,2014-15,56,13,10,23,0.41,1,93,13.98,28,53739.0,15:59,6,4,10,60.0,92,20,26,19,7,0,0,0,3014.0,0:53,0,1,1,6698.0,1:59,987500
8474688,Greg,Pateryn,1990-06-20,D,R,2014-15,17,0,0,0,0.0,0,10,0.0,6,12907.0,12:39,0,0,0,0.0,48,18,0,10,-10,0,0,0,98.0,0:5,0,0,0,522.0,0:30,562500
8474697,Mark,Borowiecki,1989-07-12,D,L,2014-15,63,1,10,11,0.17,15,30,3.33,107,60142.0,15:54,0,0,0,0.0,233,102,9,21,-12,0,0,0,125.0,0:1,0,0,0,8307.0,2:11,575000
8474709,Matt,Martin,1989-05-08,LW,L,2014-15,78,8,6,14,0.18,-4,90,8.89,114,52741.0,11:16,5,5,10,50.0,382,36,24,27,-3,0,0,0,655.0,0:8,0,0,0,222.0,0:2,1000000
8474715,Cam,Atkinson,1989-06-05,RW,R,2014-15,78,22,18,40,0.51,-2,212,10.38,22,79518.0,16:59,4,5,9,44.44,55,39,40,22,18,7,3,10,10816.0,2:18,1,0,1,4578.0,0:58,1150000
8474716,Jared,Spurgeon,1989-11-29,D,R,2014-15,66,9,16,25,0.38,3,128,7.03,6,89586.0,22:37,0,0,0,0.0,48,124,31,30,1,3,3,6,8020.0,2:1,0,0,0,8639.0,2:10,2666667
8474717,Mark,Barberio,1990-03-23,D,L,2014-15,52,1,6,7,0.13,-4,53,1.89,16,52362.0,16:46,0,0,0,0.0,35,46,13,20,-7,0,0,0,200.0,0:3,0,0,0,2523.0,0:48,874125
8474722,Luke,Witkowski,1990-04-14,RW,R,2014-15,16,0,0,0,0.0,0,10,0.0,15,14579.0,15:11,0,0,0,0.0,37,20,2,10,-8,0,0,0,8.0,0:0,0,0,0,686.0,0:42,627500
8474727,Ben,Smith,1988-07-11,RW,R,2014-15,80,7,7,14,0.18,2,92,7.61,2,62650.0,13:3,310,284,594,52.19,72,75,22,16,6,0,0,0,698.0,0:8,0,0,0,10164.0,2:7,1500000
8474736,Zac,Rinaldo,1990-06-15,C,L,2014-15,58,1,5,6,0.1,-9,45,2.22,102,31035.0,8:55,1,2,3,33.33,216,20,9,9,0,0,0,0,255.0,0:4,0,0,0,945.0,0:16,750000
8474739,Tommy,Wingels,1988-04-12,C,R,2014-15,75,15,21,36,0.48,-7,158,9.49,40,74119.0,16:28,70,84,154,45.45,263,55,33,40,-7,4,6,10,6737.0,1:29,1,0,1,5749.0,1:16,2475000
8474743,Zach,Redmond,1988-07-26,D,R,2014-15,59,5,15,20,0.34,-1,93,5.38,24,60696.0,17:8,0,0,0,0.0,59,76,20,17,3,1,5,6,5302.0,1:29,0,0,0,1096.0,0:18,750000
8474744,Sean,Collins,1988-12-29,C,L,2014-15,8,0,2,2,0.25,0,4,0.0,2,4960.0,10:20,2,3,5,40.0,18,0,0,0,0,0,0,0,27.0,0:3,0,0,0,0.0,0:0,620000
8474748,Andrew,MacWilliam,1990-03-25,D,L,2014-15,12,0,2,2,0.17,-6,5,0.0,12,11090.0,15:24,0,1,1,0.0,35,20,2,4,-2,0,0,0,11.0,0:0,0,0,0,2046.0,2:50,875000
8474749,Matt,Bartkowski,1988-06-04,D,L,2014-15,47,0,4,4,0.09,-6,67,0.0,37,47774.0,16:56,0,0,0,0.0,88,24,6,25,-19,0,0,0,218.0,0:4,0,0,0,3156.0,1:7,1250000
8474772,Stu,Bickel,1986-10-02,D,R,2014-15,9,0,1,1,0.11,1,3,0.0,46,2937.0,5:26,0,0,0,0.0,10,9,1,2,-1,0,0,0,0.0,0:0,0,0,0,0.0,0:0,600000
8474774,Dalton,Prout,1990-03-13,D,R,2014-15,63,0,8,8,0.13,-14,64,0.0,85,69610.0,18:24,0,0,0,0.0,166,84,3,18,-15,0,0,0,226.0,0:3,0,0,0,8841.0,2:20,1075000
8474793,Justin,Hodgman,1988-06-27,C,R,2014-15,5,1,0,1,0.2,-2,3,33.33,2,3419.0,11:23,25,21,46,54.35,8,0,0,2,-2,1,0,1,220.0,0:44,0,0,0,0.0,0:0,550000
8474818,Jordie,Benn,1987-07-26,D,L,2014-15,73,2,14,16,0.22,-5,70,2.86,34,79128.0,18:3,0,1,1,0.0,92,121,16,44,-28,0,2,2,2979.0,0:40,0,0,0,7952.0,1:48,700000
8474849,Antoine,Roussel,1989-11-21,LW,L,2014-15,80,13,12,25,0.31,-20,113,11.5,148,69705.0,14:31,3,14,17,17.65,115,71,31,38,-7,0,3,3,3012.0,0:37,0,0,0,8522.0,1:46,2000000
8474870,Tyler,Johnson,1990-07-29,C,R,2014-15,77,29,43,72,0.94,33,203,14.29,24,79641.0,17:14,537,566,1103,48.69,64,36,26,31,-5,8,9,17,10386.0,2:14,0,0,0,8127.0,1:45,3333333
8474873,Brian,Lashoff,1990-07-16,D,L,2014-15,11,0,2,2,0.18,4,7,0.0,6,8768.0,13:17,0,0,0,0.0,7,14,3,2,1,0,0,0,0.0,0:0,0,0,0,930.0,1:24,725000
8474884,Mike,Hoffman,1989-11-24,LW,L,2014-15,79,27,21,48,0.61,16,199,13.57,14,68986.0,14:33,7,7,14,50.0,40,33,57,45,12,1,2,3,8285.0,1:44,0,0,0,289.0,0:3,750000
8475098,Tyler,Bozak,1986-03-19,C,R,2014-15,82,23,26,49,0.6,-34,154,14.94,44,94206.0,19:8,944,831,1775,53.18,83,46,68,23,45,12,6,18,17358.0,3:31,2,0,2,3433.0,0:41,4200000
8475119,Zach,Sill,1988-05-24,C,L,2014-15,63,1,3,4,0.06,-5,43,2.33,84,31687.0,8:22,46,47,93,49.46,173,27,15,6,9,0,0,0,241.0,0:3,0,0,0,2924.0,0:46,550000
8475147,Jordan,Schroeder,1990-09-29,LW,R,2014-15,25,3,5,8,0.32,9,48,6.25,2,16284.0,10:51,0,0,0,0.0,24,6,13,5,8,0,0,0,10.0,0:0,0,0,0,131.0,0:5,600000
8475148,Tim,Erixon,1991-02-24,D,L,2014-15,42,2,5,7,0.17,-7,36,5.56,14,38348.0,15:13,0,0,0,0.0,34,32,8,10,-2,1,4,5,5094.0,2:1,0,0,0,1667.0,0:39,600000
8475149,Marcus,Johansson,1990-10-06,LW,L,2014-15,82,20,27,47,0.57,6,138,14.49,10,81057.0,16:28,7,9,16,43.75,69,18,29,30,-1,3,12,15,14380.0,2:55,0,0,0,182.0,0:2,2000000
8475150,Jordan,Caron,1990-11-02,RW,L,2014-15,30,0,0,0,0.0,-2,12,0.0,18,14464.0,8:2,0,1,1,0.0,41,8,1,3,-2,0,0,0,59.0,0:1,0,0,0,49.0,0:1,600000
8475151,Kyle,Palmieri,1991-02-01,RW,R,2014-15,57,14,15,29,0.51,-2,112,12.5,37,48211.0,14:5,6,6,12,50.0,97,24,15,27,-12,5,6,11,5867.0,1:42,0,0,0,11.0,0:0,1466667
8475153,Dylan,Olsen,1991-01-03,D,L,2014-15,44,2,6,8,0.18,-7,44,4.55,20,41984.0,15:54,0,0,0,0.0,77,52,9,9,0,0,1,1,1533.0,0:34,0,0,0,4653.0,1:45,775000
8475154,Carter,Ashton,1991-04-01,RW,L,2014-15,7,0,0,0,0.0,-3,4,0.0,0,2614.0,6:13,1,4,5,20.0,6,3,2,1,1,0,0,0,0.0,0:0,0,0,0,32.0,0:4,850500
8475155,Simon,Despres,1991-07-27,D,L,2014-15,75,3,20,23,0.31,11,103,2.91,86,75897.0,16:51,0,1,1,0.0,233,101,11,30,-19,0,1,1,1897.0,0:25,0,0,0,3714.0,0:49,900000
8475157,Landon,Ferraro,1991-08-08,C,R,2014-15,3,1,0,1,0.33,1,4,25.0,0,2157.0,11:59,0,0,0,0.0,3,3,3,0,3,0,0,0,2.0,0:0,0,0,0,0.0,0:0,550000
8475158,Ryan,O'Reilly,1991-02-07,C,L,2014-15,82,17,38,55,0.67,-5,171,9.94,12,97026.0,19:43,713,621,1334,53.45,38,48,98,26,72,2,10,12,12915.0,2:37,1,1,2,8867.0,1:48,6000000
8475160,Kyle,Clifford,1991-01-13,LW,L,2014-15,80,6,9,15,0.19,5,117,5.13,87,51544.0,10:44,2,4,6,33.33,200,14,17,20,-3,0,0,0,505.0,0:6,0,0,0,170.0,0:2,1075000
8475161,Chris,Brown,1991-02-03,RW,R,2014-15,5,1,0,1,0.2,1,4,25.0,2,1938.0,6:27,1,2,3,33.33,6,1,0,2,-2,0,0,0,2.0,0:0,0,0,0,0.0,0:0,853333
8475162,Mat,Clark,1990-10-17,D,R,2014-15,7,0,1,1,0.14,2,2,0.0,6,5364.0,12:46,0,0,0,0.0,10,5,1,2,-1,0,0,0,0.0,0:0,0,0,0,457.0,1:5,550000
8475163,Alex,Chiasson,1990-10-01,RW,R,2014-15,76,11,15,26,0.34,-5,105,10.48,67,60996.0,13:22,3,18,21,14.29,93,20,22,9,13,3,3,6,8728.0,1:54,0,1,1,3851.0,0:50,866667
8475164,Jakob,Silfverberg,1990-10-13,RW,R,2014-15,81,13,26,39,0.48,15,189,6.88,24,76115.0,15:39,23,27,50,46.0,42,37,41,19,22,2,2,4,2880.0,0:35,1,2,3,8527.0,1:45,850000
8475165,Anton,Lander,1991-04-24,C,L,2014-15,38,6,14,20,0.53,-12,61,9.84,14,34227.0,15:0,226,225,451,50.11,59,12,8,18,-10,4,3,7,4707.0,2:3,0,0,0,1959.0,0:51,600000
8475166,John,Tavares,1990-09-20,C,L,2014-15,82,38,48,86,1.05,5,278,13.67,46,101712.0,20:40,753,689,1442,52.22,48,37,94,109,-15,13,18,31,18218.0,3:42,0,1,1,162.0,0:1,5500000
8475167,Victor,Hedman,1990-12-18,D,L,2014-15,59,10,28,38,0.64,12,115,8.7,40,80301.0,22:41,0,0,0,0.0,51,110,29,66,-37,3,8,11,8884.0,2:30,0,0,0,8489.0,2:23,4000000
8475168,Matt,Duchene,1991-01-16,C,L,2014-15,82,21,34,55,0.67,3,207,10.14,16,91373.0,18:34,635,582,1217,52.18,43,74,49,34,15,2,5,7,11322.0,2:18,0,0,0,763.0,0:9,6000000
8475169,Evander,Kane,1991-08-02,LW,L,2014-15,37,10,12,22,0.59,-1,126,7.94,56,42874.0,19:18,30,37,67,44.78,119,14,18,19,-1,4,2,6,4806.0,2:9,1,2,3,3956.0,1:46,5250000
8475170,Brayden,Schenn,1991-08-22,C,L,2014-15,82,18,29,47,0.57,-5,156,11.54,34,84034.0,17:4,86,98,184,46.74,199,38,28,31,-3,7,12,19,14688.0,2:59,0,0,0,191.0,0:2,2500000
8475171,Oliver,Ekman-Larsson,1991-07-17,D,L,2014-15,82,23,20,43,0.52,-18,264,8.71,40,124047.0,25:12,0,0,0,0.0,167,77,30,46,-16,10,10,20,19115.0,3:53,1,0,1,12630.0,2:34,5500000
8475172,Nazem,Kadri,1990-10-06,C,L,2014-15,73,18,21,39,0.53,-7,176,10.23,28,77099.0,17:36,528,616,1144,46.15,118,23,44,43,1,3,4,7,10832.0,2:28,1,0,1,701.0,0:9,2900000
8475174,Jared,Cowen,1991-01-25,D,L,2014-15,54,3,6,9,0.17,-11,47,6.38,45,58808.0,18:9,0,0,0,0.0,159,76,13,33,-20,0,0,0,342.0,0:6,0,0,0,6920.0,2:8,3100000
8475175,Magnus,Paajarvi,1991-04-12,LW,L,2014-15,10,0,1,1,0.1,-2,9,0.0,6,5878.0,9:47,1,0,1,100.0,8,0,0,1,-1,0,1,1,193.0,0:19,0,0,0,0.0,0:0,1200000
8475176,Ryan,Ellis,1991-01-03,D,R,2014-15,58,9,18,27,0.47,8,118,7.63,27,66057.0,18:58,0,0,0,0.0,41,74,21,27,-6,2,4,6,7652.0,2:11,0,0,0,2289.0,0:39,2500000
8475177,Calvin,de Haan,1991-05-09,D,L,2014-15,65,1,11,12,0.18,3,92,1.09,24,74140.0,19:0,0,0,0,0.0,140,130,19,44,-25,0,1,1,742.0,0:11,1,0,1,6793.0,1:44,1966667
8475178,Zack,Kassian,1991-01-24,RW,R,2014-15,42,10,6,16,0.38,-5,55,18.18,81,31798.0,12:37,0,6,6,0.0,88,2,10,14,-4,1,0,1,1647.0,0:39,0,0,0,44.0,0:1,1750000
8475179,Dmitry,Kulikov,1990-10-29,D,L,2014-15,73,3,19,22,0.3,0,83,3.61,48,93344.0,21:18,0,0,0,0.0,114,105,17,26,-9,1,5,6,6543.0,1:29,0,1,1,11094.0,2:31,4333333
8475180,Peter,Holland,1991-01-14,C,L,2014-15,62,11,14,25,0.4,0,93,11.83,31,54019.0,14:31,312,373,685,45.55,99,21,67,21,46,1,2,3,4143.0,1:6,1,1,2,6313.0,1:41,775000
8475181,Nick,Leddy,1991-03-20,D,L,2014-15,78,10,27,37,0.47,18,120,8.33,14,95293.0,20:21,0,0,0,0.0,73,90,39,42,-3,1,11,12,11411.0,2:26,0,1,1,3166.0,0:40,2700000
8475182,David,Rundblad,1990-10-08,D,R,2014-15,49,3,11,14,0.29,17,58,5.17,12,37630.0,12:47,0,0,0,0.0,23,38,10,29,-19,0,1,1,1653.0,0:33,0,0,0,32.0,0:0,785000
8475184,Chris,Kreider,1991-04-30,LW,L,2014-15,80,21,25,46,0.57,24,180,11.67,88,75415.0,15:42,9,12,21,42.86,162,17,25,46,-21,7,1,8,9028.0,1:52,0,0,0,4.0,0:0,2475000
8475185,Jacob,Josefson,1991-03-02,C,L,2014-15,62,6,5,11,0.18,0,61,9.84,24,46245.0,12:25,289,297,586,49.32,55,30,15,14,1,0,2,2,1911.0,0:30,3,0,3,6884.0,1:51,800000
8475186,John,Moore,1990-11-19,D,L,2014-15,57,2,9,11,0.19,-4,77,2.6,30,55769.0,16:18,0,0,0,0.0,77,52,7,23,-16,0,4,4,4471.0,1:18,0,0,0,725.0,0:12,850500
8475188,Brayden,McNabb,1991-01-21,D,L,2014-15,71,2,22,24,0.34,11,74,2.7,52,67730.0,15:53,1,0,1,100.0,175,56,12,45,-33,0,5,5,4567.0,1:4,0,0,0,3117.0,0:43,650000
8475191,Reilly,Smith,1991-04-01,RW,L,2014-15,81,13,27,40,0.49,7,143,9.09,20,74846.0,15:24,2,6,8,25.0,74,39,34,34,0,1,10,11,8712.0,1:47,0,0,0,81.0,0:1,1400000
8475192,Taylor,Beck,1991-05-13,LW,R,2014-15,62,8,8,16,0.26,-4,78,10.26,18,44379.0,11:55,5,5,10,50.0,61,23,15,10,5,2,0,2,2469.0,0:39,0,0,0,1564.0,0:25,550000
8475193,Tomas,Tatar,1990-12-01,LW,L,2014-15,82,29,27,56,0.68,6,211,13.74,28,79818.0,16:13,6,6,12,50.0,90,18,27,40,-13,9,10,19,12257.0,2:29,0,0,0,34.0,0:0,2750000
8475194,Philip,Samuelsson,1991-07-26,D,L,2014-15,4,0,0,0,0.0,-3,4,0.0,0,4052.0,16:53,0,0,0,0.0,2,4,0,1,-1,0,0,0,0.0,0:0,0,0,0,658.0,2:44,550000
8475197,Tyson,Barrie,1991-07-26,D,R,2014-15,80,12,41,53,0.66,5,139,8.63,26,102554.0,21:21,0,0,0,0.0,80,90,40,47,-7,2,14,16,14232.0,2:57,0,0,0,982.0,0:12,2600000
8475199,Eric,Gelinas,1991-05-08,D,L,2014-15,61,6,13,19,0.31,-2,112,5.36,42,60247.0,16:27,0,0,0,0.0,82,50,13,28,-15,3,6,9,8135.0,2:13,0,0,0,303.0,0:4,900000
8475204,Brandon,Pirri,1991-04-10,RW,L,2014-15,49,22,2,24,0.49,6,143,15.38,14,43423.0,14:46,86,89,175,49.14,39,13,18,12,6,7,0,7,5073.0,1:43,0,0,0,167.0,0:3,925000
8475206,Stefan,Elliott,1991-01-30,D,R,2014-15,5,0,0,0,0.0,-2,10,0.0,2,4180.0,13:56,0,0,0,0.0,2,5,1,2,-1,0,0,0,445.0,1:29,0,0,0,0.0,0:0,850500
8475208,Brian,Dumoulin,1991-09-06,D,L,2014-15,8,1,0,1,0.12,0,4,25.0,2,7522.0,15:40,0,0,0,0.0,11,9,0,3,-3,0,0,0,196.0,0:24,0,0,0,363.0,0:45,831667
8475209,Richard,Panik,1991-02-07,RW,L,2014-15,76,11,6,17,0.22,-8,87,12.64,49,53100.0,11:38,2,5,7,28.57,101,57,30,20,10,2,0,2,3627.0,0:47,0,0,0,2167.0,0:28,735000
8475213,Drew,Shore,1991-01-29,C,R,2014-15,11,1,2,3,0.27,-5,13,7.69,0,7038.0,10:39,29,30,59,49.15,10,4,1,1,0,0,0,0,187.0,0:17,0,0,0,170.0,0:15,900000
8475214,Jeremy,Morin,1991-04-16,LW,R,2014-15,43,2,4,6,0.14,1,73,2.74,28,26314.0,10:11,2,3,5,40.0,45,5,14,9,5,0,0,0,608.0,0:14,0,0,0,1.0,0:0,800000
8475218,Mattias,Ekholm,1990-05-24,D,L,2014-15,80,7,11,18,0.22,12,86,8.14,52,91242.0,19:0,0,0,0,0.0,57,102,30,45,-15,1,1,2,2985.0,0:37,0,0,0,7260.0,1:30,1037500
8475220,Marcus,Foligno,1991-08-10,LW,L,2014-15,57,8,12,20,0.35,-5,66,12.12,50,55490.0,16:13,57,75,132,43.18,193,48,28,25,3,0,1,1,3133.0,0:54,0,1,1,4725.0,1:22,1875000
8475222,Sami,Vatanen,1991-06-03,D,R,2014-15,67,12,25,37,0.55,5,122,9.84,36,86277.0,21:27,1,1,2,50.0,75,123,27,48,-21,7,10,17,12558.0,3:7,1,0,1,7137.0,1:46,1262500
8475223,Linden,Vey,1991-07-17,RW,R,2014-15,75,10,14,24,0.32,-3,61,16.39,18,59271.0,13:10,215,287,502,42.83,14,9,25,28,-3,4,2,6,8411.0,1:52,0,0,0,71.0,0:0,735000
8475224,Jordan,Szwarz,1991-05-14,RW,R,2014-15,9,1,0,1,0.11,-2,8,12.5,2,7273.0,13:28,0,0,0,0.0,5,9,1,0,1,0,0,0,14.0,0:1,0,0,0,1216.0,2:15,630000
8475225,Craig,Smith,1989-09-05,RW,R,2014-15,82,23,21,44,0.54,11,252,9.13,44,77443.0,15:44,12,18,30,40.0,77,17,41,53,-12,6,3,9,12130.0,2:27,0,0,0,53.0,0:0,2000000
8475231,Casey,Cizikas,1991-02-27,C,L,2014-15,70,9,9,18,0.26,-2,90,10.0,24,52571.0,12:31,446,409,855,52.16,144,50,42,22,20,0,1,1,479.0,0:6,2,0,2,6032.0,1:26,1000000
8475233,David,Savard,1990-10-22,D,R,2014-15,82,11,25,36,0.44,0,112,9.82,71,112884.0,22:56,1,0,1,100.0,195,105,14,22,-8,3,7,10,9597.0,1:57,0,0,0,14117.0,2:52,1300000
8475235,Nicolas,Deslauriers,1991-02-22,LW,L,2014-15,82,5,10,15,0.18,-24,76,6.58,71,58407.0,11:52,0,1,1,0.0,261,36,9,8,1,0,0,0,539.0,0:6,0,1,1,3218.0,0:39,637500
8475236,Cody,Eakin,1991-05-24,C,L,2014-15,78,19,21,40,0.51,-1,142,13.38,26,80465.0,17:11,656,636,1292,50.77,62,59,68,41,27,2,2,4,6221.0,1:19,2,1,3,9179.0,1:57,1900000
8475243,Ryan,Bourque,1991-01-03,C,L,2014-15,1,0,0,0,0.0,-1,1,0.0,0,709.0,11:49,0,0,0,0.0,0,0,1,0,1,0,0,0,0.0,0:0,0,0,0,24.0,0:24,562500
8475246,Kevin,Connauton,1990-02-23,D,L,2014-15,62,9,12,21,0.34,5,96,9.38,35,60324.0,16:12,0,0,0,0.0,83,48,11,33,-22,0,3,3,6133.0,1:38,0,0,0,97.0,0:1,683333
8475247,Michael,Latta,1991-05-25,C,R,2014-15,53,0,6,6,0.11,4,24,0.0,68,26643.0,8:22,160,175,335,47.76,91,14,15,11,4,0,0,0,69.0,0:1,0,0,0,336.0,0:6,575000
8475250,Andrej,Nestrasil,1991-02-22,C,L,2014-15,54,7,13,20,0.37,-1,82,8.54,8,43259.0,13:21,55,39,94,58.51,54,17,31,13,18,2,3,5,4415.0,1:21,0,0,0,7.0,0:0,550000
8475253,Garrett,Wilson,1991-03-16,LW,L,2014-15,2,0,0,0,0.0,-2,5,0.0,0,1061.0,8:50,0,0,0,0.0,5,1,0,0,0,0,0,0,22.0,0:11,0,0,0,0.0,0:0,715000
8475254,Gabriel,Dumont,1990-10-06,C,R,2014-15,3,0,0,0,0.0,-1,4,0.0,0,1642.0,9:7,11,2,13,84.62,8,2,0,0,0,0,0,0,0.0,0:0,0,0,0,32.0,0:10,562500
8475260,Corban,Knight,1990-09-10,C,R,2014-15,2,0,0,0,0.0,0,2,0.0,0,768.0,6:24,9,2,11,81.82,4,1,0,0,0,0,0,0,0.0,0:0,0,0,0,0.0,0:0,900000
8475266,Tomas,Vincour,1990-11-19,C,R,2014-15,7,0,1,1,0.14,-1,2,0.0,2,3013.0,7:10,0,0,0,0.0,5,4,1,2,-1,0,0,0,0.0,0:0,0,0,0,0.0,0:0,600000
8475268,Gabriel,Bourque,1990-09-23,LW,L,2014-15,69,3,10,13,0.19,-13,76,3.95,10,49739.0,12:0,3,3,6,50.0,141,44,27,14,13,0,0,0,1164.0,0:16,0,0,0,4746.0,1:8,775000
8475274,Seth,Helgeson,1990-10-08,D,L,2014-15,22,0,2,2,0.09,4,11,0.0,18,17772.0,13:27,0,0,0,0.0,42,18,3,9,-6,0,0,0,8.0,0:0,0,0,0,1515.0,1:8,595000
8475279,Ben,Chiarot,1991-05-09,D,L,2014-15,40,2,6,8,0.2,5,37,5.41,22,40855.0,17:1,0,0,0,0.0,70,51,8,25,-17,0,0,0,122.0,0:3,0,0,0,1992.0,0:49,600000
8475287,Erik,Haula,1991-03-23,LW,L,2014-15,72,7,7,14,0.19,-7,92,7.61,32,52490.0,12:9,260,313,573,45.38,31,42,38,10,28,1,0,1,335.0,0:4,0,1,1,9227.0,2:8,900000
8475294,Rasmus,Rissanen,1991-07-13,D,L,2014-15,6,0,0,0,0.0,-5,3,0.0,4,5392.0,14:58,0,0,0,0.0,25,7,0,3,-3,0,0,0,14.0,0:2,0,0,0,283.0,0:47,575000
8475295,Brandon,Kozun,1990-03-08,RW,R,2014-15,20,2,2,4,0.2,-3,8,25.0,6,9493.0,7:54,1,1,2,50.0,21,4,7,4,3,0,0,0,43.0,0:2,0,0,0,544.0,0:27,550000
8475309,Jerry,D'Amigo,1991-02-19,RW,L,2014-15,9,0,0,0,0.0,-4,7,0.0,2,5254.0,9:43,0,0,0,0.0,8,7,3,0,3,0,0,0,16.0,0:1,0,0,0,690.0,1:16,850500
8475310,Curtis,McKenzie,1991-02-22,LW,L,2014-15,36,4,1,5,0.14,-8,41,9.76,48,24912.0,11:32,3,5,8,37.5,85,13,10,13,-3,0,0,0,89.0,0:2,0,0,0,126.0,0:3,645000
8475314,Anders,Lee,1990-07-03,LW,L,2014-15,76,25,16,41,0.54,9,197,12.69,33,65633.0,14:23,1,0,1,100.0,169,29,23,23,0,5,1,6,10054.0,2:12,0,0,0,181.0,0:2,850500
8475321,Phil,Varone,1990-12-04,C,L,2014-15,28,3,2,5,0.18,-14,28,10.71,10,22588.0,13:26,147,179,326,45.09,30,22,8,14,-6,0,0,0,1309.0,0:46,0,0,0,0.0,0:0,586667
8475323,Marcus,Kruger,1990-05-27,C,L,2014-15,81,7,10,17,0.21,-5,126,5.56,32,63609.0,13:5,357,313,670,53.28,29,50,30,9,21,0,0,0,122.0,0:1,0,0,0,10801.0,2:13,1287500
8475325,Jordan,Nolan,1989-06-23,C,L,2014-15,60,6,3,9,0.15,-6,44,13.64,54,35872.0,9:57,1,5,6,16.67,102,11,11,16,-5,0,0,0,310.0,0:5,0,0,0,24.0,0:0,700000
8475342,Oliver,Lauridsen,1989-03-24,D,L,2014-15,1,0,0,0,0.0,-1,2,0.0,10,626.0,10:26,0,0,0,0.0,2,0,0,1,-1,0,0,0,0.0,0:0,0,0,0,81.0,1:21,600000
8475414,Craig,Cunningham,1990-09-13,LW,R,2014-15,51,3,4,7,0.14,-7,54,5.56,4,32048.0,10:28,69,67,136,50.74,107,31,8,2,6,0,0,0,175.0,0:3,1,0,1,2915.0,0:57,600000
8475430,Brandon,Manning,1990-06-04,D,L,2014-15,11,0,3,3,0.27,3,10,0.0,7,11327.0,17:9,0,0,0,0.0,19,13,0,6,-6,0,0,0,158.0,0:14,0,0,0,1697.0,2:34,700000
8475455,Brenden,Dillon,1990-11-13,D,L,2014-15,80,2,8,10,0.12,-13,91,2.2,77,93941.0,19:34,0,0,0,0.0,154,139,15,51,-36,0,0,0,557.0,0:6,1,1,2,6485.0,1:21,1250000
8475461,Andrew,Agozzino,1991-01-03,LW,L,2014-15,1,0,1,1,1.0,1,1,0.0,0,585.0,9:45,0,2,2,0.0,1,0,1,0,1,0,0,0,0.0,0:0,0,0,0,0.0,0:0,590000
8475462,Radko,Gudas,1990-06-05,D,R,2014-15,31,2,3,5,0.16,-5,63,3.17,34,31620.0,17:0,0,0,0,0.0,115,63,9,12,-3,0,0,0,129.0,0:4,0,0,0,1250.0,0:40,991667
8475598,Ryan,Stanton,1989-07-20,D,L,2014-15,54,3,8,11,0.2,9,59,5.08,35,51857.0,16:0,0,0,0,0.0,93,113,10,31,-21,0,0,0,111.0,0:2,0,0,0,4154.0,1:16,550000
8475613,Nate,Prosser,1986-05-07,D,R,2014-15,63,2,5,7,0.11,-1,38,5.26,32,48368.0,12:47,0,0,0,0.0,34,102,7,13,-6,0,0,0,106.0,0:1,0,0,0,7348.0,1:56,700000
8475619,Aaron,Volpatti,1985-05-30,LW,L,2014-15,2,0,0,0,0.0,0,1,0.0,0,1154.0,9:37,0,0,0,0.0,3,1,0,1,-1,0,0,0,0.0,0:0,0,0,0,0.0,0:0,575000
8475625,Matt,Irwin,1987-11-29,D,L,2014-15,53,8,11,19,0.36,3,93,8.6,18,54122.0,17:1,0,0,0,0.0,55,65,14,26,-12,1,2,3,4242.0,1:20,0,0,0,480.0,0:9,1000000
8475650,Brandon,Bollig,1987-01-31,LW,L,2014-15,62,1,4,5,0.08,-9,67,1.49,88,31987.0,8:35,3,2,5,60.0,137,23,15,16,-1,0,0,0,223.0,0:3,0,0,0,135.0,0:2,1250000
8475671,Matt,Fraser,1990-05-20,RW,L,2014-15,60,8,4,12,0.2,-16,92,8.7,17,40385.0,11:13,3,4,7,42.86,111,20,13,16,-3,1,0,1,1636.0,0:27,0,0,0,36.0,0:0,625000
8475690,Christopher,Tanev,1989-12-20,D,R,2014-15,70,2,18,20,0.29,8,53,3.77,12,88540.0,21:4,0,0,0,0.0,23,170,26,49,-23,0,2,2,2184.0,0:31,0,0,0,11542.0,2:44,2000000
8475692,Mats,Zuccarello,1987-09-01,RW,L,2014-15,78,15,34,49,0.63,17,154,9.74,45,80772.0,17:15,16,21,37,43.24,120,42,60,41,19,0,6,6,9189.0,1:57,0,0,0,1774.0,0:22,3500000
8475714,Calle,Jarnkrok,1991-09-25,C,R,2014-15,74,7,11,18,0.24,2,95,7.37,18,57051.0,12:50,296,345,641,46.18,32,21,18,10,8,0,0,0,914.0,0:12,0,1,1,6702.0,1:30,715000
8475715,Oscar,Lindberg,1991-10-29,C,L,2014-15,1,0,0,0,0.0,0,2,0.0,0,498.0,8:18,2,3,5,40.0,3,0,0,1,-1,0,0,0,0.0,0:0,0,0,0,0.0,0:0,675000
8475716,Martin,Marincin,1992-02-18,D,L,2014-15,41,1,4,5,0.12,-4,38,2.63,16,45871.0,18:38,1,0,1,100.0,17,59,16,38,-22,0,0,0,282.0,0:6,0,0,0,4221.0,1:42,730000
8475722,Jason,Zucker,1992-01-16,LW,L,2014-15,51,21,5,26,0.51,-9,124,16.94,18,46082.0,15:3,2,5,7,28.57,67,13,21,19,2,1,0,1,2597.0,0:50,1,0,1,3449.0,1:7,900250
8475723,Petr,Straka,1992-06-15,RW,L,2014-15,3,0,2,2,0.67,1,2,0.0,0,1702.0,9:27,0,0,0,0.0,4,1,1,1,0,0,0,0,0.0,0:0,0,0,0,0.0,0:0,925000
8475726,Tyler,Toffoli,1992-04-24,C,R,2014-15,76,23,26,49,0.64,25,200,11.5,37,66526.0,14:35,4,5,9,44.44,86,11,37,32,5,3,2,5,6592.0,1:26,5,1,6,4531.0,0:59,716667
8475727,Ryan,Spooner,1992-01-30,C,L,2014-15,29,8,10,18,0.62,2,73,10.96,2,25296.0,14:32,100,120,220,45.45,17,5,8,11,-3,3,2,5,4797.0,2:45,0,0,0,165.0,0:5,760000
8475728,Johan,Larsson,1992-07-25,C,L,2014-15,39,6,10,16,0.41,0,50,12.0,12,33968.0,14:30,150,191,341,43.99,59,19,10,12,-2,1,3,4,2986.0,1:16,0,0,0,242.0,0:6,763333
8475732,Danny,Biega,1991-09-29,D,R,2014-15,10,0,2,2,0.2,-5,7,0.0,0,9685.0,16:8,0,0,0,0.0,27,7,1,7,-6,0,0,0,19.0,0:1,0,0,0,7.0,0:0,755000
8475733,Max,Reinhart,1992-02-04,C,L,2014-15,4,0,0,0,0.0,-3,3,0.0,0,1941.0,8:5,6,23,29,20.69,1,3,0,0,0,0,0,0,0.0,0:0,0,0,0,0.0,0:0,618333
8475735,Greg,McKegg,1992-06-17,C,L,2014-15,3,0,0,0,0.0,0,1,0.0,0,1654.0,9:11,17,16,33,51.52,3,2,0,0,0,0,0,0,21.0,0:7,0,0,0,0.0,0:0,660000
8475739,Michael,Bournival,1992-05-31,LW,L,2014-15,29,3,2,5,0.17,3,27,11.11,4,13725.0,7:53,4,1,5,80.0,26,10,6,7,-1,0,0,0,76.0,0:2,0,0,0,295.0,0:10,660000
8475744,Evgeny,Kuznetsov,1992-05-19,C,L,2014-15,80,11,26,37,0.46,10,127,8.66,24,63989.0,13:19,304,377,681,44.64,43,15,32,24,8,4,9,13,6609.0,1:22,0,0,0,98.0,0:1,900000
8475745,Charlie,Coyle,1992-03-02,C,R,2014-15,82,11,24,35,0.43,13,120,9.17,39,71602.0,14:33,334,384,718,46.52,137,52,24,20,4,1,2,3,6275.0,1:16,0,0,0,268.0,0:3,900000
8475747,Patrik,Nemeth,1992-02-08,D,L,2014-15,22,0,3,3,0.14,0,16,0.0,6,21398.0,16:12,0,0,0,0.0,28,21,3,8,-5,0,0,0,104.0,0:4,0,0,0,1510.0,1:8,763333
8475749,Christian,Thomas,1992-05-26,LW,R,2014-15,18,1,0,1,0.06,-2,26,3.85,7,9823.0,9:5,0,1,1,0.0,8,3,5,0,5,0,0,0,174.0,0:9,0,0,0,0.0,0:0,808333
8475750,Jon,Merrill,1992-02-03,D,L,2014-15,66,2,12,14,0.21,-14,47,4.26,24,81395.0,20:33,0,0,0,0.0,59,89,18,32,-14,2,2,4,3934.0,0:59,0,1,1,6958.0,1:45,840000
8475752,Tyler,Pitlick,1991-11-01,C,R,2014-15,17,2,0,2,0.12,-3,18,11.11,4,12692.0,12:26,5,4,9,55.56,55,17,4,6,-2,0,0,0,210.0,0:12,0,0,0,43.0,0:2,725000
8475753,Justin,Faulk,1992-03-20,D,R,2014-15,82,15,34,49,0.6,-19,238,6.3,30,120176.0,24:25,0,0,0,0.0,157,114,70,50,20,7,13,20,13352.0,2:42,2,0,2,9766.0,1:59,4833333
8475754,Brock,Nelson,1991-10-15,C,L,2014-15,82,20,22,42,0.51,6,190,10.53,24,78145.0,15:52,354,445,799,44.31,99,52,53,37,16,10,5,15,13341.0,2:42,0,0,0,4660.0,0:56,900000
8475755,Alex,Petrovic,1992-03-03,D,R,2014-15,33,0,3,3,0.09,-4,29,0.0,34,32194.0,16:15,0,0,0,0.0,76,34,4,12,-8,0,0,0,371.0,0:11,0,0,0,1560.0,0:47,795000
8475758,Devante,Smith-Pelly,1992-06-14,RW,R,2014-15,74,6,14,20,0.27,-1,104,5.77,24,63396.0,14:16,23,60,83,27.71,205,49,18,26,-8,0,1,1,4087.0,0:55,1,1,2,5163.0,1:9,800000
8475759,Brandon,Gormley,1992-02-18,D,L,2014-15,27,2,2,4,0.15,-7,39,5.13,10,24822.0,15:19,0,0,0,0.0,26,32,6,7,-1,1,0,1,882.0,0:32,0,0,0,2636.0,1:37,840000
8475760,Nick,Bjugstad,1992-07-17,C,R,2014-15,72,24,19,43,0.6,-7,207,11.59,38,71635.0,16:34,486,508,994,48.89,148,29,23,28,-5,7,5,12,10010.0,2:19,0,0,0,2233.0,0:31,900000
8475761,Beau,Bennett,1991-11-27,RW,R,2014-15,49,4,8,12,0.24,-1,81,4.94,16,36713.0,12:29,0,2,2,0.0,68,13,9,17,-8,0,0,0,2208.0,0:45,0,0,0,47.0,0:0,900000
8475763,Kevin,Hayes,1992-05-08,C,L,2014-15,79,17,28,45,0.57,15,111,15.32,22,61814.0,13:2,247,434,681,36.27,57,33,45,40,5,1,4,5,2888.0,0:36,1,0,1,2120.0,0:26,900000
8475764,Cam,Fowler,1991-12-05,D,L,2014-15,80,7,27,34,0.42,4,87,8.05,14,101490.0,21:8,0,0,0,0.0,47,107,23,52,-29,1,8,9,11555.0,2:24,1,1,2,8682.0,1:48,4000000
8475765,Vladimir,Tarasenko,1991-12-13,RW,L,2014-15,77,37,36,73,0.95,27,264,14.02,31,81426.0,17:37,0,3,3,0.0,32,18,35,19,16,8,10,18,12221.0,2:38,0,0,0,620.0,0:8,900000
8475767,Joey,Hishon,1991-10-20,C,L,2014-15,13,1,1,2,0.15,-1,19,5.26,0,7888.0,10:6,35,43,78,44.87,3,7,5,2,3,0,0,0,755.0,0:58,0,0,0,9.0,0:0,850500
8475768,Jaden,Schwartz,1992-06-25,LW,L,2014-15,75,28,35,63,0.84,13,184,15.22,16,82107.0,18:14,68,78,146,46.58,54,46,59,26,33,8,8,16,10546.0,2:20,0,2,2,5088.0,1:7,2350000
8475770,Emerson,Etem,1992-06-16,RW,L,2014-15,45,5,5,10,0.22,-6,77,6.49,4,33058.0,12:14,2,2,4,50.0,63,20,12,11,1,0,0,0,802.0,0:17,0,0,0,1249.0,0:27,870000
8475772,Riley,Sheahan,1991-12-07,C,L,2014-15,79,13,23,36,0.46,-3,123,10.57,16,74145.0,15:38,484,486,970,49.9,21,20,22,28,-6,5,6,11,11355.0,2:23,0,0,0,2773.0,0:35,950000
8475774,Petter,Granberg,1992-08-27,D,R,2014-15,7,0,0,0,0.0,1,1,0.0,6,4806.0,11:26,0,0,0,0.0,16,7,2,3,-1,0,0,0,2.0,0:0,0,0,0,983.0,2:20,800000
8475775,Tye,McGinn,1990-07-29,LW,L,2014-15,51,2,5,7,0.14,0,60,3.33,21,30914.0,10:6,1,1,2,50.0,71,17,8,11,-3,0,0,0,256.0,0:5,0,0,0,61.0,0:1,600000
8475780,Chris,Wagner,1991-05-27,RW,R,2014-15,9,0,0,0,0.0,-2,7,0.0,2,4746.0,8:47,33,22,55,60.0,22,3,1,0,1,0,0,0,0.0,0:0,0,0,0,253.0,0:28,900000
8475784,Jeff,Skinner,1992-05-16,LW,L,2014-15,77,18,13,31,0.4,-24,235,7.66,18,74142.0,16:2,21,25,46,45.65,47,12,62,42,20,4,3,7,9734.0,2:6,0,0,0,41.0,0:0,5725000
8475790,Erik,Gudbranson,1992-01-07,D,R,2014-15,76,4,9,13,0.17,-4,110,3.64,58,84898.0,18:37,0,0,0,0.0,212,75,6,33,-27,0,4,4,4029.0,0:53,0,0,0,9948.0,2:10,2500000
8475791,Taylor,Hall,1991-11-14,LW,L,2014-15,53,14,24,38,0.72,-1,158,8.86,40,61119.0,19:13,45,53,98,45.92,67,37,35,56,-21,3,3,6,7962.0,2:30,0,0,0,770.0,0:14,6000000
8475792,Brett,Connolly,1992-05-02,RW,R,2014-15,55,12,5,17,0.31,3,83,14.46,48,40105.0,12:9,18,25,43,41.86,90,13,9,6,3,2,1,3,6516.0,1:58,0,0,0,146.0,0:2,850500
8475793,Ryan,Johansen,1992-07-31,C,R,2014-15,82,26,45,71,0.87,-6,202,12.87,40,95951.0,19:30,851,787,1638,51.95,84,33,60,53,7,7,19,26,14115.0,2:52,2,0,2,6596.0,1:20,4000000
8475794,Tyler,Seguin,1992-01-31,C,R,2014-15,71,37,40,77,1.08,-1,280,13.21,20,83288.0,19:33,275,236,511,53.82,63,26,45,45,0,13,16,29,16461.0,3:51,0,0,0,237.0,0:3,5750000
8475796,Mark,Pysyk,1992-01-11,D,R,2014-15,7,2,1,3,0.43,4,4,50.0,2,7635.0,18:10,0,0,0,0.0,1,11,1,2,-1,0,0,0,164.0,0:23,0,0,0,393.0,0:56,900000
8475797,Jarred,Tinordi,1992-02-20,D,L,2014-15,13,0,2,2,0.15,-5,5,0.0,19,9412.0,12:4,0,0,0,0.0,20,18,1,4,-3,0,0,0,0.0,0:0,0,0,0,297.0,0:22,870000
8475798,Mikael,Granlund,1992-02-26,RW,L,2014-15,68,8,31,39,0.57,17,99,8.08,20,73019.0,17:53,476,508,984,48.37,47,45,34,24,10,0,8,8,8813.0,2:9,0,0,0,1791.0,0:26,900000
8475799,Nino,Niederreiter,1992-09-08,RW,L,2014-15,80,24,13,37,0.46,2,149,16.11,28,69817.0,14:32,2,5,7,28.57,155,32,28,16,12,6,2,8,7426.0,1:32,1,0,1,2163.0,0:27,2666667
8475800,Teemu,Pulkkinen,1992-01-02,LW,R,2014-15,31,5,3,8,0.26,5,67,7.46,10,21344.0,11:28,0,0,0,0.0,3,4,2,4,-2,1,1,2,4480.0,2:24,0,0,0,0.0,0:0,698333
8475807,Joakim,Nordstrom,1992-02-25,LW,L,2014-15,38,0,3,3,0.08,-5,42,0.0,4,25008.0,10:58,2,8,10,20.0,73,17,12,3,9,0,0,0,97.0,0:2,0,0,0,1338.0,0:35,616667
8475808,Michael,Chaput,1992-04-09,C,L,2014-15,33,1,4,5,0.15,-8,23,4.35,21,20194.0,10:11,143,151,294,48.64,59,20,4,3,1,0,0,0,144.0,0:4,0,0,0,1883.0,0:57,706667
8475810,Bryan,Rust,1992-05-11,RW,R,2014-15,14,1,1,2,0.14,-3,34,2.94,4,10102.0,12:1,0,0,0,0.0,21,3,2,6,-4,0,0,0,412.0,0:29,0,0,0,12.0,0:0,652500
8475816,Stanislav,Galiev,1992-01-17,RW,R,2014-15,2,1,0,1,0.5,1,2,50.0,0,1126.0,9:23,0,0,0,0.0,3,0,2,1,1,0,0,0,18.0,0:9,0,0,0,0.0,0:0,595000
8475826,Justin,Shugg,1991-12-24,RW,R,2014-15,3,0,0,0,0.0,0,3,0.0,2,1025.0,5:41,0,0,0,0.0,3,0,0,1,-1,0,0,0,7.0,0:2,0,0,0,0.0,0:0,600000
8475829,John,Ramage,1991-02-07,D,R,2014-15,1,0,0,0,0.0,-1,4,0.0,0,1090.0,18:10,0,0,0,0.0,2,1,0,0,0,0,0,0,0.0,0:0,0,0,0,0.0,0:0,690000
8475842,Sam,Carrick,1992-02-04,C,R,2014-15,16,1,1,2,0.12,1,17,5.88,9,6225.0,6:29,38,53,91,41.76,30,1,7,1,6,0,0,0,0.0,0:0,0,0,0,160.0,0:10,631667
8475848,Brendan,Gallagher,1992-05-06,RW,R,2014-15,82,24,23,47,0.57,18,254,9.45,31,81612.0,16:35,43,56,99,43.43,48,49,43,18,25,3,5,8,12020.0,2:26,0,0,0,153.0,0:1,685000
8475855,Jesper,Fast,1991-12-02,RW,R,2014-15,58,6,8,14,0.24,-1,52,11.54,8,41079.0,11:48,4,16,20,20.0,102,28,13,5,8,0,1,1,132.0,0:2,0,0,0,3830.0,1:6,805000
8475868,Anthony,Bitetto,1990-07-15,D,L,2014-15,7,0,0,0,0.0,-1,2,0.0,7,4947.0,11:46,1,0,1,100.0,9,3,1,3,-2,0,0,0,15.0,0:2,0,0,0,14.0,0:2,605000
8475869,Brandon,Davidson,1991-08-21,D,L,2014-15,12,1,0,1,0.08,-5,7,14.29,0,10899.0,15:8,0,0,0,0.0,18,22,0,4,-4,0,0,0,29.0,0:2,0,0,0,980.0,1:21,615000
8475878,Freddie,Hamilton,1992-01-01,C,R,2014-15,18,1,0,1,0.06,-2,11,9.09,0,8183.0,7:34,24,37,61,39.34,25,3,2,1,1,0,0,0,165.0,0:9,0,0,0,125.0,0:6,626667
8475902,Zach,Trotman,1990-08-26,D,R,2014-15,27,1,4,5,0.19,-2,46,2.17,0,26581.0,16:24,0,0,0,0.0,44,33,2,6,-4,0,0,0,1151.0,0:42,0,0,0,1254.0,0:46,625000
8475906,John,Klingberg,1992-08-14,D,R,2014-15,65,11,29,40,0.62,5,98,11.22,32,85182.0,21:50,0,0,0,0.0,54,77,32,59,-27,2,10,12,11462.0,2:56,0,0,0,590.0,0:9,713333
8475907,Micheal,Ferland,1992-04-20,LW,L,2014-15,26,2,3,5,0.19,1,34,5.88,16,16417.0,10:31,0,0,0,0.0,67,10,19,11,8,0,1,1,545.0,0:20,0,0,0,41.0,0:1,611667
8475913,Mark,Stone,1992-05-13,RW,R,2014-15,80,26,38,64,0.8,21,157,16.56,14,81702.0,17:1,7,11,18,38.89,49,53,98,43,55,5,8,13,11490.0,2:23,1,0,1,6697.0,1:23,603333
8475917,Jason,Akeson,1990-06-03,RW,R,2014-15,13,0,0,0,0.0,-1,9,0.0,8,6279.0,8:3,1,1,2,50.0,11,4,1,3,-2,0,0,0,177.0,0:13,0,0,0,7.0,0:0,575000
8475958,Michael,Sgarbossa,1992-07-25,C,L,2014-15,3,0,1,1,0.33,0,2,0.0,10,1277.0,7:5,9,11,20,45.0,0,1,0,0,0,0,0,0,1.0,0:0,0,0,0,0.0,0:0,556667
8475996,Brendan,Shinnimin,1991-01-07,C,L,2014-15,12,0,1,1,0.08,-1,10,0.0,8,7945.0,11:2,42,59,101,41.58,12,4,4,4,0,0,0,0,80.0,0:6,0,0,0,0.0,0:0,667500
8476043,Ben,Street,1987-02-13,C,L,2014-15,3,0,0,0,0.0,0,4,0.0,0,2087.0,11:35,17,15,32,53.12,3,0,1,2,-1,0,0,0,0.0,0:0,0,0,0,0.0,0:0,650000
8476062,Mark,Arcobello,1988-08-12,RW,R,2014-15,77,17,14,31,0.4,-10,129,13.18,20,68407.0,14:48,471,468,939,50.16,111,27,39,43,-4,1,3,4,4017.0,0:52,0,1,1,2687.0,0:34,600000
8476116,Ryan,Garbutt,1985-08-12,C,L,2014-15,67,8,17,25,0.37,-9,143,5.59,55,54535.0,13:33,16,9,25,64.0,82,48,27,21,6,0,0,0,440.0,0:6,1,0,1,6252.0,1:33,1800000
8476147,Kael,Mouillierat,1987-12-09,LW,L,2014-15,6,1,1,2,0.33,-3,1,100.0,8,3124.0,8:40,16,18,34,47.06,8,3,4,0,4,0,0,0,9.0,0:1,0,0,0,0.0,0:0,675000
8476158,Harry,Zolnierczyk,1987-09-01,LW,L,2014-15,2,0,0,0,0.0,-1,1,0.0,0,1335.0,11:7,0,2,2,0.0,6,1,1,0,1,0,0,0,0.0,0:0,0,0,0,89.0,0:44,650000
8476162,Steve,Oleksy,1986-02-04,D,R,2014-15,1,0,0,0,0.0,-1,1,0.0,0,731.0,12:11,0,0,0,0.0,2,0,0,0,0,0,0,0,0.0,0:0,0,0,0,0.0,0:0,541667
8476166,Taylor,Fedun,1988-06-04,D,R,2014-15,7,0,4,4,0.57,0,12,0.0,4,7135.0,16:59,0,0,0,0.0,0,8,3,2,1,0,2,2,768.0,1:49,0,0,0,99.0,0:14,575000
8476177,Matt,Read,1986-06-14,RW,R,2014-15,80,8,22,30,0.38,-4,142,5.63,14,84319.0,17:33,11,10,21,52.38,108,55,32,33,-1,2,3,5,7735.0,1:36,0,1,1,9641.0,2:0,3625000
8476179,Will,Acton,1987-07-16,C,L,2014-15,3,0,0,0,0.0,-2,2,0.0,5,1928.0,10:42,4,4,8,50.0,3,3,2,0,2,0,0,0,3.0,0:1,0,0,0,243.0,1:21,680000
8476191,Kevan,Miller,1987-11-15,D,R,2014-15,41,2,5,7,0.17,20,37,5.41,15,44362.0,18:2,0,0,0,0.0,87,60,7,15,-8,0,0,0,15.0,0:0,0,0,0,6899.0,2:48,800000
8476195,Cory,Conacher,1989-12-14,C,L,2014-15,15,1,2,3,0.2,-3,23,4.35,14,12132.0,13:28,1,2,3,33.33,19,7,6,3,3,0,0,0,689.0,0:45,0,0,0,11.0,0:0,600000
8476207,Brian,Gibbons,1988-02-26,LW,L,2014-15,25,0,5,5,0.2,2,21,0.0,8,20735.0,13:49,4,5,9,44.44,14,17,7,5,2,0,1,1,987.0,0:39,0,0,0,2751.0,1:50,750000
8476209,Mike,Sislo,1988-01-20,RW,R,2014-15,10,0,1,1,0.1,-2,13,0.0,2,7327.0,12:12,0,0,0,0.0,12,2,2,0,2,0,0,0,2.0,0:0,0,0,0,811.0,1:21,562500
8476214,Brandon,DeFazio,1988-09-13,LW,L,2014-15,2,0,0,0,0.0,0,2,0.0,0,713.0,5:56,0,0,0,0.0,0,0,1,0,1,0,0,0,0.0,0:0,0,0,0,0.0,0:0,600000
8476227,Joe,Whitney,1988-02-06,RW,L,2014-15,4,1,0,1,0.25,-1,1,100.0,0,1650.0,6:52,0,0,0,0.0,5,0,0,0,0,0,0,0,0.0,0:0,0,0,0,3.0,0:0,567500
8476235,Justin,Fontaine,1987-11-06,RW,R,2014-15,71,9,22,31,0.44,13,104,8.65,12,50930.0,11:57,1,1,2,50.0,9,27,22,13,9,0,2,2,1497.0,0:21,0,0,0,2570.0,0:36,1000000
8476244,Raphael,Diaz,1986-01-09,D,R,2014-15,56,2,2,4,0.07,-3,52,3.85,10,40397.0,12:1,0,0,0,0.0,24,67,12,17,-5,1,0,1,3287.0,0:58,0,0,0,18.0,0:0,700000
8476279,Jyrki,Jokipakka,1991-08-20,D,L,2014-15,51,0,10,10,0.2,-2,40,0.0,8,50523.0,16:30,0,0,0,0.0,42,66,16,37,-21,0,0,0,178.0,0:3,0,0,0,2985.0,0:58,666667
8476289,Alexey,Marchenko,1992-01-02,D,R,2014-15,13,1,1,2,0.15,1,7,14.29,2,12036.0,15:25,0,0,0,0.0,9,10,4,4,0,0,0,0,91.0,0:7,0,0,0,567.0,0:43,666667
8476292,Ondrej,Palat,1991-03-28,LW,L,2014-15,75,16,47,63,0.84,31,139,11.51,24,78441.0,17:25,10,25,35,28.57,124,50,43,43,0,3,8,11,10541.0,2:20,1,1,2,7984.0,1:46,3333333
8476300,Nikita,Nesterov,1993-03-28,D,L,2014-15,27,2,5,7,0.26,6,44,4.55,16,26008.0,16:3,0,0,0,0.0,42,17,16,14,2,1,1,2,872.0,0:32,0,0,0,306.0,0:11,742500
8476302,Frank,Corrado,1993-03-26,D,R,2014-15,10,1,0,1,0.1,-7,8,12.5,0,9401.0,15:40,0,0,0,0.0,15,12,1,5,-4,0,0,0,207.0,0:20,0,0,0,187.0,0:18,591667
8476312,Josh,Manson,1991-10-07,D,R,2014-15,28,0,3,3,0.11,1,26,0.0,31,30969.0,18:26,0,0,0,0.0,44,24,9,17,-8,0,0,0,87.0,0:3,0,0,0,2642.0,1:34,925000
8476336,Iiro,Pakarinen,1991-08-25,RW,R,2014-15,17,1,2,3,0.18,-4,34,2.94,2,10338.0,10:8,1,0,1,100.0,51,3,0,2,-2,0,2,2,896.0,0:52,0,0,0,32.0,0:1,817500
8476344,Tyler,Graovac,1993-04-27,C,L,2014-15,3,0,0,0,0.0,0,4,0.0,0,1660.0,9:13,6,16,22,27.27,0,2,2,0,2,0,0,0,0.0,0:0,0,0,0,0.0,0:0,747500
8476346,Johnny,Gaudreau,1993-08-13,LW,L,2014-15,80,24,40,64,0.8,11,167,14.37,14,85041.0,17:43,3,5,8,37.5,14,27,67,78,-11,8,13,21,13457.0,2:48,0,0,0,26.0,0:0,925000
8476356,Tobias,Rieder,1993-01-10,C,L,2014-15,72,13,8,21,0.29,-19,189,6.88,14,72994.0,16:53,1,4,5,20.0,123,37,40,11,29,0,2,2,6083.0,1:24,3,0,3,5487.0,1:16,853333
8476363,Brian,Ferlin,1992-06-03,RW,R,2014-15,7,0,1,1,0.14,0,6,0.0,0,3694.0,8:47,0,1,1,0.0,20,0,1,0,1,0,0,0,26.0,0:3,0,0,0,0.0,0:0,875000
8476381,Andrew,Shaw,1991-07-20,RW,R,2014-15,79,15,11,26,0.33,-8,146,10.27,67,70852.0,14:56,357,355,712,50.14,127,33,17,16,1,5,1,6,12958.0,2:44,0,0,0,428.0,0:5,2000000
8476386,Shane,Prince,1992-11-16,LW,L,2014-15,2,0,1,1,0.5,1,2,0.0,0,1257.0,10:28,0,0,0,0.0,2,0,0,0,0,0,0,0,0.0,0:0,0,0,0,0.0,0:0,876667
8476389,Vincent,Trocheck,1993-07-11,C,R,2014-15,50,7,15,22,0.44,9,89,7.87,24,42016.0,14:0,234,247,481,48.65,93,19,21,8,13,1,0,1,2718.0,0:54,0,0,0,300.0,0:6,661667
8476392,Adam,Lowry,1993-03-29,C,L,2014-15,80,11,12,23,0.29,1,104,10.58,46,66015.0,13:45,402,449,851,47.24,256,32,25,14,11,0,3,3,2715.0,0:33,1,0,1,3046.0,0:38,828333
8476393,Nick,Cousins,1993-07-20,C,L,2014-15,11,0,0,0,0.0,1,6,0.0,2,5819.0,8:49,23,29,52,44.23,13,5,5,2,3,0,0,0,115.0,0:10,0,0,0,0.0,0:0,842500
8476394,Michael,Paliotta,1993-04-06,D,R,2014-15,1,0,1,1,1.0,0,2,0.0,0,765.0,12:45,0,0,0,0.0,0,2,0,0,0,0,0,0,0.0,0:0,0,0,0,0.0,0:0,925000
8476403,Klas,Dahlbeck,1991-07-06,D,L,2014-15,23,1,3,4,0.17,-8,20,5.0,8,24370.0,17:39,0,0,0,0.0,64,46,9,4,5,0,0,0,6.0,0:0,0,0,0,3581.0,2:35,613333
8476404,Andy,Andreoff,1991-05-17,LW,L,2014-15,18,2,1,3,0.17,1,14,14.29,18,9254.0,8:34,32,29,61,52.46,33,0,7,4,3,0,0,0,112.0,0:6,0,0,0,10.0,0:0,550000
8476406,Nick,Shore,1992-09-26,C,R,2014-15,34,1,6,7,0.21,0,33,3.03,10,22617.0,11:5,127,109,236,53.81,51,14,8,2,6,0,1,1,628.0,0:18,0,0,0,820.0,0:24,925000
8476410,Josh,Leivo,1993-05-26,LW,R,2014-15,9,1,0,1,0.11,-1,10,10.0,4,4133.0,7:39,0,2,2,0.0,5,0,7,0,7,0,0,0,53.0,0:5,0,0,0,0.0,0:0,792500
8476419,Jean-Gabriel,Pageau,1992-11-11,C,R,2014-15,50,10,9,19,0.38,4,97,10.31,9,42562.0,14:11,335,346,681,49.19,158,20,19,13,6,0,0,0,529.0,0:10,2,0,2,5861.0,1:57,613333
8476423,Reid,Boucher,1993-09-08,C,L,2014-15,11,1,0,1,0.09,-4,20,5.0,0,7352.0,11:8,0,0,0,0.0,9,5,7,1,6,0,0,0,54.0,0:4,0,0,0,0.0,0:0,692500
8476426,David,Musil,1993-04-09,D,L,2014-15,4,0,2,2,0.5,-2,3,0.0,2,4753.0,19:48,0,0,0,0.0,5,8,1,2,-1,0,0,0,18.0,0:4,0,0,0,354.0,1:28,894167
8476427,Ty,Rattie,1993-02-05,RW,R,2014-15,11,0,2,2,0.18,0,8,0.0,2,6006.0,9:6,0,0,0,0.0,15,4,0,0,0,0,0,0,409.0,0:37,0,0,0,0.0,0:0,772500
8476428,Rocco,Grimaldi,1993-02-08,C,R,2014-15,7,1,0,1,0.14,1,18,5.56,4,5296.0,12:36,6,8,14,42.86,7,1,3,0,3,0,0,0,158.0,0:22,0,0,0,0.0,0:0,925000
8476430,Tomas,Jurco,1992-12-28,LW,L,2014-15,63,3,15,18,0.29,6,92,3.26,14,43508.0,11:30,0,2,2,0.0,97,11,19,16,3,1,1,2,4293.0,1:8,0,0,0,0.0,0:0,709167
8476431,Adam,Clendening,1992-10-26,D,R,2014-15,21,1,3,4,0.19,2,17,5.88,10,20963.0,16:38,0,0,0,0.0,9,22,2,14,-12,1,2,3,2607.0,2:4,0,0,0,44.0,0:2,742500
8476432,Boone,Jenner,1993-06-15,C,L,2014-15,31,9,8,17,0.55,-5,83,10.84,12,33982.0,18:16,151,155,306,49.35,102,25,18,17,1,2,3,5,4095.0,2:12,0,0,0,2411.0,1:17,778333
8476435,Alex,Khokhlachev,1993-09-09,C,L,2014-15,3,0,0,0,0.0,-2,1,0.0,0,1476.0,8:12,9,8,17,52.94,1,0,0,1,-1,0,0,0,170.0,0:56,0,0,0,0.0,0:0,786667
8476436,Dmitrij,Jaskin,1993-03-23,RW,L,2014-15,54,13,5,18,0.33,7,108,12.04,16,43636.0,13:28,3,4,7,42.86,146,21,16,11,5,3,0,3,3442.0,1:3,0,0,0,95.0,0:1,772500
8476437,Victor,Rask,1993-03-01,C,L,2014-15,80,11,22,33,0.41,-14,172,6.4,16,78416.0,16:20,468,450,918,50.98,42,36,46,34,12,2,9,11,11994.0,2:29,0,0,0,2117.0,0:26,680833
8476438,Brandon,Saad,1992-10-27,LW,L,2014-15,82,23,29,52,0.63,7,203,11.33,12,84886.0,17:15,38,50,88,43.18,53,29,46,29,17,2,8,10,10782.0,2:11,0,0,0,5319.0,1:4,764167
8476439,Brett,Ritchie,1993-07-01,RW,R,2014-15,31,6,3,9,0.29,-1,78,7.69,12,26014.0,13:59,1,3,4,25.0,89,5,9,10,-1,0,1,1,4269.0,2:17,0,0,0,5.0,0:0,814167
8476440,Markus,Granlund,1993-04-16,C,L,2014-15,48,8,10,18,0.38,-4,65,12.31,16,38504.0,13:22,193,331,524,36.83,44,24,27,16,11,1,1,2,1487.0,0:30,0,0,0,2515.0,0:52,767500
8476442,Matt,Nieto,1992-11-05,LW,L,2014-15,72,10,17,27,0.38,-12,135,7.41,20,65903.0,15:15,0,1,1,0.0,24,38,38,36,2,1,3,4,4134.0,0:57,0,1,1,4342.0,1:0,759167
8476443,Xavier,Ouellet,1993-07-29,D,L,2014-15,21,2,1,3,0.14,4,27,7.41,2,20652.0,16:23,0,0,0,0.0,11,13,2,8,-6,0,0,0,185.0,0:8,0,0,0,707.0,0:33,670000
8476447,Miikka,Salomaki,1993-03-09,RW,L,2014-15,1,1,0,1,1.0,1,4,25.0,0,649.0,10:49,0,0,0,0.0,7,1,0,0,0,0,0,0,0.0,0:0,0,0,0,55.0,0:55,780833
8476448,William,Karlsson,1993-01-08,C,L,2014-15,21,3,2,5,0.24,3,29,10.34,2,15412.0,12:13,93,104,197,47.21,18,7,8,9,-1,0,1,1,2423.0,1:55,0,0,0,28.0,0:1,830833
8476449,Scott,Harrington,1993-03-10,D,L,2014-15,10,0,0,0,0.0,-10,9,0.0,4,9480.0,15:48,0,0,0,0.0,12,10,1,1,0,0,0,0,258.0,0:25,0,0,0,738.0,1:13,589167
8476451,Lucas,Lessio,1993-01-23,LW,L,2014-15,26,2,3,5,0.19,-10,44,4.55,8,19899.0,12:45,0,2,2,0.0,59,6,7,7,0,0,0,0,431.0,0:16,0,0,0,0.0,0:0,830833
8476452,Tyler,Wotherspoon,1993-03-12,D,L,2014-15,1,0,0,0,0.0,-3,1,0.0,0,1219.0,20:19,0,0,0,0.0,0,2,0,0,0,0,0,0,0.0,0:0,0,0,0,276.0,4:36,925000
8476453,Nikita,Kucherov,1993-06-17,RW,L,2014-15,82,29,36,65,0.79,38,191,15.18,37,73559.0,14:57,0,2,2,0.0,65,28,22,47,-25,2,13,15,10861.0,2:12,0,0,0,132.0,0:1,711667
8476454,Ryan,Nugent-Hopkins,1993-04-12,C,L,2014-15,76,24,32,56,0.74,-12,189,12.7,25,94123.0,20:38,620,736,1356,45.72,92,37,54,43,11,2,12,14,12396.0,2:43,0,1,1,7485.0,1:38,6000000
8476455,Gabriel,Landeskog,1992-11-23,LW,L,2014-15,82,23,36,59,0.72,-2,214,10.75,79,91047.0,18:30,16,29,45,35.56,169,73,52,34,18,8,9,17,12247.0,2:29,0,0,0,2269.0,0:27,5571429
8476456,Jonathan,Huberdeau,1993-06-04,LW,L,2014-15,79,15,39,54,0.68,10,169,8.88,38,79385.0,16:44,2,6,8,25.0,68,24,34,23,11,0,12,12,11121.0,2:20,0,0,0,620.0,0:7,894167
8476457,Adam,Larsson,1992-11-12,D,R,2014-15,64,3,21,24,0.38,2,91,3.3,34,80497.0,20:57,0,0,0,0.0,92,120,21,30,-9,0,0,0,1224.0,0:19,0,3,3,12145.0,3:9,900000
8476458,Ryan,Strome,1993-07-11,C,R,2014-15,81,17,33,50,0.62,23,179,9.5,47,74834.0,15:23,149,170,319,46.71,92,21,38,52,-14,1,7,8,10326.0,2:7,1,0,1,2990.0,0:36,863333
8476459,Mika,Zibanejad,1993-04-18,C,R,2014-15,80,20,26,46,0.57,0,150,13.33,20,78899.0,16:26,615,646,1261,48.77,149,26,34,27,7,4,10,14,12903.0,2:41,0,0,0,1440.0,0:18,894167
8476460,Mark,Scheifele,1993-03-15,C,R,2014-15,82,15,34,49,0.6,11,170,8.82,24,91455.0,18:35,492,656,1148,42.86,100,61,54,45,9,3,10,13,11872.0,2:24,0,0,0,2480.0,0:30,863333
8476461,Sean,Couturier,1992-12-07,C,L,2014-15,82,15,22,37,0.45,4,148,10.14,28,90470.0,18:23,643,687,1330,48.35,72,35,40,30,10,1,5,6,7722.0,1:34,1,1,2,11409.0,2:19,1750000
8476462,Dougie,Hamilton,1993-06-17,D,R,2014-15,72,10,32,42,0.58,-3,188,5.32,41,92171.0,21:20,0,0,0,0.0,106,53,24,45,-21,5,10,15,10822.0,2:30,0,0,0,5026.0,1:9,925000
8476463,Jonas,Brodin,1993-07-12,D,L,2014-15,71,3,14,17,0.24,21,95,3.16,8,102978.0,24:10,0,0,0,0.0,31,128,33,33,0,0,2,2,4064.0,0:57,0,1,1,9584.0,2:14,925000
8476465,Ryan,Murphy,1993-03-31,D,R,2014-15,37,4,9,13,0.35,-11,61,6.56,8,40605.0,18:17,0,0,0,0.0,20,37,20,30,-10,3,2,5,4627.0,2:5,0,0,0,82.0,0:2,863333
8476466,Sven,Baertschi,1992-10-05,LW,L,2014-15,18,2,4,6,0.33,-3,15,13.33,10,10456.0,9:40,0,0,0,0.0,8,7,7,5,2,0,0,0,279.0,0:15,0,0,0,0.0,0:0,894167
8476467,Jamie,Oleksiak,1992-12-21,D,L,2014-15,36,1,7,8,0.22,0,36,2.78,8,28942.0,13:23,0,0,0,0.0,82,46,9,22,-13,0,0,0,127.0,0:3,0,0,0,2312.0,1:4,894167
8476468,J.T.,Miller,1993-03-14,C,L,2014-15,58,10,13,23,0.4,5,92,10.87,23,44195.0,12:41,93,112,205,45.37,89,28,27,23,4,2,1,3,3117.0,0:53,0,0,0,70.0,0:1,894167
8476470,Nathan,Beaulieu,1992-12-05,D,L,2014-15,64,1,8,9,0.14,6,62,1.61,45,60285.0,15:41,0,0,0,0.0,50,69,8,47,-39,0,2,2,2849.0,0:44,0,0,0,957.0,0:14,925000
8476472,Oscar,Klefbom,1993-07-20,D,L,2014-15,60,2,18,20,0.33,-21,98,2.04,4,79196.0,21:59,0,0,0,0.0,45,102,48,48,0,0,2,2,1651.0,0:27,0,0,0,6289.0,1:44,894167
8476473,Connor,Murphy,1993-03-26,D,R,2014-15,73,4,3,7,0.1,-27,72,5.56,42,73587.0,16:48,0,1,1,0.0,137,142,8,25,-17,0,0,0,227.0,0:3,0,0,0,7557.0,1:43,863333
8476476,Joe,Morrow,1992-12-09,D,L,2014-15,15,1,0,1,0.07,3,20,5.0,4,15021.0,16:41,0,0,0,0.0,18,22,2,3,-1,0,0,0,330.0,0:22,0,0,0,431.0,0:28,863333
8476477,Matt,Puempel,1993-01-24,LW,L,2014-15,13,2,1,3,0.23,6,14,14.29,8,6265.0,8:1,0,1,1,0.0,9,1,3,0,3,0,0,0,0.0,0:0,0,0,0,31.0,0:2,863333
8476478,Stuart,Percy,1993-05-18,D,L,2014-15,9,0,3,3,0.33,-4,13,0.0,2,9762.0,18:4,0,0,0,0.0,14,13,7,12,-5,0,2,2,789.0,1:27,0,0,0,941.0,1:44,863333
8476479,Phillip,Danault,1993-02-24,C,L,2014-15,2,0,0,0,0.0,0,2,0.0,0,1140.0,9:30,6,14,20,30.0,3,0,0,0,0,0,0,0,142.0,1:11,0,0,0,0.0,0:0,863333
8476480,Vladislav,Namestnikov,1992-11-22,C,L,2014-15,43,9,7,16,0.37,1,46,19.57,13,30948.0,11:59,70,85,155,45.16,41,13,16,9,7,1,1,2,2001.0,0:46,0,0,0,1175.0,0:27,925000
8476482,Nicklas,Jensen,1993-03-06,RW,L,2014-15,5,0,0,0,0.0,-1,7,0.0,0,2867.0,9:33,0,0,0,0.0,7,4,0,1,-1,0,0,0,36.0,0:7,0,0,0,0.0,0:0,863333
8476483,Rickard,Rakell,1993-05-05,C,R,2014-15,71,9,22,31,0.44,6,105,8.57,10,53557.0,12:34,310,355,665,46.62,79,22,18,33,-15,2,7,9,5536.0,1:17,0,0,0,36.0,0:0,894167
8476495,Seth,Griffith,1993-01-04,C,R,2014-15,30,6,4,10,0.33,-2,33,18.18,6,24198.0,13:26,3,6,9,33.33,14,13,12,6,6,1,2,3,3168.0,1:45,0,0,0,28.0,0:0,759167
8476536,Colin,Smith,1993-06-20,C,R,2014-15,1,0,0,0,0.0,0,1,0.0,0,366.0,6:6,4,6,10,40.0,1,0,0,1,-1,0,0,0,0.0,0:0,0,0,0,0.0,0:0,628333
8476539,Jonathan,Marchessault,1990-12-27,C,R,2014-15,2,1,0,1,0.5,1,3,33.33,0,1433.0,11:56,1,2,3,33.33,4,0,1,0,1,0,0,0,93.0,0:46,0,0,0,0.0,0:0,925000
8476549,Daniil,Tarasov,1991-06-20,RW,L,2014-15,5,0,1,1,0.2,2,5,0.0,0,2271.0,7:34,1,0,1,100.0,2,1,1,0,1,0,0,0,114.0,0:22,0,0,0,0.0,0:0,680000
8476624,Barclay,Goodrow,1993-02-26,RW,L,2014-15,60,4,8,12,0.2,-1,68,5.88,35,39858.0,11:4,12,11,23,52.17,76,24,27,24,3,0,0,0,976.0,0:16,0,1,1,1627.0,0:27,626667
8476769,Bobby,Farnham,1989-01-21,RW,L,2014-15,11,0,0,0,0.0,0,6,0.0,24,4736.0,7:10,0,0,0,0.0,26,2,0,1,-1,0,0,0,92.0,0:8,0,0,0,0.0,0:0,550000
8476779,Brad,Hunt,1988-08-24,D,L,2014-15,11,1,2,3,0.27,-6,20,5.0,0,12860.0,19:29,0,0,0,0.0,8,10,6,6,0,1,0,1,1664.0,2:31,0,0,0,482.0,0:43,550000
8476792,Torey,Krug,1991-04-12,D,L,2014-15,78,12,27,39,0.5,13,205,5.85,20,91700.0,19:35,0,0,0,0.0,75,68,15,31,-16,2,12,14,12254.0,2:37,0,0,0,919.0,0:11,1400000
8476798,Karl,Stollery,1987-11-21,D,L,2014-15,10,0,0,0,0.0,-1,9,0.0,6,8837.0,14:43,0,0,0,0.0,23,21,1,7,-6,0,0,0,40.0,0:4,0,0,0,651.0,1:5,605000
8476799,Cameron,Schilling,1988-10-07,D,L,2014-15,4,0,0,0,0.0,1,2,0.0,4,2730.0,11:22,0,0,0,0.0,4,2,0,0,0,0,0,0,0.0,0:0,0,0,0,5.0,0:1,625000
8476806,J.T.,Brown,1990-07-02,RW,R,2014-15,52,3,6,9,0.17,-2,74,4.05,30,33093.0,10:36,6,7,13,46.15,43,20,7,18,-11,0,0,0,153.0,0:2,0,0,0,3345.0,1:4,950000
8476807,Matt,Tennyson,1990-04-23,D,R,2014-15,27,2,6,8,0.3,0,37,5.41,16,28459.0,17:34,0,0,0,0.0,48,34,11,18,-7,1,1,2,2926.0,1:48,0,1,1,743.0,0:27,625000
8476808,Brian,Flynn,1988-07-26,C,R,2014-15,63,5,12,17,0.27,-5,82,6.1,8,56368.0,14:54,172,187,359,47.91,44,46,12,17,-5,0,1,1,2967.0,0:47,0,2,2,7053.0,1:51,637500
8476822,Luke,Glendening,1989-04-28,RW,R,2014-15,82,12,6,18,0.22,5,104,11.54,34,72424.0,14:43,499,463,962,51.87,147,73,26,14,12,1,0,1,713.0,0:8,0,0,0,16607.0,3:22,628333
8476850,Ryan,Murray,1993-09-27,D,L,2014-15,12,1,2,3,0.25,1,8,12.5,8,13614.0,18:54,0,0,0,0.0,5,11,5,2,3,1,0,1,553.0,0:46,0,0,0,1245.0,1:43,894167
8476851,Alex,Galchenyuk,1994-02-12,LW,L,2014-15,80,20,26,46,0.57,8,163,12.27,39,78858.0,16:25,82,92,174,47.13,91,44,24,28,-4,3,9,12,10677.0,2:13,0,0,0,298.0,0:3,925000
8476852,Griffin,Reinhart,1994-01-24,D,L,2014-15,8,0,1,1,0.12,1,4,0.0,6,6803.0,14:10,0,0,0,0.0,14,8,0,2,-2,0,0,0,14.0,0:1,0,0,0,259.0,0:32,863333
8476853,Morgan,Rielly,1994-03-09,D,L,2014-15,81,8,21,29,0.36,-16,148,5.41,14,98841.0,20:20,0,0,0,0.0,98,103,41,63,-22,1,8,9,11888.0,2:26,0,0,0,3637.0,0:44,894167
8476854,Hampus,Lindholm,1994-01-20,D,L,2014-15,78,7,27,34,0.44,25,107,6.54,32,101838.0,21:45,0,5,5,0.0,59,77,29,68,-39,0,6,6,7587.0,1:37,0,0,0,9160.0,1:57,894167
8476855,Nail,Yakupov,1993-10-06,RW,L,2014-15,81,14,19,33,0.41,-35,191,7.33,18,75053.0,15:26,0,1,1,0.0,97,28,34,55,-21,5,5,10,9211.0,1:53,0,0,0,6.0,0:0,925000
8476856,Matt,Dumba,1994-07-25,D,R,2014-15,58,8,8,16,0.28,13,86,9.3,23,52236.0,15:0,0,0,0,0.0,42,51,9,28,-19,2,4,6,5475.0,1:34,0,0,0,1189.0,0:20,894167
8476868,Henrik,Samuelsson,1994-02-07,C,R,2014-15,3,0,0,0,0.0,-2,4,0.0,2,2388.0,13:16,2,0,2,100.0,5,0,1,0,1,0,0,0,373.0,2:4,0,0,0,0.0,0:0,894167
8476870,Stefan,Matteau,1994-02-23,C,L,2014-15,7,1,0,1,0.14,0,8,12.5,4,4986.0,11:52,0,0,0,0.0,17,1,2,3,-1,0,0,0,0.0,0:0,0,0,0,8.0,0:1,842500
8476871,Tanner,Pearson,1992-08-10,LW,L,2014-15,42,12,4,16,0.38,14,68,17.65,14,33496.0,13:17,5,3,8,62.5,46,9,18,14,4,1,0,1,3817.0,1:30,0,0,0,1145.0,0:27,735833
8476872,Scott,Laughton,1994-05-30,C,L,2014-15,31,2,4,6,0.19,-1,51,3.92,17,23658.0,12:43,134,149,283,47.35,58,11,11,12,-1,0,1,1,649.0,0:20,0,0,0,1786.0,0:57,863333
8476874,Olli,Maatta,1994-08-22,D,L,2014-15,20,1,8,9,0.45,1,27,3.7,10,24850.0,20:42,0,0,0,0.0,18,33,3,11,-8,0,2,2,1577.0,1:18,0,0,0,2852.0,2:22,894167
8476878,Zemgus,Girgensons,1994-01-05,C,L,2014-15,61,15,15,30,0.49,-16,115,13.04,25,69831.0,19:4,440,560,1000,44.0,127,62,19,12,7,1,3,4,7550.0,2:3,3,0,3,7570.0,2:4,894167
8476879,Cody,Ceci,1993-12-21,D,R,2014-15,81,5,16,21,0.26,-4,130,3.85,6,93749.0,19:17,0,0,0,0.0,89,113,14,41,-27,1,3,4,4913.0,1:0,0,0,0,11421.0,2:21,894167
8476880,Tom,Wilson,1994-03-29,RW,R,2014-15,67,4,13,17,0.25,-1,79,5.06,172,43966.0,10:56,2,9,11,18.18,205,24,20,10,10,0,0,0,202.0,0:3,0,0,0,46.0,0:0,894167
8476881,Tomas,Hertl,1993-11-12,C,L,2014-15,82,13,18,31,0.38,-5,145,8.97,16,71598.0,14:33,38,45,83,45.78,106,33,29,64,-35,3,3,6,7279.0,1:28,0,0,0,61.0,0:0,925000
8476882,Teuvo,Teravainen,1994-09-11,LW,L,2014-15,34,4,5,9,0.26,4,66,6.06,2,26080.0,12:47,29,33,62,46.77,11,14,11,15,-4,0,1,1,1542.0,0:45,0,0,0,50.0,0:1,894167
8476884,Derrick,Pouliot,1994-01-16,D,L,2014-15,34,2,5,7,0.21,-11,56,3.57,4,35795.0,17:32,0,0,0,0.0,15,20,11,18,-7,1,3,4,5080.0,2:29,0,0,0,158.0,0:4,863333
8476885,Jacob,Trouba,1994-02-26,D,R,2014-15,65,7,15,22,0.34,2,133,5.26,46,90934.0,23:18,0,1,1,0.0,97,120,28,76,-48,1,5,6,7575.0,1:56,0,0,0,13081.0,3:21,894167
8476886,Slater,Koekkoek,1994-02-18,D,L,2014-15,3,0,0,0,0.0,0,6,0.0,2,2985.0,16:35,0,0,0,0.0,2,3,1,0,1,0,0,0,2.0,0:0,0,0,0,137.0,0:45,894167
8476887,Filip,Forsberg,1994-08-13,LW,R,2014-15,82,26,37,63,0.77,15,237,10.97,24,85268.0,17:19,3,4,7,42.86,108,28,50,57,-7,6,13,19,13935.0,2:49,0,0,0,115.0,0:1,894167
8476888,Mikhail,Grigorenko,1994-05-16,C,L,2014-15,25,3,3,6,0.24,-10,35,8.57,2,22754.0,15:10,153,178,331,46.22,28,15,2,7,-5,1,1,2,1616.0,1:4,0,0,0,80.0,0:3,925000
8476906,Shayne,Gostisbehere,1993-04-20,D,L,2014-15,2,0,0,0,0.0,-2,2,0.0,0,1507.0,12:33,0,0,0,0.0,0,1,1,3,-2,0,0,0,260.0,2:10,0,0,0,0.0,0:0,925000
8476919,Chris,Tierney,1994-07-01,C,L,2014-15,43,6,15,21,0.49,3,48,12.5,6,31599.0,12:14,150,192,342,43.86,11,17,19,20,-1,1,3,4,1991.0,0:46,0,0,0,367.0,0:8,711667
8476921,Jordan,Martinook,1992-07-25,LW,L,2014-15,8,0,1,1,0.12,-3,8,0.0,0,5615.0,11:41,1,0,1,100.0,14,2,2,0,2,0,0,0,22.0,0:2,0,0,0,352.0,0:44,658250
8476923,Damon,Severson,1994-08-07,D,R,2014-15,51,5,12,17,0.33,-13,93,5.38,22,67207.0,21:57,0,1,1,0.0,19,34,14,38,-24,0,7,7,6383.0,2:5,0,0,0,3201.0,1:2,605833
8476931,Jake,McCabe,1993-10-12,D,L,2014-15,2,0,0,0,0.0,0,2,0.0,0,1335.0,11:7,0,0,0,0.0,4,1,0,0,0,0,0,0,62.0,0:31,0,0,0,38.0,0:19,925000
8476944,Brendan,Woods,1992-06-11,LW,L,2014-15,2,0,0,0,0.0,-1,3,0.0,0,724.0,6:2,0,0,0,0.0,2,0,0,0,0,0,0,0,0.0,0:0,0,0,0,0.0,0:0,725000
8476975,Cedric,Paquette,1993-08-13,C,L,2014-15,64,12,7,19,0.3,4,91,13.19,51,52265.0,13:36,112,123,235,47.66,127,58,24,23,1,0,0,0,176.0,0:2,2,0,2,7934.0,2:3,633333
8476981,Josh,Anderson,1994-05-07,RW,R,2014-15,6,0,1,1,0.17,-1,10,0.0,2,4842.0,13:27,0,0,0,0.0,24,2,3,3,0,0,0,0,8.0,0:1,0,0,0,0.0,0:0,678333
8476989,Petteri,Lindbohm,1993-09-23,D,L,2014-15,23,2,1,3,0.13,-1,32,6.25,26,21488.0,15:34,0,0,0,0.0,26,22,6,3,3,0,0,0,17.0,0:0,0,0,0,542.0,0:23,636667
8477070,Liam,O'Brien,1994-07-29,C,L,2014-15,13,1,1,2,0.15,4,16,6.25,23,5884.0,7:32,1,1,2,50.0,35,0,3,1,2,0,0,0,1.0,0:0,0,0,0,0.0,0:0,621667
8477126,Jayson,Megna,1990-02-01,C,R,2014-15,12,0,1,1,0.08,-2,13,0.0,14,7945.0,11:2,0,0,0,0.0,40,8,3,4,-1,0,0,0,49.0,0:4,0,0,0,332.0,0:27,874125
8477205,Andrej,Sustr,1990-11-29,D,R,2014-15,72,0,13,13,0.18,10,55,0.0,34,76474.0,17:42,0,0,0,0.0,39,84,17,28,-11,0,1,1,374.0,0:5,0,0,0,6381.0,1:28,874125
8477213,Tim,Schaller,1990-11-16,C,L,2014-15,18,1,1,2,0.11,-5,19,5.26,2,12255.0,11:20,74,112,186,39.78,44,14,3,3,0,0,0,0,62.0,0:3,0,0,0,1108.0,1:1,925000
8477214,Conor,Allen,1990-01-31,D,L,2014-15,4,0,0,0,0.0,-1,2,0.0,4,2928.0,12:12,0,0,0,0.0,6,0,0,3,-3,0,0,0,28.0,0:7,0,0,0,0.0,0:0,925000
8477215,Danny,DeKeyser,1990-03-07,D,L,2014-15,80,2,29,31,0.39,11,89,2.25,42,100451.0,20:55,0,0,0,0.0,74,88,14,38,-24,0,6,6,6350.0,1:19,0,0,0,11122.0,2:19,2187500
8477220,Nate,Schmidt,1991-07-16,D,L,2014-15,39,1,3,4,0.1,-2,40,2.5,10,32494.0,13:53,0,0,0,0.0,34,33,11,13,-2,0,0,0,20.0,0:0,0,0,0,377.0,0:9,625000
8477227,Eriah,Hayes,1988-07-07,RW,R,2014-15,4,0,0,0,0.0,-2,10,0.0,2,2393.0,9:58,1,0,1,100.0,7,4,1,1,0,0,0,0,21.0,0:5,0,0,0,0.0,0:0,655000
8477228,Matt,Lindblad,1990-03-23,C,L,2014-15,2,0,0,0,0.0,0,3,0.0,0,931.0,7:45,0,5,5,0.0,2,0,0,0,0,0,0,0,0.0,0:0,0,0,0,118.0,0:59,833750
8477244,Chad,Ruhwedel,1990-05-07,D,R,2014-15,4,0,1,1,0.25,3,4,0.0,0,2991.0,12:27,0,0,0,0.0,6,2,0,0,0,0,0,0,43.0,0:10,0,0,0,0.0,0:0,650000
8477249,Andrew,Miller,1988-09-18,C,R,2014-15,9,1,5,6,0.67,-2,14,7.14,0,7425.0,13:45,1,1,2,50.0,7,6,3,6,-3,0,0,0,0.0,0:0,0,0,0,8.0,0:0,675000
8477290,Michael,Raffl,1988-12-01,LW,L,2014-15,67,21,7,28,0.42,6,134,15.67,34,57067.0,14:11,44,53,97,45.36,172,46,21,18,3,2,0,2,1715.0,0:25,1,0,1,3764.0,0:56,1100000
8477407,Anthony,Duclair,1995-08-26,LW,L,2014-15,18,1,6,7,0.39,4,18,5.56,4,13129.0,12:9,0,0,0,0.0,6,5,5,6,-1,0,1,1,1524.0,1:24,0,0,0,0.0,0:0,772500
8477410,Bogdan,Yakimov,1994-10-04,C,L,2014-15,1,0,0,0,0.0,-1,1,0.0,0,679.0,11:19,3,4,7,42.86,2,0,0,0,0,0,0,0,0.0,0:0,0,0,0,0.0,0:0,842500
8477413,Sven,Andrighetto,1993-03-21,RW,L,2014-15,12,2,1,3,0.25,0,12,16.67,0,6778.0,9:24,3,12,15,20.0,5,4,1,2,-1,0,0,0,1113.0,1:32,0,0,0,0.0,0:0,633333
8477429,Andrew,Copp,1994-07-08,C,L,2014-15,1,0,1,1,1.0,2,4,0.0,0,796.0,13:16,6,3,9,66.67,0,0,0,0,0,0,0,0,34.0,0:34,0,0,0,21.0,0:21,925000
8477444,Andre,Burakovsky,1995-02-09,LW,L,2014-15,53,9,13,22,0.42,12,65,13.85,10,41088.0,12:55,74,93,167,44.31,22,18,18,17,1,2,1,3,3697.0,1:9,0,0,0,5.0,0:0,894167
8477448,Marko,Dano,1994-11-30,C,L,2014-15,35,8,13,21,0.6,12,84,9.52,14,27840.0,13:15,16,21,37,43.24,94,12,18,7,11,0,0,0,450.0,0:12,0,0,0,113.0,0:3,925000
8477451,Ryan,Hartman,1994-09-20,RW,R,2014-15,5,0,0,0,0.0,-1,8,0.0,2,2486.0,8:17,0,0,0,0.0,11,2,0,0,0,0,0,0,11.0,0:2,0,0,0,0.0,0:0,894167
8477455,Jacob,de la Rose,1995-05-20,LW,L,2014-15,33,4,2,6,0.18,-5,38,10.53,12,27321.0,13:47,64,96,160,40.0,71,24,6,13,-7,0,0,0,364.0,0:11,1,0,1,2297.0,1:9,925000
8477486,Emile,Poirier,1994-12-14,LW,L,2014-15,6,0,1,1,0.17,1,2,0.0,0,2874.0,7:59,0,1,1,0.0,7,1,3,0,3,0,0,0,72.0,0:12,0,0,0,0.0,0:0,894167
8477492,Nathan,MacKinnon,1995-09-01,C,R,2014-15,64,14,24,38,0.59,-7,192,7.29,34,65464.0,17:2,201,227,428,46.96,43,41,45,38,7,3,4,7,9345.0,2:26,0,0,0,190.0,0:2,925000
8477493,Aleksander,Barkov,1995-09-02,C,L,2014-15,71,16,20,36,0.51,-4,123,13.01,16,74545.0,17:29,462,540,1002,46.11,35,35,42,27,15,3,4,7,9655.0,2:15,0,0,0,1948.0,0:27,925000
8477494,Jonathan,Drouin,1995-03-28,LW,L,2014-15,70,4,28,32,0.46,3,76,5.26,34,55593.0,13:14,11,10,21,52.38,55,16,36,25,11,3,3,6,8024.0,1:54,0,0,0,255.0,0:3,894167
8477495,Seth,Jones,1994-10-03,D,R,2014-15,82,8,19,27,0.33,3,123,6.5,20,97824.0,19:52,0,0,0,0.0,72,90,41,46,-5,2,9,11,10748.0,2:11,1,0,1,8229.0,1:40,925000
8477496,Elias,Lindholm,1994-12-02,C,R,2014-15,81,17,22,39,0.48,-23,170,10.0,14,79818.0,16:25,115,105,220,52.27,106,30,36,42,-6,4,11,15,12196.0,2:30,0,0,0,195.0,0:2,925000
8477497,Sean,Monahan,1994-10-12,C,L,2014-15,81,31,31,62,0.77,8,191,16.23,12,95360.0,19:37,902,928,1830,49.29,39,42,81,52,29,10,9,19,13772.0,2:50,1,1,2,4072.0,0:50,925000
8477498,Darnell,Nurse,1995-02-04,D,L,2014-15,2,0,0,0,0.0,-2,2,0.0,0,2039.0,16:59,0,0,0,0.0,5,0,0,0,0,0,0,0,25.0,0:12,0,0,0,46.0,0:23,894167
8477499,Rasmus,Ristolainen,1994-10-27,D,R,2014-15,78,8,12,20,0.26,-32,121,6.61,26,96474.0,20:36,1,0,1,100.0,118,136,9,35,-26,4,5,9,9368.0,2:0,0,0,0,6129.0,1:18,925000
8477500,Bo,Horvat,1995-04-05,C,L,2014-15,68,13,12,25,0.37,-8,93,13.98,16,50036.0,12:15,436,412,848,51.42,70,47,13,10,3,0,0,0,1059.0,0:15,1,0,1,2899.0,0:42,894167
8477501,Valeri,Nichushkin,1995-03-04,RW,L,2014-15,8,0,1,1,0.12,-5,6,0.0,2,6611.0,13:46,0,0,0,0.0,7,1,5,6,-1,0,0,0,300.0,0:37,0,0,0,3.0,0:0,925000
8477505,Alexander,Wennberg,1994-09-22,C,L,2014-15,68,4,16,20,0.29,-19,85,4.71,22,63748.0,15:37,288,386,674,42.73,58,45,25,11,14,1,3,4,5892.0,1:26,0,0,0,7335.0,1:47,925000
8477507,Nikita,Zadorov,1995-04-16,D,L,2014-15,60,3,12,15,0.25,-10,52,5.77,51,63747.0,17:42,1,0,1,100.0,134,73,11,39,-28,2,3,5,5042.0,1:24,0,0,0,1435.0,0:23,894167
8477508,Curtis,Lazar,1995-02-02,C,R,2014-15,67,6,9,15,0.22,1,92,6.52,14,51845.0,12:53,129,144,273,47.25,167,40,24,13,11,0,0,0,539.0,0:8,0,0,0,2008.0,0:29,894167
8477509,Mirco,Mueller,1995-03-21,D,L,2014-15,39,1,3,4,0.1,-8,31,3.23,10,39689.0,16:57,0,0,0,0.0,49,58,19,21,-2,0,0,0,734.0,0:18,0,0,0,1859.0,0:47,894167
8477510,Kerby,Rychel,1994-10-07,LW,L,2014-15,5,0,3,3,0.6,3,4,0.0,2,3208.0,10:41,0,0,0,0.0,11,3,2,1,1,0,0,0,29.0,0:5,0,0,0,0.0,0:0,894167
8477589,Ronalds,Kenins,1991-02-28,LW,L,2014-15,30,4,8,12,0.4,-2,38,10.53,8,22083.0,12:16,0,0,0,0.0,71,7,13,9,4,0,0,0,171.0,0:5,0,0,0,12.0,0:0,680000
8477591,Josh,Jooris,1990-07-14,RW,R,2014-15,60,12,12,24,0.4,1,89,13.48,16,52170.0,14:29,276,291,567,48.68,59,29,39,29,10,4,1,5,2430.0,0:40,0,0,0,4038.0,1:7,925000
8477715,Tyler,Gaudet,1993-04-04,C,L,2014-15,2,0,0,0,0.0,-1,1,0.0,0,1149.0,9:34,9,8,17,52.94,2,1,1,0,1,0,0,0,0.0,0:0,0,0,0,22.0,0:11,925000
8477845,Trevor,van Riemsdyk,1991-07-24,D,R,2014-15,18,0,1,1,0.06,0,21,0.0,2,14619.0,13:32,0,0,0,0.0,4,15,9,4,5,0,0,0,176.0,0:9,0,0,0,182.0,0:10,925000
8477850,Christian,Folin,1991-02-09,D,R,2014-15,40,2,8,10,0.25,3,39,5.13,13,36480.0,15:12,0,0,0,0.0,46,42,9,16,-7,0,1,1,319.0,0:7,0,0,0,1349.0,0:33,925000
8477851,Jordan,Oesterle,1992-06-25,D,L,2014-15,6,0,1,1,0.17,-4,7,0.0,0,5290.0,14:41,0,0,0,0.0,2,3,2,1,1,0,0,0,321.0,0:53,0,0,0,54.0,0:9,767500
8477887,Patrick,Brown,1992-05-29,C,R,2014-15,7,0,0,0,0.0,-4,4,0.0,4,3730.0,8:52,0,2,2,0.0,11,2,1,0,1,0,0,0,24.0,0:3,0,0,0,111.0,0:15,652500
8477902,Dennis,Everberg,1991-12-31,RW,L,2014-15,55,3,9,12,0.22,-7,62,4.84,10,38943.0,11:48,0,3,3,0.0,73,41,20,11,9,0,0,0,779.0,0:14,0,0,0,1878.0,0:34,612500
8477913,David,Wolf,1989-09-15,LW,L,2014-15,3,0,0,0,0.0,0,1,0.0,2,1689.0,9:23,1,1,2,50.0,6,0,1,0,1,0,0,0,0.0,0:0,0,0,0,0.0,0:0,867500
8477916,Borna,Rendulic,1992-03-25,RW,R,2014-15,11,1,1,2,0.18,1,6,16.67,6,6205.0,9:24,0,0,0,0.0,22,3,5,1,4,0,0,0,163.0,0:14,0,0,0,0.0,0:0,622500
8477922,Melker,Karlsson,1990-07-18,C,R,2014-15,53,13,11,24,0.45,-3,100,13.0,20,49083.0,15:26,13,20,33,39.39,51,26,21,22,-1,1,0,1,3297.0,1:2,0,0,0,595.0,0:11,825000
8477930,Pierre-Edouard,Bellemare,1985-03-06,LW,L,2014-15,81,6,6,12,0.15,-3,113,5.31,18,62363.0,12:49,360,401,761,47.31,121,61,32,19,13,0,0,0,437.0,0:5,0,0,0,10034.0,2:3,600000
8477932,Aaron,Ekblad,1996-02-07,D,R,2014-15,81,12,27,39,0.48,12,170,7.06,32,105997.0,21:48,0,0,0,0.0,109,80,26,41,-15,6,7,13,13644.0,2:48,0,0,0,2072.0,0:25,925000
8477933,Sam,Reinhart,1995-11-06,C,R,2014-15,9,0,1,1,0.11,-1,3,0.0,2,5596.0,10:21,21,65,86,24.42,3,5,2,1,1,0,0,0,66.0,0:7,0,0,0,0.0,0:0,925000
8477934,Leon,Draisaitl,1995-10-27,C,L,2014-15,37,2,7,9,0.24,-17,49,4.08,4,28184.0,12:41,128,187,315,40.63,21,8,14,16,-2,1,1,2,4081.0,1:50,0,0,0,32.0,0:0,925000
8477935,Sam,Bennett,1996-06-20,C,L,2014-15,1,0,1,1,1.0,-1,1,0.0,0,960.0,16:0,1,5,6,16.67,0,0,1,0,1,0,0,0,54.0,0:54,0,0,0,0.0,0:0,925000
8477942,Kevin,Fiala,1996-07-22,LW,L,2014-15,1,0,0,0,0.0,-1,3,0.0,0,685.0,11:25,0,0,0,0.0,0,1,2,0,2,0,0,0,0.0,0:0,0,0,0,0.0,0:0,925000
8477956,David,Pastrnak,1996-05-25,RW,R,2014-15,46,10,17,27,0.59,12,93,10.75,8,38566.0,13:58,5,12,17,29.41,20,11,25,30,-5,2,1,3,4660.0,1:41,0,0,0,118.0,0:2,925000
8478042,Viktor,Arvidsson,1993-04-08,LW,R,2014-15,6,0,0,0,0.0,0,9,0.0,0,3692.0,10:15,0,0,0,0.0,3,5,3,3,0,0,0,0,0.0,0:0,0,0,0,0.0,0:0,631667
8478137,Jiri,Sekac,1992-06-10,LW,L,2014-15,69,9,14,23,0.33,0,85,10.59,22,56187.0,13:34,0,2,2,0.0,75,29,26,27,-1,2,1,3,2714.0,0:39,0,0,0,1043.0,0:15,925000
8478376,Casey,Bailey,1991-10-27,RW,R,2014-15,6,1,0,1,0.17,1,9,11.11,2,3253.0,9:2,0,0,0,0.0,3,4,1,1,0,0,0,0,46.0,0:7,0,0,0,0.0,0:0,912500
8478393,Kyle,Baun,1992-05-04,RW,R,2014-15,3,0,0,0,0.0,-1,4,0.0,0,2257.0,12:32,0,0,0,0.0,12,0,1,0,1,0,0,0,0.0,0:0,0,0,0,0.0,0:0,858750
8448208,Jaromir,Jagr,1972-02-15,RW,L,2015-16,79,27,39,66,0.84,23,143,18.88,48,80936.0,17:4,0,1,1,0.0,31,16,33,44,-11,5,6,11,12867.0,2:42,0,0,0,78.0,0:0,3500000
8460542,Patrik,Elias,1976-04-13,C,L,2015-16,16,2,6,8,0.5,5,21,9.52,10,14819.0,15:26,9,19,28,32.14,10,1,5,9,-4,0,2,2,3333.0,3:28,0,0,0,750.0,0:46,5500000
8460720,Eric,Boulton,1976-08-17,LW,L,2015-16,6,0,0,0,0.0,-3,3,0.0,2,3415.0,9:29,0,0,0,0.0,15,0,1,2,-1,0,0,0,172.0,0:28,0,0,0,120.0,0:20,575000
8462038,Shane,Doan,1976-10-10,RW,R,2015-16,72,28,19,47,0.65,4,170,16.47,98,76011.0,17:35,74,69,143,51.75,116,15,33,27,6,12,5,17,13191.0,3:3,0,0,0,3073.0,0:42,5300000
8462042,Jarome,Iginla,1977-07-01,RW,R,2015-16,82,22,25,47,0.57,-22,182,12.09,41,78039.0,15:51,61,54,115,53.04,70,45,22,22,0,13,6,19,14414.0,2:55,0,0,0,201.0,0:2,5333333
8464977,Dainius,Zubrus,1978-06-16,C,L,2015-16,50,3,4,7,0.14,4,33,9.09,20,34769.0,11:35,15,12,27,55.56,68,15,15,15,0,0,0,0,163.0,0:3,0,0,0,2970.0,0:59,3100000
8464989,Matt,Cullen,1976-11-02,C,L,2015-16,82,16,16,32,0.39,5,118,13.56,20,68291.0,13:52,582,462,1044,55.75,40,41,19,20,-1,0,0,0,1241.0,0:15,3,3,6,12477.0,2:32,800000
8465009,Zdeno,Chara,1977-03-18,D,L,2015-16,80,9,28,37,0.46,12,158,5.7,71,115665.0,24:5,0,1,1,0.0,134,123,23,87,-64,1,9,10,7493.0,1:33,0,2,2,15971.0,3:19,6916667
8465058,Michal,Rozsival,1978-09-03,D,R,2015-16,51,1,12,13,0.25,3,41,2.44,33,49451.0,16:9,0,0,0,0.0,81,63,6,24,-18,0,2,2,1430.0,0:28,0,1,1,1854.0,0:36,600000
8465185,Willie,Mitchell,1977-04-23,D,L,2015-16,46,1,6,7,0.15,-2,33,3.03,18,54994.0,19:55,0,0,0,0.0,68,70,6,18,-12,0,0,0,354.0,0:7,0,0,0,8932.0,3:14,4250000
8465978,Shawn,Thornton,1977-07-23,LW,R,2015-16,50,1,4,5,0.1,-2,58,1.72,80,26067.0,8:41,6,7,13,46.15,73,2,9,4,5,0,0,0,328.0,0:6,0,0,0,0.0,0:0,1200000
8466138,Joe,Thornton,1979-07-02,C,L,2015-16,82,19,63,82,1.0,25,121,15.7,54,90343.0,18:21,399,354,753,52.99,48,30,69,98,-29,8,21,29,17917.0,3:38,0,0,0,227.0,0:2,6750000
8466139,Patrick,Marleau,1979-09-15,C,L,2015-16,82,25,23,48,0.59,-22,216,11.57,10,93620.0,19:1,267,258,525,50.86,64,36,46,71,-25,11,14,25,17314.0,3:31,1,0,1,6274.0,1:16,6666667
8466148,Marian,Hossa,1979-01-12,RW,L,2015-16,64,13,20,33,0.52,10,191,6.81,24,66284.0,17:15,0,2,2,0.0,37,33,44,25,19,2,7,9,7518.0,1:57,3,1,4,5990.0,1:33,5275000
8466251,Jason,Chimera,1979-05-02,LW,L,2015-16,82,20,20,40,0.49,0,165,12.12,22,69129.0,14:3,8,20,28,28.57,103,13,15,32,-17,4,5,9,7116.0,1:26,2,0,2,4840.0,0:59,2000000
8466285,Brian,Campbell,1979-05-23,D,L,2015-16,82,6,25,31,0.38,31,99,6.06,26,109607.0,22:16,0,0,0,0.0,27,80,23,54,-31,0,8,8,13211.0,2:41,1,0,1,7953.0,1:36,7142875
8466333,Andrew,Ference,1979-03-17,D,L,2015-16,6,0,0,0,0.0,-4,4,0.0,6,4701.0,13:3,0,0,0,0.0,10,5,0,2,-2,0,0,0,13.0,0:2,0,0,0,421.0,1:10,3250000
8466393,Pascal,Dupuis,1979-04-07,RW,L,2015-16,18,2,2,4,0.22,-1,28,7.14,12,16305.0,15:5,2,1,3,66.67,35,12,2,4,-2,0,0,0,166.0,0:9,0,0,0,2618.0,2:25,3750000
8467096,Dan,Boyle,1976-07-12,D,R,2015-16,74,10,14,24,0.32,0,95,10.53,30,83536.0,18:48,0,0,0,0.0,66,105,19,47,-28,3,7,10,9666.0,2:10,0,0,0,2989.0,0:40,4500000
8467329,Vincent,Lecavalier,1980-04-21,C,L,2015-16,49,10,8,18,0.37,0,67,14.93,22,38926.0,13:14,297,288,585,50.77,62,22,13,14,-1,6,1,7,4542.0,1:32,0,0,0,1420.0,0:28,7727272
8467330,David,Legwand,1980-08-17,C,L,2015-16,79,5,9,14,0.18,-4,61,8.2,14,46003.0,9:42,196,231,427,45.9,28,18,19,12,7,0,1,1,163.0,0:2,1,1,2,11498.0,2:25,3000000
8467338,Alex,Tanguay,1979-11-21,LW,L,2015-16,70,8,27,35,0.5,8,71,11.27,32,66320.0,15:47,3,2,5,60.0,22,36,27,17,10,1,8,9,9472.0,2:15,0,1,1,2288.0,0:32,3500000
8467351,Scott,Gomez,1979-12-23,C,L,2015-16,34,1,8,9,0.26,-7,20,5.0,6,23128.0,11:20,125,152,277,45.13,3,10,6,13,-7,0,4,4,3201.0,1:34,0,0,0,66.0,0:1,575000
8467370,Mike,Fisher,1980-06-05,C,R,2015-16,70,13,10,23,0.33,-14,98,13.27,29,72085.0,17:9,668,582,1250,53.44,142,74,21,14,7,3,2,5,9513.0,2:15,0,1,1,7441.0,1:46,4400000
8467371,Mike,Ribeiro,1980-02-10,C,L,2015-16,81,7,43,50,0.62,11,76,9.21,62,84805.0,17:26,288,472,760,37.89,61,20,22,50,-28,2,13,15,13455.0,2:46,0,0,0,151.0,0:1,5500000
8467389,Brad,Richards,1980-05-02,C,L,2015-16,68,10,18,28,0.41,4,164,6.1,8,60361.0,14:47,124,126,250,49.6,16,12,15,22,-7,4,10,14,10804.0,2:38,0,0,0,78.0,0:1,6666666
8467400,Francois,Beauchemin,1980-06-04,D,L,2015-16,82,8,26,34,0.41,-7,127,6.3,38,123393.0,25:4,0,0,0,0.0,78,256,31,41,-10,2,9,11,10377.0,2:6,0,2,2,17338.0,3:31,4500000
8467407,Brian,Gionta,1979-01-18,RW,R,2015-16,79,12,21,33,0.42,-5,169,7.1,12,84052.0,17:43,54,66,120,45.0,46,36,31,21,10,1,5,6,9471.0,1:59,0,0,0,6756.0,1:25,4250000
8467423,Shawn,Horcoff,1978-09-17,C,L,2015-16,59,6,9,15,0.25,1,73,8.22,34,47036.0,13:17,320,306,626,51.12,58,24,12,28,-16,0,0,0,883.0,0:14,1,1,2,5736.0,1:37,1750000
8467452,Rob,Scuderi,1978-12-30,D,L,2015-16,63,0,10,10,0.16,7,35,0.0,10,59762.0,15:48,0,1,1,0.0,31,75,5,29,-24,0,0,0,107.0,0:1,0,1,1,6793.0,1:47,3375000
8467493,Chris,Neil,1979-06-18,RW,R,2015-16,80,5,8,13,0.16,-3,70,7.14,165,44631.0,9:17,1,1,2,50.0,215,12,11,12,-1,0,0,0,305.0,0:3,0,0,0,47.0,0:0,1900000
8467496,Andrei,Markov,1978-12-20,D,L,2015-16,82,5,39,44,0.54,-6,117,4.27,38,117272.0,23:50,0,0,0,0.0,57,142,38,93,-55,4,13,17,16646.0,3:23,0,0,0,11493.0,2:20,5750000
8467514,Pavel,Datsyuk,1978-07-20,C,L,2015-16,66,16,33,49,0.74,7,181,8.84,14,77834.0,19:39,599,517,1116,53.67,70,33,48,26,22,8,12,20,11707.0,2:57,0,0,0,336.0,0:5,7500000
8467875,Daniel,Sedin,1980-09-26,LW,L,2015-16,82,28,33,61,0.74,7,258,10.85,36,90202.0,18:20,5,14,19,26.32,20,19,24,31,-7,8,11,19,16080.0,3:16,0,1,1,2245.0,0:27,7000000
8467876,Henrik,Sedin,1980-09-26,C,L,2015-16,74,11,44,55,0.74,0,99,11.11,24,81602.0,18:22,620,727,1347,46.03,9,19,23,50,-27,5,15,20,14320.0,3:13,1,0,1,2486.0,0:33,7000000
8467890,Barret,Jackman,1981-03-05,D,L,2015-16,73,1,4,5,0.07,1,64,1.56,76,60695.0,13:51,0,0,0,0.0,100,86,8,35,-27,0,0,0,119.0,0:1,0,0,0,3720.0,0:50,2000000
8467899,Martin,Havlat,1981-04-19,RW,L,2015-16,2,1,0,1,0.5,0,3,33.33,0,1307.0,10:53,0,0,0,0.0,1,0,3,0,3,0,0,0,52.0,0:26,0,0,0,0.0,0:0,600000
8467967,Chris,Kelly,1980-11-11,C,L,2015-16,11,2,0,2,0.18,3,8,25.0,0,8637.0,13:5,22,30,52,42.31,13,13,2,2,0,0,0,0,94.0,0:8,1,0,1,1576.0,2:23,3000000
8468001,Derek,MacKenzie,1981-06-11,C,L,2015-16,64,6,7,13,0.2,7,79,7.59,36,50502.0,13:9,439,362,801,54.81,154,38,27,13,14,0,0,0,567.0,0:8,0,1,1,10116.0,2:38,1300000
8468083,Henrik,Zetterberg,1980-10-09,C,L,2015-16,82,13,37,50,0.61,-15,214,6.07,24,95499.0,19:24,539,536,1075,50.14,54,26,29,46,-17,2,20,22,15324.0,3:6,0,0,0,433.0,0:5,6083333
8468085,Radim,Vrbata,1981-06-13,RW,R,2015-16,63,13,14,27,0.43,-30,199,6.53,12,60657.0,16:2,4,10,14,28.57,15,12,20,27,-7,5,4,9,10793.0,2:51,0,0,0,230.0,0:3,5000000
8468208,Joel,Ward,1980-12-02,RW,R,2015-16,79,21,22,43,0.54,-15,138,15.22,28,80452.0,16:58,237,256,493,48.07,68,53,41,51,-10,5,7,12,9942.0,2:5,1,1,2,6352.0,1:20,3275000
8468309,Mark,Streit,1977-12-11,D,L,2015-16,62,6,17,23,0.37,-1,110,5.45,18,81373.0,21:52,0,0,0,0.0,28,90,14,41,-27,2,6,8,11551.0,3:6,0,0,0,5393.0,1:26,5250000
8468483,Marian,Gaborik,1982-02-14,RW,L,2015-16,54,12,10,22,0.41,-6,142,8.45,20,48420.0,14:56,1,2,3,33.33,29,17,13,18,-5,1,3,4,5984.0,1:50,0,0,0,346.0,0:6,4875000
8468486,Scott,Hartnell,1982-04-18,LW,L,2015-16,79,23,26,49,0.62,-11,150,15.33,112,73865.0,15:35,0,3,3,0.0,131,41,20,32,-12,10,2,12,12026.0,2:32,0,0,0,277.0,0:3,4750000
8468493,Ron,Hainsey,1981-03-24,D,L,2015-16,81,5,14,19,0.23,-13,131,3.82,37,108498.0,22:19,0,0,0,0.0,85,126,34,48,-14,0,0,0,1001.0,0:12,0,0,0,13456.0,2:46,2833333
8468498,Brooks,Orpik,1980-09-26,D,L,2015-16,41,3,7,10,0.24,11,31,9.68,24,48734.0,19:48,0,0,0,0.0,125,102,7,24,-17,0,0,0,65.0,0:1,0,0,0,5513.0,2:14,5500000
8468504,Brad,Boyes,1982-04-17,RW,R,2015-16,60,8,16,24,0.4,-6,85,9.41,12,43093.0,11:58,9,5,14,64.29,20,17,25,19,6,2,3,5,8566.0,2:22,0,0,0,95.0,0:1,2625000
8468505,Steve,Ott,1982-08-19,C,L,2015-16,21,0,2,2,0.1,-3,21,0.0,34,13757.0,10:55,39,31,70,55.71,34,5,3,1,2,0,0,0,44.0,0:2,0,0,0,2224.0,1:45,2600000
8468508,Justin,Williams,1981-10-04,RW,R,2015-16,82,22,30,52,0.63,15,201,10.95,36,81932.0,16:39,57,52,109,52.29,32,43,37,48,-11,3,6,9,9980.0,2:1,0,1,1,4726.0,0:57,3250000
8468509,Niklas,Kronwall,1981-01-12,D,L,2015-16,64,3,23,26,0.41,-21,61,4.92,30,84516.0,22:0,0,0,0,0.0,93,81,9,23,-14,0,14,14,10955.0,2:51,0,0,0,8612.0,2:14,4750000
8468513,Nick,Schultz,1982-08-25,D,L,2015-16,81,1,9,10,0.12,-1,70,1.43,42,87221.0,17:56,1,0,1,100.0,85,174,4,38,-34,0,0,0,277.0,0:3,0,0,0,14314.0,2:56,2250000
8468526,Jarret,Stoll,1982-06-24,C,R,2015-16,80,4,5,9,0.11,-1,49,8.16,36,58450.0,12:10,481,362,843,57.06,117,69,8,11,-3,0,0,0,116.0,0:1,0,0,0,8553.0,1:46,800000
8468535,Antoine,Vermette,1982-07-20,C,L,2015-16,76,17,21,38,0.5,-14,123,13.82,93,75883.0,16:38,754,597,1351,55.81,55,57,27,33,-6,6,10,16,12970.0,2:50,1,0,1,4783.0,1:2,3750000
8468542,Paul,Martin,1981-03-05,D,L,2015-16,78,3,17,20,0.26,13,49,6.12,22,97006.0,20:43,0,0,0,0.0,54,123,26,50,-24,1,1,2,1874.0,0:24,0,0,0,10367.0,2:12,4850000
8468575,Dominic,Moore,1980-08-03,C,L,2015-16,80,6,9,15,0.19,-2,94,6.38,32,63816.0,13:17,476,385,861,55.28,51,35,24,36,-12,0,0,0,276.0,0:3,0,0,0,10351.0,2:9,1500000
8468611,Matt,Hendricks,1981-06-17,C,L,2015-16,68,5,7,12,0.18,2,62,8.06,82,54010.0,13:14,251,202,453,55.41,175,68,14,20,-6,0,0,0,590.0,0:8,1,1,2,9104.0,2:13,1850000
8468635,Travis,Moen,1982-04-06,LW,L,2015-16,23,0,2,2,0.09,-3,12,0.0,21,11305.0,8:11,4,1,5,80.0,30,13,4,4,0,0,0,0,38.0,0:1,0,1,1,555.0,0:24,1850000
8468639,John-Michael,Liles,1980-11-25,D,L,2015-16,81,6,15,21,0.26,-10,111,5.41,18,98676.0,20:18,0,0,0,0.0,81,127,26,44,-18,1,2,3,8192.0,1:41,1,0,1,7477.0,1:32,3875000
8468674,Deryk,Engelland,1982-04-03,D,R,2015-16,69,3,9,12,0.17,7,71,4.23,54,63058.0,15:13,0,0,0,0.0,105,107,8,22,-14,0,0,0,504.0,0:7,0,1,1,5117.0,1:14,2916667
8468700,Paul,Gaustad,1982-02-03,C,L,2015-16,63,2,4,6,0.1,-4,46,4.35,46,42495.0,11:14,427,345,772,55.31,114,33,14,14,0,0,0,0,135.0,0:2,1,1,2,6961.0,1:50,3250000
8469455,Jason,Spezza,1983-06-13,C,R,2015-16,75,33,30,63,0.84,4,202,16.34,22,74340.0,16:31,538,443,981,54.84,9,20,45,62,-17,9,15,24,14048.0,3:7,0,0,0,492.0,0:6,7500000
8469459,Mikko,Koivu,1983-03-12,C,L,2015-16,82,17,39,56,0.68,6,141,12.06,40,98051.0,19:55,987,771,1758,56.14,38,57,37,45,-8,10,10,20,16810.0,3:25,1,1,2,4505.0,0:54,6750000
8469462,Tuomo,Ruutu,1983-02-16,LW,L,2015-16,33,0,1,1,0.03,-7,34,0.0,8,22779.0,11:30,2,3,5,40.0,63,8,10,8,2,0,0,0,358.0,0:10,0,0,0,449.0,0:13,4750000
8469465,Dan,Hamhuis,1982-12-13,D,L,2015-16,58,3,10,13,0.22,-2,72,4.17,28,74525.0,21:24,0,0,0,0.0,64,72,24,47,-23,1,2,3,4832.0,1:23,0,0,0,9074.0,2:36,4500000
8469466,Ales,Hemsky,1983-08-13,RW,R,2015-16,75,13,26,39,0.52,3,155,8.39,20,58969.0,13:6,2,4,6,33.33,25,26,22,36,-14,1,4,5,7250.0,1:36,0,0,0,35.0,0:0,4000000
8469469,R.J.,Umberger,1982-05-03,C,L,2015-16,39,2,9,11,0.28,1,48,4.17,15,23771.0,10:9,2,3,5,40.0,59,15,4,7,-3,1,1,2,1151.0,0:29,0,0,0,318.0,0:8,4600000
8469470,Carlo,Colaiacovo,1983-01-27,D,L,2015-16,36,1,4,5,0.14,-11,29,3.45,10,31261.0,14:28,0,0,0,0.0,36,41,3,11,-8,0,1,1,382.0,0:10,0,0,0,139.0,0:3,900000
8469490,Tim,Jackman,1981-11-14,RW,R,2015-16,2,0,0,0,0.0,-2,1,0.0,4,688.0,5:44,0,0,0,0.0,2,0,0,1,-1,0,0,0,0.0,0:0,0,0,0,0.0,0:0,700000
8469492,Fedor,Tyutin,1983-07-19,D,L,2015-16,61,1,2,3,0.05,-6,25,4.0,28,64380.0,17:35,0,0,0,0.0,128,71,7,13,-6,0,0,0,338.0,0:5,0,0,0,7727.0,2:6,4500000
8469500,Michael,Cammalleri,1982-06-08,LW,L,2015-16,42,14,24,38,0.9,15,101,13.86,18,48583.0,19:16,7,7,14,50.0,15,13,19,24,-5,3,7,10,7610.0,3:1,0,0,0,507.0,0:12,5000000
8469501,Chris,Thorburn,1983-06-03,RW,R,2015-16,82,6,6,12,0.15,-1,70,8.57,81,49797.0,10:7,68,54,122,55.74,146,32,11,18,-7,0,0,0,379.0,0:4,1,0,1,3403.0,0:41,1200000
8469506,Jason,Pominville,1982-11-30,RW,R,2015-16,75,11,25,36,0.48,10,187,5.88,12,73637.0,16:21,37,45,82,45.12,31,31,21,22,-1,3,7,10,11103.0,2:28,0,0,0,31.0,0:0,5600000
8469508,Jay,McClement,1983-03-02,C,L,2015-16,77,3,8,11,0.14,-17,64,4.69,24,53609.0,11:36,375,303,678,55.31,79,31,32,21,11,0,0,0,441.0,0:5,1,0,1,8872.0,1:55,1200000
8469521,Tomas,Plekanec,1982-10-31,C,L,2015-16,82,14,40,54,0.66,4,189,7.41,36,91178.0,18:31,804,811,1615,49.78,60,46,15,45,-30,1,12,13,13214.0,2:41,0,0,0,7952.0,1:36,5000000
8469544,Patrick,Sharp,1981-12-27,LW,R,2015-16,76,20,35,55,0.72,-3,226,8.85,27,80337.0,17:37,16,17,33,48.48,76,24,51,46,5,7,17,24,13057.0,2:51,0,0,0,530.0,0:6,5900000
8469547,Jordin,Tootoo,1983-02-02,RW,R,2015-16,66,4,5,9,0.14,-26,90,4.44,102,45650.0,11:31,0,2,2,0.0,99,18,17,23,-6,2,3,5,4803.0,1:12,0,0,0,82.0,0:1,825000
8469555,Christian,Ehrhoff,1982-07-06,D,L,2015-16,48,2,10,12,0.25,-11,80,2.5,34,44593.0,15:29,0,0,0,0.0,39,35,5,22,-17,0,8,8,4729.0,1:38,0,0,0,1177.0,0:24,4000000
8469598,Kevin,Bieksa,1981-06-16,D,R,2015-16,71,4,11,15,0.21,-7,109,3.67,99,89506.0,21:0,0,0,0,0.0,152,108,13,51,-38,2,4,6,6351.0,1:29,0,0,0,8817.0,2:4,4600000
8469619,Dennis,Seidenberg,1981-07-18,D,L,2015-16,61,1,11,12,0.2,-1,66,1.52,24,70995.0,19:23,0,0,0,0.0,127,120,16,24,-8,0,1,1,186.0,0:3,0,0,0,8606.0,2:21,4000000
8469623,Marek,Zidlicky,1977-02-03,D,R,2015-16,53,4,12,16,0.3,5,48,8.33,20,49555.0,15:35,0,0,0,0.0,39,68,5,21,-16,0,4,4,5963.0,1:52,0,0,0,146.0,0:2,1500000
8469638,Jussi,Jokinen,1983-04-01,LW,L,2015-16,81,18,42,60,0.74,25,153,11.76,42,88896.0,18:17,135,127,262,51.53,43,50,31,47,-16,5,7,12,12662.0,2:36,1,1,2,11067.0,2:16,4000000
8469639,Brooks,Laich,1983-06-23,C,L,2015-16,81,2,12,14,0.17,-13,101,1.98,18,55574.0,11:26,98,145,243,40.33,126,34,29,16,13,0,0,0,1281.0,0:15,0,1,1,9602.0,1:58,4500000
8469665,Johnny,Oduya,1981-10-01,D,L,2015-16,82,4,17,21,0.26,8,63,6.35,26,100257.0,20:22,0,0,0,0.0,73,172,23,37,-14,0,0,0,683.0,0:8,1,1,2,13795.0,2:48,3750000
8469707,PA,Parenteau,1983-03-24,RW,R,2015-16,77,20,21,41,0.53,0,168,11.9,68,75116.0,16:15,4,14,18,22.22,48,26,29,27,2,7,4,11,12914.0,2:47,0,0,0,89.0,0:1,4000000
8469759,Vernon,Fiddler,1980-05-09,C,L,2015-16,82,12,10,22,0.27,5,98,12.24,31,57270.0,11:38,455,442,897,50.72,42,39,24,15,9,1,1,2,1459.0,0:17,2,2,4,10689.0,2:10,1250000
8469760,Zbynek,Michalek,1982-12-23,D,R,2015-16,70,2,5,7,0.1,3,69,2.9,20,71469.0,17:0,0,0,0,0.0,84,125,21,27,-6,0,0,0,147.0,0:2,0,0,0,13093.0,3:7,3200000
8469770,Dennis,Wideman,1983-03-20,D,R,2015-16,51,2,17,19,0.37,-9,75,2.67,30,63082.0,20:36,0,0,0,0.0,37,77,14,37,-23,2,6,8,9042.0,2:57,0,0,0,4732.0,1:32,5250000
8470039,Tomas,Fleischmann,1984-05-16,LW,L,2015-16,76,14,11,25,0.33,-8,123,11.38,32,69374.0,15:12,24,19,43,55.81,40,19,38,16,22,0,1,1,2721.0,0:35,1,0,1,6804.0,1:29,750000
8470041,Rick,Nash,1984-06-16,LW,L,2015-16,60,15,21,36,0.6,8,183,8.2,30,60982.0,16:56,0,1,1,0.0,69,24,45,40,5,4,2,6,7660.0,2:7,0,1,1,4905.0,1:21,7800000
8470047,Valtteri,Filppula,1984-03-20,C,L,2015-16,76,8,23,31,0.41,-6,101,7.92,46,83251.0,18:15,632,584,1216,51.97,30,25,30,37,-7,1,7,8,12518.0,2:44,1,0,1,7492.0,1:38,5000000
8470104,Tom,Gilbert,1983-01-10,D,R,2015-16,45,1,1,2,0.04,3,36,2.78,12,45532.0,16:51,0,0,0,0.0,29,88,6,39,-33,0,0,0,411.0,0:9,0,1,1,4954.0,1:50,2800000
8470105,Scottie,Upshall,1983-10-07,RW,L,2015-16,70,6,8,14,0.2,5,113,5.31,44,45980.0,10:56,12,22,34,35.29,92,16,19,10,9,0,0,0,156.0,0:2,0,3,3,5269.0,1:15,700000
8470110,Trevor,Daley,1983-10-09,D,L,2015-16,82,6,22,28,0.34,9,130,4.62,34,90731.0,18:26,0,1,1,0.0,42,79,17,28,-11,1,8,9,9125.0,1:51,0,0,0,3262.0,0:39,3300000
8470120,Alexander,Semin,1984-03-03,RW,R,2015-16,15,1,3,4,0.27,1,18,5.56,12,11102.0,12:20,1,0,1,100.0,6,4,6,8,-2,0,0,0,1875.0,2:5,0,0,0,0.0,0:0,7000000
8470121,Matt,Greene,1983-05-13,D,R,2015-16,3,0,0,0,0.0,0,3,0.0,8,2115.0,11:45,0,0,0,0.0,5,1,0,3,-3,0,0,0,1.0,0:0,0,0,0,340.0,1:53,2500000
8470144,Frans,Nielsen,1984-04-24,C,L,2015-16,81,20,32,52,0.64,1,181,11.05,12,86119.0,17:43,586,583,1169,50.13,35,92,30,30,0,7,13,20,13241.0,2:43,2,0,2,9670.0,1:59,2750000
8470151,Jay,Bouwmeester,1983-09-27,D,L,2015-16,72,3,16,19,0.26,-4,105,2.86,18,99853.0,23:6,0,0,0,0.0,71,110,11,30,-19,1,1,2,2931.0,0:40,0,0,0,13937.0,3:13,5400000
8470159,Boyd,Gordon,1983-10-19,C,R,2015-16,65,2,2,4,0.06,-7,53,3.77,10,47587.0,12:12,526,383,909,57.87,21,51,10,12,-2,0,0,0,159.0,0:2,1,0,1,10966.0,2:48,3000000
8470162,Matt,Stajan,1983-12-19,C,L,2015-16,80,6,11,17,0.21,-4,58,10.34,52,60948.0,12:41,373,415,788,47.34,77,45,34,34,0,0,0,0,448.0,0:5,2,1,3,7489.0,1:33,3125000
8470169,Gregory,Campbell,1983-12-17,C,L,2015-16,82,3,8,11,0.13,-6,58,5.17,78,51986.0,10:33,229,253,482,47.51,100,56,14,11,3,0,0,0,237.0,0:2,0,0,0,8971.0,1:49,1500000
8470171,Max,Talbot,1984-02-11,C,L,2015-16,38,2,5,7,0.18,-11,29,6.9,15,25567.0,11:12,164,181,345,47.54,66,28,9,0,9,0,1,1,189.0,0:4,0,0,0,4062.0,1:46,1800000
8470180,Eric,Nystrom,1983-02-14,LW,L,2015-16,46,7,0,7,0.15,-6,27,25.93,20,31694.0,11:29,1,1,2,50.0,92,26,6,6,0,0,0,0,63.0,0:1,1,0,1,3803.0,1:22,2500000
8470187,Johnny,Boychuk,1984-01-19,D,R,2015-16,70,9,16,25,0.36,17,165,5.45,31,89741.0,21:22,0,0,0,0.0,149,140,21,47,-26,1,4,5,4069.0,0:58,0,0,0,9855.0,2:20,6000000
8470201,Jiri,Hudler,1984-01-04,RW,L,2015-16,72,16,30,46,0.64,-1,109,14.68,27,68080.0,15:45,11,15,26,42.31,28,7,23,25,-2,3,7,10,11101.0,2:34,0,0,0,59.0,0:0,4000000
8470207,Joffrey,Lupul,1983-09-23,LW,R,2015-16,46,11,3,14,0.3,-10,102,10.78,12,40354.0,14:37,0,4,4,0.0,58,14,12,7,5,2,2,4,6516.0,2:21,0,0,0,20.0,0:0,5250000
8470230,Daniel,Paille,1984-04-15,LW,L,2015-16,12,0,0,0,0.0,-2,11,0.0,0,8214.0,11:24,0,1,1,0.0,16,9,5,2,3,0,0,0,2.0,0:0,0,0,0,1212.0,1:41,575000
8470257,Alexander,Steen,1984-03-01,LW,L,2015-16,67,17,35,52,0.78,3,172,9.88,48,81892.0,20:22,159,198,357,44.54,50,35,36,20,16,2,19,21,11883.0,2:57,1,0,1,7195.0,1:47,5800000
8470274,Chris,Higgins,1983-06-02,LW,L,2015-16,33,3,1,4,0.12,-14,51,5.88,4,27281.0,13:46,1,2,3,33.33,15,18,7,8,-1,0,0,0,1250.0,0:37,1,0,1,2968.0,1:29,2500000
8470281,Duncan,Keith,1983-07-16,D,L,2015-16,67,9,34,43,0.64,13,130,6.92,26,101446.0,25:14,0,1,1,0.0,16,116,22,46,-24,4,14,18,11304.0,2:48,0,1,1,10772.0,2:40,5538462
8470317,Nate,Guenin,1982-12-10,D,R,2015-16,29,0,0,0,0.0,2,10,0.0,2,22725.0,13:3,0,0,0,0.0,15,33,2,6,-4,0,0,0,4.0,0:0,0,0,0,2971.0,1:42,800000
8470318,Jonathan,Ericsson,1984-03-02,D,L,2015-16,71,3,12,15,0.21,2,68,4.41,56,78957.0,18:32,0,0,0,0.0,121,48,14,61,-47,0,0,0,448.0,0:6,0,0,0,11164.0,2:37,4250000
8470324,Josh,Gorges,1984-08-14,D,L,2015-16,77,2,10,12,0.16,-7,57,3.51,72,94549.0,20:27,0,0,0,0.0,143,167,13,17,-4,0,0,0,308.0,0:4,0,0,0,10512.0,2:16,3900000
8470358,Alexandre,Burrows,1981-04-11,RW,L,2015-16,79,9,13,22,0.28,-13,135,6.67,49,71905.0,15:10,10,12,22,45.45,81,33,27,14,13,2,4,6,9148.0,1:55,0,0,0,8195.0,1:43,4500000
8470543,Chris,Kunitz,1979-09-26,LW,L,2015-16,80,17,23,40,0.5,29,150,11.33,41,80758.0,16:49,5,6,11,45.45,264,33,33,43,-10,2,4,6,10261.0,2:8,0,0,0,1647.0,0:20,3850000
8470595,Eric,Staal,1984-10-29,C,L,2015-16,83,13,26,39,0.47,-2,199,6.53,34,92406.0,18:33,446,396,842,52.97,74,33,62,39,23,1,6,7,12850.0,2:34,0,0,0,1654.0,0:19,8250000
8470598,Thomas,Vanek,1984-01-19,LW,R,2015-16,74,18,23,41,0.55,-10,146,12.33,22,69312.0,15:36,12,26,38,31.58,18,17,22,51,-29,6,8,14,11526.0,2:35,0,0,0,90.0,0:1,6500000
8470599,Milan,Michalek,1984-12-07,LW,L,2015-16,45,7,9,16,0.36,0,64,10.94,18,43520.0,16:7,3,5,8,37.5,42,27,25,14,11,3,3,6,7906.0,2:55,0,0,0,2516.0,0:55,4000000
8470600,Ryan,Suter,1985-01-21,D,L,2015-16,82,8,43,51,0.62,10,188,4.26,30,140677.0,28:35,0,0,0,0.0,69,142,36,41,-5,3,18,21,18105.0,3:40,1,1,2,9621.0,1:57,7538462
8470601,Braydon,Coburn,1985-02-27,D,L,2015-16,80,1,9,10,0.12,12,92,1.09,53,80411.0,16:45,0,0,0,0.0,111,88,17,31,-14,0,0,0,368.0,0:4,0,1,1,11034.0,2:17,4500000
8470602,Dion,Phaneuf,1985-04-10,D,L,2015-16,71,4,28,32,0.45,-7,144,2.78,90,95197.0,22:20,0,0,0,0.0,168,89,19,35,-16,0,9,9,12163.0,2:51,0,2,2,7811.0,1:50,7000000
8470604,Jeff,Carter,1985-01-01,C,R,2015-16,77,24,38,62,0.81,18,242,9.92,20,84954.0,18:23,598,630,1228,48.7,89,39,26,41,-15,4,8,12,10583.0,2:17,1,1,2,7664.0,1:39,5272727
8470606,Dustin,Brown,1984-11-04,RW,R,2015-16,82,11,17,28,0.34,-5,218,5.05,30,79573.0,16:10,8,9,17,47.06,234,20,40,31,9,2,1,3,4985.0,1:0,0,1,1,7567.0,1:32,5875000
8470607,Brent,Seabrook,1985-04-20,D,R,2015-16,81,14,35,49,0.6,6,167,8.38,32,110918.0,22:49,0,0,0,0.0,121,150,19,89,-70,6,19,25,13929.0,2:51,0,0,0,8688.0,1:47,5800000
8470609,Steve,Bernier,1985-03-31,RW,R,2015-16,24,1,5,6,0.25,3,27,3.7,9,16168.0,11:13,0,0,0,0.0,42,13,6,7,-1,0,0,0,434.0,0:18,0,0,0,13.0,0:0,750000
8470610,Zach,Parise,1984-07-28,LW,L,2015-16,70,25,28,53,0.76,-3,234,10.68,36,81026.0,19:17,0,4,4,0.0,71,42,39,18,21,7,11,18,14274.0,3:23,0,0,0,1178.0,0:16,7538462
8470611,Eric,Fehr,1985-09-07,C,R,2015-16,55,8,6,14,0.25,0,74,10.81,19,43084.0,13:3,107,135,242,44.21,60,45,30,11,19,0,1,1,1216.0,0:22,4,0,4,8171.0,2:28,2000000
8470612,Ryan,Getzlaf,1985-05-10,C,R,2015-16,77,13,50,63,0.82,14,178,7.3,55,90117.0,19:30,602,617,1219,49.38,108,61,48,75,-27,6,16,22,13129.0,2:50,0,1,1,6755.0,1:27,8250000
8470613,Brent,Burns,1985-03-09,D,R,2015-16,82,27,48,75,0.91,-5,353,7.65,53,127251.0,25:51,1,0,1,100.0,101,145,53,102,-49,7,23,30,20145.0,4:5,1,1,2,10499.0,2:8,5760000
8470614,Mark,Stuart,1984-04-27,D,L,2015-16,64,1,2,3,0.05,-7,39,2.56,66,62784.0,16:21,0,0,0,0.0,162,120,3,43,-40,0,0,0,81.0,0:1,0,1,1,11128.0,2:53,2625000
8470616,Ryan,Kesler,1984-08-31,C,R,2015-16,79,21,32,53,0.67,5,164,12.8,78,92580.0,19:31,980,695,1675,58.51,168,92,39,34,5,5,10,15,9646.0,2:2,1,0,1,13049.0,2:45,5000000
8470617,Mike,Richards,1985-02-11,C,L,2015-16,39,2,3,5,0.13,-2,46,4.35,8,28490.0,12:10,235,240,475,49.47,39,19,12,10,2,0,0,0,137.0,0:3,0,0,0,5306.0,2:16,5750000
8470619,Brian,Boyle,1984-12-18,C,L,2015-16,76,13,7,20,0.26,-7,117,11.11,57,58871.0,12:54,346,336,682,50.73,115,48,15,16,-1,2,1,3,2923.0,0:38,2,0,2,7962.0,1:44,2000000
8470621,Corey,Perry,1985-05-16,RW,R,2015-16,82,34,28,62,0.76,2,215,15.81,68,87122.0,17:42,2,8,10,20.0,104,36,25,53,-28,12,12,24,14141.0,2:52,0,0,0,242.0,0:2,8625000
8470622,Patrick,Eaves,1984-05-01,RW,R,2015-16,54,11,6,17,0.31,-5,86,12.79,27,42038.0,12:58,3,8,11,27.27,70,20,16,11,5,5,2,7,6585.0,2:1,0,0,0,1023.0,0:18,1150000
8470626,Loui,Eriksson,1985-07-17,LW,L,2015-16,82,30,33,63,0.77,13,184,16.3,12,95850.0,19:28,12,9,21,57.14,22,34,48,27,21,10,7,17,14324.0,2:54,2,1,3,9106.0,1:51,4250000
8470630,Kevin,Klein,1984-12-13,D,R,2015-16,69,9,17,26,0.38,16,69,13.04,19,84392.0,20:23,0,0,0,0.0,117,155,20,45,-25,0,1,1,1930.0,0:27,0,0,0,8672.0,2:5,2900000
8470638,Patrice,Bergeron,1985-07-24,C,R,2015-16,80,32,36,68,0.85,12,282,11.35,49,95207.0,19:50,1130,848,1978,57.13,77,56,67,34,33,12,13,25,14381.0,2:59,1,2,3,10546.0,2:11,6875000
8470640,Matt,Carle,1984-09-25,D,L,2015-16,64,2,7,9,0.14,4,54,3.7,26,64434.0,16:46,0,0,0,0.0,30,91,9,28,-19,0,0,0,1383.0,0:21,0,0,0,5523.0,1:26,5500000
8470642,Shea,Weber,1985-08-14,D,R,2015-16,78,20,31,51,0.65,-7,189,10.58,27,118764.0,25:22,0,0,0,0.0,169,160,19,39,-20,14,12,26,14340.0,3:3,0,1,1,13319.0,2:50,7857143
8470644,Colin,McDonald,1984-09-30,RW,R,2015-16,5,1,0,1,0.2,0,4,25.0,7,2443.0,8:8,0,0,0,0.0,16,1,0,0,0,0,0,0,3.0,0:0,0,0,0,0.0,0:0,625000
8470655,David,Backes,1984-05-01,RW,R,2015-16,79,21,24,45,0.57,4,168,12.5,83,91151.0,19:13,620,572,1192,52.01,239,63,39,24,15,8,5,13,11824.0,2:29,0,0,0,8542.0,1:48,4500000
8470667,Clarke,MacArthur,1985-04-06,LW,L,2015-16,4,0,0,0,0.0,-1,4,0.0,0,2606.0,10:51,0,1,1,0.0,3,1,0,0,0,0,0,0,193.0,0:48,0,0,0,31.0,0:7,4650000
8470724,Kyle,Quincey,1985-08-12,D,L,2015-16,47,4,7,11,0.23,1,62,6.45,36,55733.0,19:45,0,0,0,0.0,49,62,8,26,-18,0,0,0,190.0,0:4,0,0,0,6438.0,2:16,4250000
8470740,Lee,Stempniak,1983-02-04,RW,R,2015-16,82,19,32,51,0.62,4,146,13.01,38,88283.0,17:56,2,11,13,15.38,113,34,31,30,1,3,9,12,9539.0,1:56,1,0,1,7907.0,1:36,850000
8470750,John,Mitchell,1985-01-22,C,L,2015-16,71,10,11,21,0.3,-7,101,9.9,52,64947.0,15:14,415,434,849,48.88,85,65,33,17,16,0,1,1,2602.0,0:36,0,0,0,8580.0,2:0,1800000
8470755,Brad,Richardson,1985-02-04,C,L,2015-16,82,11,20,31,0.38,8,117,9.4,46,76858.0,15:37,523,438,961,54.42,57,53,26,15,11,0,0,0,1440.0,0:17,0,0,0,8234.0,1:40,2083333
8470760,Marc,Methot,1985-06-21,D,L,2015-16,69,5,7,12,0.17,12,74,6.76,34,85525.0,20:39,0,0,0,0.0,124,90,10,49,-39,0,0,0,221.0,0:3,0,0,0,9068.0,2:11,4900000
8470775,Nate,Thompson,1984-10-05,C,L,2015-16,49,3,3,6,0.12,-1,42,7.14,47,34084.0,11:35,235,216,451,52.11,103,40,7,14,-7,0,0,0,396.0,0:8,1,0,1,4638.0,1:34,1600000
8470778,Drew,Miller,1984-02-17,LW,L,2015-16,28,1,1,2,0.07,-5,27,3.7,2,21794.0,12:58,1,1,2,50.0,39,33,8,6,2,0,0,0,82.0,0:2,0,0,0,4992.0,2:58,1350000
8470794,Joe,Pavelski,1984-07-11,C,R,2015-16,82,38,40,78,0.95,25,224,16.96,30,97494.0,19:48,516,422,938,55.01,147,67,46,82,-36,12,16,28,17979.0,3:39,0,0,0,2735.0,0:33,6000000
8470803,Kyle,Brodziak,1984-05-25,C,R,2015-16,76,7,4,11,0.14,-1,49,14.29,37,49271.0,10:48,275,281,556,49.46,50,37,18,11,7,0,0,0,225.0,0:2,3,0,3,8030.0,1:45,900000
8470828,Toby,Enstrom,1984-11-05,D,L,2015-16,72,2,14,16,0.22,8,50,4.0,44,90091.0,20:51,0,0,0,0.0,25,96,9,40,-31,0,1,1,5861.0,1:21,0,0,0,6671.0,1:32,5750000
8470834,Dustin,Byfuglien,1985-03-27,D,R,2015-16,81,19,34,53,0.65,4,247,7.69,119,122487.0,25:12,0,0,0,0.0,222,105,73,92,-19,3,14,17,16311.0,3:21,1,1,2,9765.0,2:0,5200000
8470852,Matt,Moulson,1983-11-01,LW,L,2015-16,81,8,13,21,0.26,-5,111,7.21,16,57849.0,11:54,0,5,5,0.0,45,23,18,15,3,2,5,7,9598.0,1:58,0,0,0,23.0,0:0,5000000
8470854,Tanner,Glass,1983-11-29,LW,L,2015-16,57,4,3,7,0.12,-3,49,8.16,66,35178.0,10:17,6,14,20,30.0,224,18,4,13,-9,0,0,0,227.0,0:3,0,0,0,1516.0,0:26,1450000
8470871,Chris,Porter,1984-05-29,LW,L,2015-16,61,4,3,7,0.11,-6,45,8.89,6,35269.0,9:38,0,1,1,0.0,157,12,15,8,7,0,0,0,71.0,0:1,0,0,0,4372.0,1:11,575000
8470877,David,Jones,1984-08-10,RW,R,2015-16,75,11,7,18,0.24,-7,84,13.1,10,55976.0,12:26,17,17,34,50.0,147,33,14,9,5,1,0,1,1700.0,0:22,0,0,0,245.0,0:3,4000000
8470886,Clayton,Stoner,1985-02-19,D,L,2015-16,50,1,5,6,0.12,4,32,3.12,67,46081.0,15:21,0,0,0,0.0,123,55,2,31,-29,0,0,0,164.0,0:3,0,1,1,5399.0,1:47,3250000
8470920,David,Clarkson,1984-03-31,RW,R,2015-16,23,2,2,4,0.17,-8,24,8.33,23,12720.0,9:13,2,10,12,16.67,45,6,5,2,3,0,0,0,390.0,0:16,0,0,0,22.0,0:0,5250000
8470966,Mark,Giordano,1983-10-03,D,L,2015-16,82,21,35,56,0.68,-5,212,9.91,54,121981.0,24:47,0,0,0,0.0,65,193,45,68,-23,9,10,19,15704.0,3:11,1,2,3,11840.0,2:24,4020000
8471214,Alex,Ovechkin,1985-09-17,LW,R,2015-16,79,50,21,71,0.9,21,398,12.56,53,96262.0,20:18,0,0,0,0.0,225,34,24,50,-26,19,5,24,20365.0,4:17,0,0,0,18.0,0:0,9538462
8471215,Evgeni,Malkin,1986-07-31,C,L,2015-16,57,27,31,58,1.02,1,162,16.67,65,66241.0,19:22,317,438,755,41.99,27,19,54,52,2,11,16,27,13041.0,3:48,0,0,0,919.0,0:16,9500000
8471217,Andrew,Ladd,1985-12-12,LW,L,2015-16,78,25,21,46,0.59,-13,181,13.81,45,88519.0,18:54,8,5,13,61.54,155,42,29,34,-5,10,4,14,12687.0,2:42,2,0,2,8617.0,1:50,4400000
8471218,Blake,Wheeler,1986-08-31,RW,R,2015-16,82,26,52,78,0.95,8,256,10.16,49,97354.0,19:47,10,18,28,35.71,92,56,38,46,-8,3,14,17,15526.0,3:9,2,2,4,6344.0,1:17,5600000
8471222,Ladislav,Smid,1986-02-01,D,L,2015-16,22,0,0,0,0.0,-7,11,0.0,6,15293.0,11:35,0,0,0,0.0,39,33,1,4,-3,0,0,0,113.0,0:5,0,0,0,609.0,0:27,3500000
8471226,Drew,Stafford,1985-10-30,RW,R,2015-16,78,21,17,38,0.49,-23,187,11.23,28,83646.0,17:52,51,50,101,50.5,59,15,30,34,-4,6,3,9,10080.0,2:9,1,2,3,4856.0,1:2,4350000
8471231,Kyle,Chipchura,1986-02-19,C,L,2015-16,70,4,8,12,0.17,-10,47,8.51,38,42985.0,10:14,88,80,168,52.38,73,13,25,16,9,0,1,1,661.0,0:9,0,0,0,3114.0,0:44,875000
8471232,Lauri,Korpikoski,1986-07-28,LW,L,2015-16,71,10,12,22,0.31,-17,88,11.36,10,59343.0,13:55,18,16,34,52.94,100,56,19,14,5,2,4,6,3436.0,0:48,1,0,1,8498.0,1:59,2500000
8471233,Travis,Zajac,1985-05-13,C,R,2015-16,74,14,28,42,0.57,3,111,12.61,25,88144.0,19:51,715,672,1387,51.55,65,41,49,5,44,6,11,17,11072.0,2:29,2,1,3,12031.0,2:42,5750000
8471240,Jeff,Schultz,1986-02-25,D,L,2015-16,1,0,0,0,0.0,-1,1,0.0,0,1095.0,18:15,0,0,0,0.0,0,2,0,0,0,0,0,0,0.0,0:0,0,0,0,221.0,3:41,850000
8471242,Mike,Green,1985-10-12,D,R,2015-16,74,7,28,35,0.47,-6,124,5.65,38,87772.0,19:46,0,2,2,0.0,106,71,18,40,-22,5,15,20,12316.0,2:46,0,0,0,625.0,0:8,6000000
8471245,Dave,Bolland,1986-06-05,C,R,2015-16,25,1,4,5,0.2,-2,26,3.85,16,21138.0,14:5,156,185,341,45.75,36,9,5,12,-7,0,3,3,1183.0,0:47,0,0,0,2991.0,1:59,5500000
8471254,Bryan,Bickell,1986-03-09,LW,L,2015-16,25,0,2,2,0.08,-5,21,0.0,2,14682.0,9:47,2,0,2,100.0,58,10,4,7,-3,0,0,0,316.0,0:12,0,0,0,0.0,0:0,4000000
8471260,Blake,Comeau,1986-02-18,LW,R,2015-16,81,12,24,36,0.44,-9,142,8.45,58,85668.0,17:37,276,290,566,48.76,173,35,31,25,6,2,6,8,8454.0,1:44,2,0,2,9738.0,2:0,2400000
8471262,Carl,Soderberg,1985-10-12,C,L,2015-16,82,12,39,51,0.62,-7,163,7.36,32,88634.0,18:0,339,380,719,47.15,27,71,32,26,6,3,11,14,11178.0,2:16,1,1,2,9780.0,1:59,4750000
8471269,Nicklas,Grossmann,1985-01-22,D,L,2015-16,58,3,4,7,0.12,-3,42,7.14,24,61895.0,17:47,0,0,0,0.0,106,73,3,21,-18,0,0,0,136.0,0:2,0,0,0,10367.0,2:58,3500000
8471273,Brandon,Dubinsky,1986-04-29,C,L,2015-16,75,17,31,48,0.64,-16,158,10.76,71,84434.0,18:45,780,704,1484,52.56,235,40,45,31,14,5,5,10,10012.0,2:13,0,0,0,8935.0,1:59,5850000
8471274,Alex,Goligoski,1985-07-30,D,L,2015-16,82,5,32,37,0.45,21,127,3.94,34,117262.0,23:50,0,0,0,0.0,100,159,18,73,-55,1,4,5,9633.0,1:57,0,1,1,11494.0,2:20,4600000
8471276,David,Krejci,1986-04-28,C,R,2015-16,72,17,46,63,0.88,4,143,11.89,32,87700.0,20:18,560,557,1117,50.13,43,57,36,49,-13,4,14,18,13956.0,3:13,0,3,3,6451.0,1:29,7250000
8471283,Brandon,Prust,1984-03-16,LW,L,2015-16,35,1,6,7,0.2,-3,19,5.26,59,26847.0,12:47,6,5,11,54.55,40,15,5,15,-10,0,0,0,270.0,0:7,0,0,0,1346.0,0:38,2500000
8471284,Andrej,Sekera,1986-06-08,D,L,2015-16,81,6,24,30,0.37,-15,155,3.87,12,106136.0,21:50,0,0,0,0.0,60,156,37,82,-45,2,12,14,11324.0,2:19,0,1,1,7844.0,1:36,5500000
8471296,Alexei,Emelin,1986-04-25,D,L,2015-16,72,0,12,12,0.17,-7,71,0.0,71,88551.0,20:29,0,0,0,0.0,256,113,15,75,-60,0,0,0,1147.0,0:15,0,0,0,9092.0,2:6,4100000
8471303,Alexander,Edler,1986-04-21,D,L,2015-16,52,6,14,20,0.38,-8,111,5.41,46,76292.0,24:27,0,0,0,0.0,84,106,15,40,-25,3,6,9,10145.0,3:15,0,0,0,8057.0,2:34,5000000
8471309,Johan,Franzen,1979-12-23,RW,L,2015-16,2,0,1,1,0.5,0,3,0.0,2,1554.0,12:57,0,1,1,0.0,3,0,0,0,0,0,1,1,76.0,0:38,0,0,0,0.0,0:0,3954545
8471311,Tyler,Kennedy,1986-07-15,C,R,2015-16,50,3,13,16,0.32,-14,72,4.17,14,40275.0,13:25,23,35,58,39.66,35,9,16,12,4,1,5,6,4127.0,1:22,0,0,0,157.0,0:3,600000
8471331,Kevin,Porter,1986-03-12,C,L,2015-16,41,0,3,3,0.07,-2,34,0.0,0,27845.0,11:19,44,43,87,50.57,96,25,7,8,-1,0,0,0,125.0,0:3,0,0,0,4567.0,1:51,575000
8471338,Torrey,Mitchell,1985-01-30,C,R,2015-16,71,11,8,19,0.27,2,69,15.94,51,54041.0,12:41,370,347,717,51.6,67,38,22,27,-5,0,0,0,412.0,0:5,1,2,3,6812.0,1:35,1200000
8471339,Ryan,Callahan,1985-03-21,RW,R,2015-16,73,10,18,28,0.38,-5,156,6.41,45,75502.0,17:14,21,15,36,58.33,164,71,34,23,11,2,2,4,10160.0,2:19,0,0,0,7528.0,1:43,5800000
8471346,Kris,Versteeg,1986-05-13,RW,R,2015-16,77,15,23,38,0.49,0,156,9.62,45,71092.0,15:23,8,8,16,50.0,20,32,38,38,0,2,7,9,8139.0,1:45,0,0,0,98.0,0:1,4400000
8471348,Nikita,Nikitin,1986-06-16,D,L,2015-16,11,0,1,1,0.09,-5,12,0.0,8,9770.0,14:48,0,0,0,0.0,14,9,0,4,-4,0,0,0,191.0,0:17,0,0,0,19.0,0:1,4500000
8471362,Mikhail,Grabovski,1984-01-31,C,L,2015-16,58,9,16,25,0.43,3,83,10.84,33,49079.0,14:6,221,242,463,47.73,28,26,28,34,-6,1,2,3,3566.0,1:1,0,0,0,101.0,0:1,5500000
8471371,Mike,Brown,1985-06-24,RW,R,2015-16,58,2,3,5,0.09,-5,51,3.92,90,27169.0,7:48,3,1,4,75.0,176,25,9,12,-3,0,0,0,139.0,0:2,0,0,0,354.0,0:6,1200000
8471385,Adam,Pardy,1984-03-29,D,L,2015-16,23,0,4,4,0.17,-7,22,0.0,14,21920.0,15:53,0,0,0,0.0,32,32,6,14,-8,0,0,0,28.0,0:1,0,1,1,3323.0,2:24,1000000
8471390,Mike,Santorelli,1985-12-14,C,R,2015-16,70,9,9,18,0.26,-4,81,11.11,8,42389.0,10:5,75,83,158,47.47,28,20,5,15,-10,1,2,3,2324.0,0:33,0,0,0,63.0,0:0,875000
8471392,Roman,Polak,1986-04-28,D,R,2015-16,79,1,15,16,0.2,6,91,1.1,72,90803.0,19:9,1,0,1,100.0,303,146,17,43,-26,0,0,0,254.0,0:3,0,0,0,13657.0,2:52,2750000
8471426,Troy,Brouwer,1985-08-17,RW,R,2015-16,82,18,21,39,0.48,2,142,12.68,62,83614.0,16:59,65,49,114,57.02,200,52,40,26,14,7,3,10,8868.0,1:48,0,0,0,7341.0,1:29,3666667
8471436,Matt,Hunwick,1985-05-21,D,L,2015-16,60,2,8,10,0.17,-17,74,2.7,32,81229.0,22:33,0,0,0,0.0,126,98,24,44,-20,0,2,2,678.0,0:11,0,0,0,13361.0,3:42,1200000
8471476,Daniel,Winnik,1985-03-06,LW,L,2015-16,76,6,13,19,0.25,4,101,5.94,38,62544.0,13:42,8,12,20,40.0,53,46,35,9,26,0,0,0,1507.0,0:19,0,0,0,7908.0,1:44,2250000
8471490,Adam,Cracknell,1985-07-15,RW,R,2015-16,52,5,5,10,0.19,-1,68,7.35,20,38161.0,12:13,156,239,395,39.49,124,25,23,14,9,0,0,0,364.0,0:7,0,0,0,1972.0,0:37,575000
8471498,Jannik,Hansen,1986-03-15,RW,R,2015-16,67,22,16,38,0.57,16,117,18.8,32,66065.0,16:26,6,15,21,28.57,39,19,25,24,1,1,0,1,1627.0,0:24,1,0,1,7024.0,1:44,2500000
8471504,Rene,Bourque,1981-12-10,RW,L,2015-16,49,3,5,8,0.16,-9,77,3.9,38,30703.0,10:26,3,6,9,33.33,82,19,16,8,8,0,0,0,678.0,0:13,0,0,0,162.0,0:3,3333333
8471657,Cody,McLeod,1984-06-26,LW,L,2015-16,82,8,5,13,0.16,1,73,10.96,138,51854.0,10:32,1,0,1,100.0,240,28,6,2,4,1,0,1,813.0,0:9,0,0,0,3873.0,0:47,1333333
8471663,Mike,Blunden,1986-12-15,RW,R,2015-16,20,3,2,5,0.25,3,14,21.43,34,10384.0,8:39,0,0,0,0.0,41,3,1,2,-1,0,0,0,268.0,0:13,0,0,0,0.0,0:0,600000
8471664,Mason,Raymond,1985-09-17,LW,L,2015-16,29,4,1,5,0.17,-3,53,7.55,8,21474.0,12:20,3,4,7,42.86,12,7,8,11,-3,0,0,0,2341.0,1:20,0,0,0,15.0,0:0,3150000
8471669,Paul,Stastny,1985-12-27,C,L,2015-16,64,10,39,49,0.77,3,103,9.71,26,73542.0,19:9,684,536,1220,56.07,32,40,20,7,13,2,12,14,9018.0,2:20,0,0,0,5358.0,1:23,7000000
8471675,Sidney,Crosby,1987-08-07,C,L,2015-16,80,36,49,85,1.06,19,248,14.52,42,98253.0,20:28,986,921,1907,51.7,90,35,40,47,-7,10,14,24,17776.0,3:42,0,0,0,1938.0,0:24,8700000
8471676,Bobby,Ryan,1987-03-17,RW,R,2015-16,81,22,34,56,0.69,-9,183,12.02,28,83470.0,17:10,3,8,11,27.27,106,24,52,52,0,6,10,16,13963.0,2:52,0,0,0,142.0,0:1,7250000
8471677,Jack,Johnson,1987-01-13,D,L,2015-16,60,6,8,14,0.23,-16,86,6.98,25,87031.0,24:10,0,1,1,0.0,98,102,8,30,-22,3,3,6,8546.0,2:22,0,0,0,10402.0,2:53,4357143
8471678,Benoit,Pouliot,1986-09-29,LW,L,2015-16,55,14,22,36,0.65,-6,109,12.84,30,52963.0,16:2,20,29,49,40.82,35,25,32,29,3,5,4,9,7762.0,2:21,1,0,1,1418.0,0:25,4000000
8471681,Jack,Skille,1987-05-19,RW,R,2015-16,74,8,6,14,0.19,-4,106,7.55,11,39216.0,8:49,4,15,19,21.05,97,25,17,8,9,0,0,0,220.0,0:2,0,0,0,959.0,0:12,675000
8471685,Anze,Kopitar,1987-08-24,C,L,2015-16,81,25,49,74,0.91,34,177,14.12,16,101412.0,20:52,950,826,1776,53.49,78,65,43,45,-2,5,13,18,12490.0,2:34,1,2,3,10484.0,2:9,6800000
8471686,Marc,Staal,1987-01-13,D,L,2015-16,77,2,13,15,0.19,2,65,3.08,36,90918.0,19:40,1,3,4,25.0,65,120,20,49,-29,0,0,0,489.0,0:6,0,0,0,10523.0,2:16,5700000
8471691,Martin,Hanzal,1987-02-20,C,L,2015-16,64,13,28,41,0.64,-5,141,9.22,77,68342.0,17:47,586,461,1047,55.97,126,28,27,21,6,3,10,13,12100.0,3:9,1,0,1,5035.0,1:18,3100000
8471693,Jakub,Kindl,1987-02-10,D,L,2015-16,44,2,6,8,0.18,13,63,3.17,18,40629.0,15:23,0,1,1,0.0,39,24,7,29,-22,0,1,1,2256.0,0:51,0,0,0,253.0,0:5,2400000
8471698,T.J.,Oshie,1986-12-23,RW,R,2015-16,80,26,25,51,0.64,16,185,14.05,34,91024.0,18:57,138,124,262,52.67,134,62,62,42,20,11,6,17,14545.0,3:1,0,0,0,6839.0,1:25,4175000
8471699,Andrew,Cogliano,1987-06-14,LW,L,2015-16,82,9,23,32,0.39,2,131,6.87,28,71004.0,14:25,6,11,17,35.29,124,27,26,34,-8,0,0,0,411.0,0:5,2,1,3,9345.0,1:53,3000000
8471702,Matt,Niskanen,1986-12-06,D,R,2015-16,82,5,27,32,0.39,10,150,3.33,38,121335.0,24:39,0,0,0,0.0,157,145,34,62,-28,2,14,16,11887.0,2:24,0,0,0,14118.0,2:52,5750000
8471703,Steve,Downie,1987-04-03,RW,R,2015-16,26,3,3,6,0.23,1,22,13.64,53,14043.0,9:0,2,2,4,50.0,29,7,4,4,0,0,0,0,296.0,0:11,0,0,0,0.0,0:0,1750000
8471707,James,Neal,1987-09-03,LW,L,2015-16,82,31,27,58,0.71,27,268,11.57,65,93831.0,19:4,8,19,27,29.63,113,31,49,25,24,4,10,14,13675.0,2:46,0,0,0,93.0,0:1,5000000
8471709,Marc-Edouard,Vlasic,1987-03-30,D,L,2015-16,67,8,31,39,0.58,15,116,6.9,48,92982.0,23:7,0,0,0,0.0,47,129,15,29,-14,2,8,10,8040.0,2:0,0,2,2,9077.0,2:15,4250000
8471710,Taylor,Chorney,1987-04-27,D,L,2015-16,55,1,5,6,0.11,8,28,3.57,21,43530.0,13:11,0,0,0,0.0,56,58,8,27,-19,0,0,0,109.0,0:1,0,0,0,3907.0,1:11,700000
8471716,Justin,Abdelkader,1987-02-25,LW,L,2015-16,82,19,23,42,0.51,-16,155,12.26,120,90703.0,18:26,5,9,14,35.71,207,44,23,29,-6,6,7,13,14152.0,2:52,0,0,0,7904.0,1:36,1800000
8471717,Adam,McQuaid,1986-10-12,D,R,2015-16,64,1,8,9,0.14,6,42,2.38,89,69274.0,18:2,0,0,0,0.0,142,121,7,27,-20,0,0,0,141.0,0:2,0,0,0,9412.0,2:27,2750000
8471724,Kris,Letang,1987-04-24,D,R,2015-16,71,16,51,67,0.94,9,218,7.34,66,114786.0,26:56,0,0,0,0.0,135,122,47,69,-22,5,22,27,16946.0,3:58,0,3,3,9887.0,2:19,7250000
8471729,Kris,Russell,1987-05-02,D,L,2015-16,62,4,15,19,0.31,-5,70,5.71,10,85842.0,23:4,0,1,1,0.0,40,210,23,47,-24,2,2,4,5643.0,1:31,0,0,0,7174.0,1:55,2600000
8471733,Rich,Clune,1987-04-25,LW,L,2015-16,19,0,4,4,0.21,1,10,0.0,22,9227.0,8:5,0,0,0,0.0,58,5,2,1,1,0,0,0,112.0,0:5,0,0,0,101.0,0:5,850000
8471735,Keith,Yandle,1986-09-09,D,L,2015-16,82,5,42,47,0.57,-4,160,3.12,40,98213.0,19:57,0,0,0,0.0,43,68,27,76,-49,2,20,22,12818.0,2:36,0,0,0,249.0,0:3,5250000
8471742,Cody,Franson,1987-08-08,D,R,2015-16,59,4,13,17,0.29,-5,92,4.35,26,59604.0,16:50,0,0,0,0.0,61,56,14,31,-17,1,6,7,7561.0,2:8,0,0,0,2653.0,0:44,3325000
8471760,Cody,Bass,1987-01-07,C,R,2015-16,17,0,0,0,0.0,-1,11,0.0,17,7816.0,7:39,12,9,21,57.14,26,8,2,0,2,0,0,0,13.0,0:0,0,0,0,203.0,0:11,575000
8471761,Chris,Butler,1986-10-27,D,L,2015-16,5,0,0,0,0.0,-1,4,0.0,4,3450.0,11:30,0,0,0,0.0,3,8,0,2,-2,0,0,0,102.0,0:20,0,0,0,93.0,0:18,675000
8471762,Chris,VandeVelde,1987-03-15,C,L,2015-16,79,2,12,14,0.18,-7,77,2.6,27,64236.0,13:33,6,15,21,28.57,139,60,21,18,3,0,0,0,489.0,0:6,1,0,1,10849.0,2:17,712500
8471766,Jared,Boll,1986-05-13,RW,R,2015-16,30,1,2,3,0.1,-3,11,9.09,61,11970.0,6:39,2,0,2,100.0,53,15,3,0,3,0,0,0,73.0,0:2,0,0,0,134.0,0:4,1700000
8471769,Niklas,Hjalmarsson,1987-06-06,D,L,2015-16,81,2,22,24,0.3,13,77,2.6,32,108758.0,22:22,0,0,0,0.0,32,151,31,65,-34,0,2,2,695.0,0:8,0,3,3,13942.0,2:52,4100000
8471794,Darren,Helm,1987-01-21,LW,L,2015-16,77,13,13,26,0.34,-2,165,7.88,32,69615.0,15:4,39,38,77,50.65,115,26,22,16,6,0,0,0,3372.0,0:43,0,0,0,8366.0,1:48,2125000
8471804,Nathan,Gerbe,1987-07-24,C,L,2015-16,47,3,4,7,0.15,-15,73,4.11,14,37957.0,13:27,2,3,5,40.0,54,10,13,23,-10,0,1,1,2907.0,1:1,0,0,0,2939.0,1:2,1750000
8471811,Cal,O'Reilly,1986-09-30,C,L,2015-16,20,3,4,7,0.35,-1,10,30.0,2,13416.0,11:10,59,50,109,54.13,3,5,2,6,-4,1,1,2,2349.0,1:57,0,0,0,65.0,0:3,700000
8471816,Mark,Fayne,1987-05-15,D,R,2015-16,69,2,5,7,0.1,-6,61,3.28,18,69208.0,16:43,0,0,0,0.0,53,100,13,36,-23,0,0,0,134.0,0:1,0,1,1,6827.0,1:38,3625000
8471817,Ryan,Reaves,1987-01-20,RW,R,2015-16,64,3,1,4,0.06,-6,31,9.68,68,30831.0,8:1,1,1,2,50.0,206,10,8,7,1,0,0,0,93.0,0:1,0,0,0,4.0,0:0,1125000
8471856,Joe,Vitale,1985-08-20,C,R,2015-16,1,0,0,0,0.0,1,1,0.0,5,373.0,6:13,0,1,1,0.0,1,0,0,0,0,0,0,0,16.0,0:16,0,0,0,46.0,0:46,1116667
8471862,Colin,Greening,1986-03-09,C,L,2015-16,31,7,8,15,0.48,-2,58,12.07,13,26219.0,14:5,13,8,21,61.9,90,10,10,10,0,1,1,2,4494.0,2:24,0,0,0,2.0,0:0,2650000
8471873,Anton,Stralman,1986-08-01,D,R,2015-16,73,9,25,34,0.47,16,127,7.09,20,96700.0,22:4,0,0,0,0.0,99,73,26,35,-9,1,11,12,12781.0,2:55,0,0,0,9153.0,2:5,4500000
8471887,Patric,Hornqvist,1987-01-01,RW,R,2015-16,82,22,29,51,0.62,15,257,8.56,36,82896.0,16:50,5,3,8,62.5,160,54,28,8,20,9,6,15,14926.0,3:2,0,0,0,141.0,0:1,4250000
8471916,Mike,Angelidis,1985-06-27,LW,L,2015-16,4,1,0,1,0.25,2,1,100.0,5,2160.0,9:0,10,21,31,32.26,6,1,1,1,0,0,0,0,57.0,0:14,0,0,0,60.0,0:15,650000
8471956,Andrew,Desjardins,1986-07-27,LW,L,2015-16,77,8,5,13,0.17,-8,96,8.33,30,61825.0,13:22,43,44,87,49.43,102,49,26,15,11,0,0,0,384.0,0:4,0,0,0,8373.0,1:48,800000
8471958,Dan,Girardi,1984-04-29,D,R,2015-16,74,2,15,17,0.23,18,77,2.6,20,90224.0,20:19,0,0,0,0.0,168,195,23,56,-33,0,0,0,538.0,0:7,0,1,1,12111.0,2:43,5500000
8471976,David,Desharnais,1986-09-14,C,L,2015-16,65,11,18,29,0.45,-6,90,12.22,20,62411.0,16:0,391,412,803,48.69,31,25,27,22,5,3,2,5,9010.0,2:18,0,0,0,76.0,0:1,3500000
8472382,Andy,Greene,1982-10-30,D,L,2015-16,82,4,9,13,0.16,7,63,6.35,26,112925.0,22:57,0,0,0,0.0,73,154,26,38,-12,1,1,2,1758.0,0:21,0,0,0,17123.0,3:28,5000000
8472410,Stephen,Gionta,1983-10-09,RW,R,2015-16,82,1,10,11,0.13,-13,62,1.61,43,60076.0,12:12,291,400,691,42.11,113,36,17,8,9,0,0,0,498.0,0:6,0,0,0,8739.0,1:46,850000
8473412,Bryan,Little,1987-11-12,C,R,2015-16,57,17,25,42,0.74,-13,127,13.39,12,67020.0,19:35,674,640,1314,51.29,48,22,20,26,-6,2,10,12,10066.0,2:56,2,0,2,6957.0,2:2,4700000
8473415,Alex,Biega,1988-04-04,D,R,2015-16,51,0,7,7,0.14,-11,61,0.0,22,51296.0,16:45,0,0,0,0.0,124,41,8,18,-10,0,0,0,666.0,0:13,0,0,0,3283.0,1:4,600000
8473419,Brad,Marchand,1988-05-11,LW,L,2015-16,77,37,24,61,0.79,21,250,14.8,90,85933.0,18:36,21,35,56,37.5,65,35,43,69,-26,6,2,8,6829.0,1:28,4,2,6,9258.0,2:0,4500000
8473422,Nick,Foligno,1987-10-31,LW,L,2015-16,72,12,25,37,0.51,-14,149,8.05,53,72972.0,16:53,83,93,176,47.16,152,46,27,25,2,0,13,13,8937.0,2:4,0,0,0,2401.0,0:33,5500000
8473426,Mike,Weber,1987-12-16,D,L,2015-16,45,1,4,5,0.11,2,40,2.5,60,41797.0,15:28,0,0,0,0.0,108,61,2,22,-20,0,0,0,28.0,0:0,0,0,0,4058.0,1:30,1666667
8473432,Derek,Dorsett,1986-12-20,RW,R,2015-16,71,5,11,16,0.23,-13,91,5.49,177,53635.0,12:35,3,7,10,30.0,127,44,11,14,-3,0,0,0,547.0,0:7,0,1,1,3353.0,0:47,2650000
8473446,Erik,Johnson,1988-03-21,D,R,2015-16,73,11,16,27,0.37,-19,175,6.29,50,102678.0,23:26,0,1,1,0.0,126,197,30,45,-15,3,3,6,8961.0,2:2,2,1,3,13545.0,3:5,3750000
8473449,Kyle,Okposo,1988-04-16,RW,R,2015-16,79,22,42,64,0.81,-4,202,10.89,51,86295.0,18:12,23,40,63,36.51,90,39,42,54,-12,7,16,23,14119.0,2:58,0,0,0,312.0,0:3,2800000
8473453,Trevor,Lewis,1987-01-08,C,R,2015-16,75,8,8,16,0.21,-10,167,4.79,20,65519.0,14:33,103,154,257,40.08,168,28,17,22,-5,0,1,1,1632.0,0:21,1,0,1,6889.0,1:31,1525000
8473463,Leo,Komarov,1987-01-23,C,L,2015-16,67,19,17,36,0.54,-12,130,14.62,40,71697.0,17:50,62,65,127,48.82,283,27,42,16,26,4,3,7,8934.0,2:13,1,0,1,6703.0,1:40,2950000
8473465,Jamie,McGinn,1988-08-05,LW,L,2015-16,84,22,17,39,0.46,-7,156,14.1,33,72035.0,14:17,4,3,7,57.14,164,27,18,19,-1,9,3,12,12148.0,2:24,0,0,0,26.0,0:0,2950000
8473466,Ryan,White,1988-03-17,C,R,2015-16,73,11,5,16,0.22,-9,88,12.5,101,55030.0,12:33,184,167,351,52.42,208,51,14,21,-7,3,0,3,4272.0,0:58,0,0,0,4198.0,0:57,800000
8473468,Eric,Gryba,1988-04-14,D,R,2015-16,53,1,5,6,0.11,0,58,1.72,75,56866.0,17:52,0,0,0,0.0,132,78,16,39,-23,0,0,0,142.0,0:2,0,0,0,7313.0,2:17,1250000
8473473,Milan,Lucic,1988-06-07,LW,L,2015-16,81,20,35,55,0.68,26,124,16.13,79,83772.0,17:14,7,13,20,35.0,244,22,22,48,-26,2,6,8,10358.0,2:7,0,0,0,242.0,0:2,6000000
8473482,Jiri,Tlusty,1988-03-16,LW,L,2015-16,30,2,2,4,0.13,-1,38,5.26,6,24681.0,13:42,0,0,0,0.0,39,13,8,4,4,1,1,2,1535.0,0:51,0,0,0,708.0,0:23,800000
8473485,Chris,Stewart,1987-10-30,RW,R,2015-16,56,8,12,20,0.36,2,78,10.26,73,36271.0,10:47,3,6,9,33.33,72,10,12,20,-8,1,4,5,3654.0,1:5,0,0,0,28.0,0:0,1700000
8473492,Matt,Beleskey,1988-06-07,LW,L,2015-16,80,15,22,37,0.46,6,168,8.93,65,76113.0,15:51,6,19,25,24.0,260,44,27,26,1,3,4,7,5936.0,1:14,0,0,0,337.0,0:4,3800000
8473504,Cal,Clutterbuck,1987-11-18,RW,R,2015-16,77,15,8,23,0.3,7,80,18.75,22,55052.0,11:54,1,2,3,33.33,288,34,21,20,1,0,0,0,502.0,0:6,2,1,3,9118.0,1:58,2750000
8473507,Jeff,Petry,1987-12-09,D,R,2015-16,51,5,11,16,0.31,-6,98,5.1,16,65350.0,21:21,1,0,1,100.0,86,73,16,50,-34,1,4,5,5493.0,1:47,0,3,3,7208.0,2:21,5500000
8473512,Claude,Giroux,1988-01-12,C,R,2015-16,78,22,45,67,0.86,-8,241,9.13,53,96157.0,20:32,1081,800,1881,57.47,83,36,41,45,-4,6,21,27,18039.0,3:51,1,1,2,6908.0,1:28,8275000
8473533,Jordan,Staal,1988-09-10,C,L,2015-16,82,20,28,48,0.59,6,151,13.25,34,90039.0,18:18,806,589,1395,57.78,165,31,55,50,5,6,4,10,8811.0,1:47,0,2,2,8732.0,1:46,6000000
8473534,Patrik,Berglund,1988-06-02,C,L,2015-16,42,10,5,15,0.36,1,80,12.5,16,39032.0,15:29,139,138,277,50.18,48,17,22,9,13,4,0,4,2025.0,0:48,0,0,0,3074.0,1:13,3700000
8473537,Viktor,Stalberg,1986-01-17,LW,L,2015-16,75,9,11,20,0.27,6,125,7.2,22,54914.0,12:12,2,4,6,33.33,144,33,29,22,7,0,0,0,167.0,0:2,0,0,0,5739.0,1:16,3000000
8473542,Tom,Sestito,1987-09-28,LW,L,2015-16,4,0,1,1,0.25,1,1,0.0,19,1391.0,5:47,0,0,0,0.0,13,1,0,1,-1,0,0,0,0.0,0:0,0,0,0,0.0,0:0,575000
8473544,Derick,Brassard,1987-09-22,C,L,2015-16,80,27,31,58,0.72,12,182,14.84,30,85849.0,17:53,676,670,1346,50.22,103,23,47,56,-9,8,14,22,12926.0,2:41,0,0,0,766.0,0:9,5000000
8473546,Michael,Grabner,1987-10-05,RW,L,2015-16,80,9,9,18,0.22,-4,116,7.76,12,69452.0,14:28,3,10,13,23.08,41,55,66,21,45,0,0,0,537.0,0:6,1,0,1,14909.0,3:6,3000000
8473548,Phil,Kessel,1987-10-02,RW,R,2015-16,82,26,33,59,0.72,9,274,9.49,18,90436.0,18:22,2,3,5,40.0,9,13,26,55,-29,4,13,17,17288.0,3:30,0,0,0,133.0,0:1,8000000
8473550,Andrew,Bodnarchuk,1988-07-11,D,L,2015-16,37,0,4,4,0.11,-7,9,0.0,14,27394.0,12:20,0,0,0,0.0,44,27,2,6,-4,0,0,0,131.0,0:3,0,0,0,562.0,0:15,650000
8473560,Korbinian,Holzer,1988-02-16,D,R,2015-16,29,0,3,3,0.1,-3,17,0.0,10,25672.0,14:45,0,0,0,0.0,57,32,2,8,-6,0,0,0,32.0,0:1,0,0,0,2259.0,1:17,750000
8473563,Nicklas,Backstrom,1987-11-23,C,L,2015-16,75,20,50,70,0.93,17,129,15.5,36,86318.0,19:10,659,698,1357,48.56,51,50,42,27,15,3,27,30,13820.0,3:4,0,0,0,4037.0,0:53,6700000
8473564,Michael,Frolik,1988-02-17,RW,L,2015-16,64,15,17,32,0.5,1,155,9.68,24,60706.0,15:48,5,5,10,50.0,49,44,27,21,6,0,1,1,1700.0,0:26,2,2,4,6588.0,1:42,4300000
8473565,Brian,Strait,1988-01-04,D,L,2015-16,52,1,5,6,0.12,1,43,2.33,31,48164.0,15:26,0,0,0,0.0,106,65,9,26,-17,0,0,0,140.0,0:2,0,1,1,4883.0,1:33,775000
8473571,Jamie,McBain,1988-02-25,D,R,2015-16,44,2,7,9,0.2,2,32,6.25,6,32304.0,12:14,0,0,0,0.0,20,38,2,13,-11,1,5,6,2501.0,0:56,0,0,0,195.0,0:4,600000
8473573,Artem,Anisimov,1988-05-24,C,L,2015-16,77,20,22,42,0.55,8,121,16.53,12,83571.0,18:5,507,641,1148,44.16,53,40,28,14,14,5,5,10,10497.0,2:16,3,1,4,6264.0,1:21,3283333
8473574,Shawn,Matthias,1988-02-19,LW,L,2015-16,71,12,16,28,0.39,-17,101,11.88,20,57565.0,13:30,9,15,24,37.5,68,39,34,12,22,0,0,0,2315.0,0:32,0,1,1,4557.0,1:4,2300000
8473579,Nikolay,Kulemin,1986-07-14,LW,L,2015-16,81,9,13,22,0.27,13,92,9.78,22,68336.0,14:3,23,36,59,38.98,107,50,32,31,1,0,0,0,251.0,0:3,0,0,0,9931.0,2:2,4187500
8473584,Andrew,MacDonald,1986-09-07,D,L,2015-16,28,1,7,8,0.29,10,20,5.0,6,33800.0,20:7,0,0,0,0.0,14,72,4,20,-16,0,2,2,1273.0,0:45,0,0,0,3040.0,1:48,5000000
8473588,Erik,Condra,1986-08-06,RW,R,2015-16,54,6,5,11,0.2,-4,58,10.34,34,34690.0,10:42,1,2,3,33.33,20,16,15,12,3,0,0,0,251.0,0:4,0,0,0,3798.0,1:10,1250000
8473589,Chris,Summers,1988-02-05,D,L,2015-16,3,0,0,0,0.0,-2,5,0.0,4,2770.0,15:23,0,0,0,0.0,4,1,0,0,0,0,0,0,0.0,0:0,0,0,0,200.0,1:6,600000
8473604,Jonathan,Toews,1988-04-29,C,L,2015-16,80,28,30,58,0.72,16,179,15.64,62,92390.0,19:14,921,652,1573,58.55,81,38,57,28,29,6,3,9,11705.0,2:26,4,3,7,6792.0,1:24,10500000
8473618,Mathieu,Perreault,1988-01-05,C,L,2015-16,71,9,32,41,0.58,-11,133,6.77,36,70499.0,16:32,94,109,203,46.31,83,33,31,26,5,6,9,15,12263.0,2:52,0,0,0,182.0,0:2,3000000
8473646,Ryan,Carter,1983-08-03,LW,L,2015-16,60,7,5,12,0.2,-3,62,11.29,48,40107.0,11:8,21,18,39,53.85,87,37,17,7,10,0,0,0,136.0,0:2,1,0,1,5983.0,1:39,625000
8473658,Victor,Bartley,1988-02-17,D,L,2015-16,10,0,0,0,0.0,2,8,0.0,6,7991.0,13:19,0,0,0,0.0,21,17,0,7,-7,0,0,0,28.0,0:2,0,0,0,67.0,0:6,666667
8473673,David,Schlemko,1987-05-07,D,L,2015-16,67,6,13,19,0.28,-22,104,5.77,16,74969.0,18:38,0,0,0,0.0,47,88,16,29,-13,1,11,12,8065.0,2:0,0,0,0,6364.0,1:34,625000
8473722,John,Scott,1982-09-26,LW,L,2015-16,12,0,1,1,0.08,-1,6,0.0,27,4700.0,6:31,0,0,0,0.0,23,3,1,3,-2,0,0,0,27.0,0:2,0,0,0,113.0,0:9,575000
8473914,Mark,Letestu,1985-02-04,C,R,2015-16,82,10,15,25,0.3,-21,107,9.35,10,77649.0,15:46,596,566,1162,51.29,68,33,28,29,-1,3,9,12,9847.0,2:0,2,1,3,12139.0,2:28,1800000
8473933,Ben,Lovejoy,1984-02-20,D,R,2015-16,66,4,6,10,0.15,9,90,4.44,30,74713.0,18:52,0,0,0,0.0,154,104,20,18,2,0,0,0,308.0,0:4,0,1,1,9838.0,2:29,1100000
8473962,Teddy,Purcell,1985-09-08,LW,R,2015-16,76,14,29,43,0.57,-11,149,9.4,12,76744.0,16:49,2,4,6,33.33,31,15,31,34,-3,2,8,10,11530.0,2:31,0,1,1,2468.0,0:32,4500000
8473970,Rob,Klinkhammer,1986-08-12,LW,L,2015-16,14,1,0,1,0.07,-6,10,10.0,6,7906.0,9:24,1,0,1,100.0,47,4,3,3,0,0,0,0,1.0,0:0,0,0,0,347.0,0:24,725000
8473986,Alex,Killorn,1989-09-14,LW,L,2015-16,81,14,26,40,0.49,14,154,9.09,44,81625.0,16:47,31,49,80,38.75,76,23,31,46,-15,3,3,6,11252.0,2:18,0,1,1,2248.0,0:27,2550000
8473989,Luke,Gazdic,1989-07-25,LW,L,2015-16,29,1,0,1,0.03,-6,18,5.56,24,10784.0,6:11,0,1,1,0.0,35,9,2,1,1,0,0,0,2.0,0:0,0,0,0,0.0,0:0,800000
8473991,Karl,Alzner,1988-09-24,D,L,2015-16,82,4,17,21,0.26,14,75,5.33,26,105165.0,21:22,0,0,0,0.0,135,207,24,41,-17,0,0,0,251.0,0:3,0,0,0,13990.0,2:50,2800000
8473992,Justin,Falk,1988-10-11,D,L,2015-16,24,0,4,4,0.17,2,16,0.0,17,20485.0,14:13,0,0,0,0.0,37,38,3,9,-6,0,0,0,26.0,0:1,0,0,0,1320.0,0:55,600000
8473994,Jamie,Benn,1989-07-18,LW,L,2015-16,82,41,48,89,1.09,7,247,16.6,64,98508.0,20:1,226,252,478,47.28,156,55,65,80,-15,17,13,30,15747.0,3:12,2,3,5,7725.0,1:34,5250000
8474000,Steven,Kampfer,1988-09-24,D,R,2015-16,47,0,4,4,0.09,5,54,0.0,26,42566.0,15:5,1,1,2,50.0,70,70,5,10,-5,0,1,1,592.0,0:12,0,0,0,2408.0,0:51,612500
8474005,Alex,Grant,1989-01-20,D,R,2015-16,5,0,0,0,0.0,-2,4,0.0,7,3970.0,13:14,0,0,0,0.0,7,2,1,0,1,0,0,0,221.0,0:44,0,0,0,171.0,0:34,600000
8474008,Paul,Carey,1988-09-24,C,L,2015-16,4,1,0,1,0.25,0,5,20.0,0,2393.0,9:58,0,0,0,0.0,6,1,0,0,0,0,0,0,0.0,0:0,0,0,0,28.0,0:7,575000
8474009,Nick,Bonino,1988-04-20,C,L,2015-16,63,9,20,29,0.46,13,97,9.28,31,59871.0,15:50,463,455,918,50.44,22,67,32,17,15,2,0,2,6025.0,1:35,1,0,1,8804.0,2:19,1900000
8474013,Ian,Cole,1989-02-21,D,L,2015-16,70,0,12,12,0.17,-3,72,0.0,59,72404.0,17:14,0,0,0,0.0,122,122,8,32,-24,0,1,1,1543.0,0:22,0,0,0,9718.0,2:18,2100000
8474024,Jim,O'Brien,1989-01-29,C,R,2015-16,4,0,0,0,0.0,-4,3,0.0,2,3244.0,13:31,29,20,49,59.18,7,2,0,1,-1,0,0,0,9.0,0:2,0,0,0,121.0,0:30,575000
8474027,Justin,Braun,1987-02-10,D,R,2015-16,80,4,19,23,0.29,11,114,3.51,36,98685.0,20:33,0,0,0,0.0,95,140,33,46,-13,0,1,1,3224.0,0:40,0,0,0,9543.0,1:59,3800000
8474031,Kevin,Shattenkirk,1989-01-29,D,R,2015-16,72,14,30,44,0.61,-14,180,7.78,51,96864.0,22:25,0,0,0,0.0,82,113,37,39,-2,6,20,26,11973.0,2:46,0,1,1,8299.0,1:55,4250000
8474034,Patrick,Maroon,1988-04-23,LW,L,2015-16,72,12,15,27,0.38,-7,104,11.54,88,53302.0,12:20,17,36,53,32.08,151,10,10,30,-20,5,3,8,6632.0,1:32,0,0,0,15.0,0:0,2000000
8474037,James,van Riemsdyk,1989-05-04,LW,L,2015-16,40,14,15,29,0.72,3,129,10.85,6,42631.0,17:45,1,1,2,50.0,52,7,29,13,16,5,4,9,6658.0,2:46,0,0,0,65.0,0:1,4250000
8474038,Paul,Byron,1989-04-27,LW,L,2015-16,62,11,7,18,0.29,-9,50,22.0,11,51182.0,13:45,3,2,5,60.0,112,25,23,15,8,0,0,0,506.0,0:8,3,2,5,6862.0,1:50,900000
8474040,Sam,Gagner,1989-08-10,C,R,2015-16,53,8,8,16,0.3,4,86,9.3,25,44077.0,13:51,34,63,97,35.05,17,15,20,13,7,2,1,3,6087.0,1:54,0,0,0,20.0,0:0,4800000
8474052,Chris,Terry,1989-04-07,LW,L,2015-16,68,8,3,11,0.16,-12,78,10.26,16,46001.0,11:16,1,8,9,11.11,82,21,21,20,1,0,0,0,2224.0,0:32,0,0,0,29.0,0:0,875000
8474053,Logan,Couture,1989-03-28,C,L,2015-16,52,15,21,36,0.69,2,137,10.95,20,54248.0,17:23,271,305,576,47.05,29,38,39,36,3,5,10,15,11399.0,3:39,0,0,0,2336.0,0:44,6000000
8474056,P.K.,Subban,1989-05-13,D,R,2015-16,68,6,45,51,0.75,4,176,3.41,75,107558.0,26:21,0,0,0,0.0,102,80,23,106,-83,2,22,24,18831.0,4:36,0,0,0,9566.0,2:20,9000000
8474061,Anthony,Peluso,1989-04-18,RW,R,2015-16,35,1,4,5,0.14,4,16,6.25,44,13407.0,6:23,0,0,0,0.0,81,4,3,6,-3,0,0,0,90.0,0:2,0,0,0,0.0,0:0,675000
8474062,Riley,Nash,1989-05-09,C,R,2015-16,64,9,13,22,0.34,-5,76,11.84,18,49752.0,12:57,193,197,390,49.49,58,21,47,13,34,2,4,6,3924.0,1:1,0,0,0,3314.0,0:51,1150000
8474066,Thomas,Hickey,1989-02-08,D,L,2015-16,62,6,12,18,0.29,9,55,10.91,30,64745.0,17:24,0,0,0,0.0,65,90,18,41,-23,0,0,0,1399.0,0:22,0,0,0,7776.0,2:5,2200000
8474068,Kyle,Turris,1989-08-14,C,R,2015-16,57,13,17,30,0.53,-15,122,10.66,32,67390.0,19:42,536,508,1044,51.34,44,31,16,24,-8,3,5,8,11064.0,3:14,0,1,1,1134.0,0:19,3500000
8474074,Paul,Postma,1989-02-22,D,R,2015-16,26,2,0,2,0.08,-3,24,8.33,4,17866.0,11:27,0,0,0,0.0,13,14,4,8,-4,0,0,0,842.0,0:32,0,0,0,44.0,0:1,887500
8474089,Brad,Malone,1989-05-20,C,L,2015-16,57,2,4,6,0.11,-11,31,6.45,75,32659.0,9:32,40,22,62,64.52,124,15,4,16,-12,0,0,0,144.0,0:2,0,0,0,3922.0,1:8,650000
8474090,Brendan,Smith,1989-02-08,D,L,2015-16,63,3,12,15,0.24,1,82,3.66,62,66540.0,17:36,0,0,0,0.0,94,42,10,35,-25,1,0,1,2317.0,0:36,0,0,0,4387.0,1:9,2750000
8474091,Brandon,Sutter,1989-02-14,C,R,2015-16,20,5,4,9,0.45,3,45,11.11,2,21572.0,17:58,146,132,278,52.52,12,10,4,5,-1,1,0,1,2814.0,2:20,1,0,1,2553.0,2:7,3300000
8474094,Matt,Halischuk,1988-06-01,RW,R,2015-16,30,0,3,3,0.1,1,39,0.0,4,17014.0,9:27,1,2,3,33.33,38,11,5,3,2,0,0,0,73.0,0:2,0,0,0,732.0,0:24,750000
8474096,Nick,Spaling,1988-09-19,C,L,2015-16,58,3,10,13,0.22,-2,53,5.66,24,49684.0,14:16,309,292,601,51.41,65,45,31,13,18,0,0,0,317.0,0:5,0,0,0,7611.0,2:11,2200000
8474098,Colton,Sceviour,1989-04-20,C,R,2015-16,71,11,12,23,0.32,6,125,8.8,21,54007.0,12:40,9,15,24,37.5,71,52,30,27,3,1,2,3,2368.0,0:33,0,1,1,7132.0,1:40,650000
8474100,Dwight,King,1989-07-05,LW,L,2015-16,47,7,6,13,0.28,-6,48,14.58,24,40713.0,14:26,2,5,7,28.57,73,6,5,6,-1,0,0,0,1197.0,0:25,0,0,0,3630.0,1:17,1950000
8474102,David,Perron,1988-05-28,LW,R,2015-16,71,12,24,36,0.51,-1,147,8.16,62,64806.0,15:12,2,8,10,20.0,142,23,22,20,2,4,8,12,8817.0,2:4,0,0,0,122.0,0:1,3812500
8474113,TJ,Brennan,1989-04-03,D,L,2015-16,7,1,0,1,0.14,-6,11,9.09,6,6341.0,15:5,0,0,0,0.0,7,5,2,2,0,0,0,0,110.0,0:15,0,0,0,160.0,0:22,675000
8474125,Carl,Gunnarsson,1986-11-09,D,L,2015-16,72,3,6,9,0.12,7,51,5.88,31,75080.0,17:22,0,0,0,0.0,67,119,14,23,-9,1,0,1,461.0,0:6,0,0,0,8739.0,2:1,3150000
8474134,Yannick,Weber,1988-09-23,D,R,2015-16,45,0,7,7,0.16,-17,65,0.0,24,50841.0,18:49,0,0,0,0.0,49,37,10,15,-5,0,5,5,6182.0,2:17,0,0,0,2152.0,0:47,1500000
8474138,Dustin,Jeffrey,1988-02-27,LW,L,2015-16,7,1,1,2,0.29,2,5,20.0,2,4791.0,11:24,35,23,58,60.34,2,1,0,0,0,0,0,0,485.0,1:9,0,0,0,0.0,0:0,575000
8474141,Patrick,Kane,1988-11-19,RW,L,2015-16,82,46,60,106,1.29,17,287,16.03,30,100419.0,20:24,11,40,51,21.57,37,21,34,37,-3,17,20,37,15390.0,3:7,0,0,0,219.0,0:2,10500000
8474145,Robert,Bortuzzo,1989-03-18,D,R,2015-16,40,2,1,3,0.08,2,47,4.26,52,31846.0,13:16,0,0,0,0.0,93,42,5,9,-4,0,0,0,40.0,0:1,0,0,0,2278.0,0:56,1050000
8474150,Mikael,Backlund,1989-03-17,C,L,2015-16,82,21,26,47,0.57,10,155,13.55,28,80831.0,16:25,539,604,1143,47.16,68,51,57,44,13,3,6,9,7862.0,1:35,3,1,4,8657.0,1:45,3575000
8474151,Ryan,McDonagh,1989-06-13,D,L,2015-16,73,9,25,34,0.47,26,113,7.96,22,97903.0,22:21,1,0,1,100.0,98,138,31,67,-36,2,7,9,8403.0,1:55,0,1,1,11558.0,2:38,4700000
8474157,Max,Pacioretty,1988-11-20,LW,L,2015-16,82,30,34,64,0.78,-10,303,9.9,34,91154.0,18:31,6,7,13,46.15,102,37,35,33,2,8,9,17,14408.0,2:55,1,0,1,5805.0,1:10,4500000
8474161,Jakub,Voracek,1989-08-15,RW,L,2015-16,73,11,44,55,0.75,-5,213,5.16,38,81407.0,18:35,3,3,6,50.0,51,34,26,50,-24,1,22,23,15433.0,3:31,0,0,0,219.0,0:3,4250000
8474162,Jake,Muzzin,1989-02-21,D,L,2015-16,82,8,32,40,0.49,7,203,3.94,64,113460.0,23:3,0,0,0,0.0,197,135,13,68,-55,1,12,13,11390.0,2:18,0,1,1,12416.0,2:31,4000000
8474166,Alec,Martinez,1987-07-26,D,L,2015-16,78,10,21,31,0.4,16,124,8.06,40,98985.0,21:9,0,0,0,0.0,164,182,8,60,-52,4,9,13,9282.0,1:59,0,1,1,10566.0,2:15,4000000
8474168,Joakim,Andersson,1989-02-05,C,L,2015-16,29,1,2,3,0.1,1,17,5.88,6,15695.0,9:1,32,38,70,45.71,14,5,1,0,1,0,0,0,123.0,0:4,0,0,0,3242.0,1:51,815000
8474176,Carl,Hagelin,1988-08-23,LW,L,2015-16,80,14,25,39,0.49,8,178,7.87,32,75393.0,15:42,6,8,14,42.86,84,33,30,35,-5,0,0,0,1130.0,0:14,0,2,2,7897.0,1:38,4000000
8474189,Lars,Eller,1989-05-08,C,L,2015-16,79,13,13,26,0.33,-13,149,8.72,28,72319.0,15:15,207,202,409,50.61,111,36,46,25,21,1,0,1,4602.0,0:58,1,0,1,6353.0,1:20,3500000
8474190,Wayne,Simmonds,1988-08-26,RW,R,2015-16,81,32,28,60,0.74,-7,229,13.97,147,83758.0,17:14,5,2,7,71.43,192,44,25,31,-6,13,8,21,17600.0,3:37,0,0,0,134.0,0:1,3975000
8474207,Nick,Holden,1987-05-15,D,L,2015-16,82,6,16,22,0.27,-1,98,6.12,24,107652.0,21:52,0,0,0,0.0,217,118,21,26,-5,0,1,1,3745.0,0:45,0,0,0,11508.0,2:20,1650000
8474218,Jason,Demers,1988-06-09,D,R,2015-16,62,7,16,23,0.37,16,94,7.45,72,77629.0,20:52,0,0,0,0.0,86,73,28,41,-13,3,2,5,6258.0,1:40,1,0,1,8891.0,2:23,3400000
8474230,Micheal,Haley,1986-03-30,C,L,2015-16,16,1,0,1,0.06,-2,10,10.0,48,6814.0,7:5,11,8,19,57.89,39,4,0,9,-9,0,0,0,18.0,0:1,0,0,0,0.0,0:0,600000
8474250,Zack,Smith,1988-04-05,LW,L,2015-16,81,25,11,36,0.44,16,121,20.66,80,74843.0,15:23,380,349,729,52.13,175,26,33,26,7,4,1,5,7735.0,1:35,5,1,6,6419.0,1:19,1887500
8474291,Jay,Beagle,1985-10-16,C,R,2015-16,57,8,9,17,0.3,0,74,10.81,24,47935.0,14:0,370,267,637,58.08,55,24,20,12,8,0,0,0,194.0,0:3,0,0,0,6809.0,1:59,1750000
8474497,Michael,Kostka,1985-11-28,D,R,2015-16,15,0,1,1,0.07,6,9,0.0,4,13363.0,14:50,0,0,0,0.0,7,20,0,6,-6,0,0,0,10.0,0:0,0,0,0,541.0,0:36,800000
8474516,Bryan,Lerg,1986-01-20,C,L,2015-16,6,0,0,0,0.0,1,4,0.0,0,3195.0,8:52,17,16,33,51.52,13,3,0,0,0,0,0,0,0.0,0:0,0,0,0,201.0,0:33,600000
8474520,Jason,Garrison,1984-11-13,D,L,2015-16,72,5,6,11,0.15,-4,99,5.05,18,79763.0,18:27,0,0,0,0.0,88,105,15,45,-30,0,0,0,2864.0,0:39,0,0,0,8087.0,1:52,4600000
8474554,Eric,Selleck,1987-10-20,LW,L,2015-16,1,0,0,0,0.0,0,1,0.0,5,573.0,9:33,0,0,0,0.0,3,0,0,0,0,0,0,0,22.0,0:22,0,0,0,0.0,0:0,575000
8474563,Drew,Doughty,1989-12-08,D,R,2015-16,82,14,37,51,0.62,24,197,7.11,52,137848.0,28:1,0,0,0,0.0,125,105,10,97,-87,9,15,24,15066.0,3:3,1,1,2,14468.0,2:56,7000000
8474564,Steven,Stamkos,1990-02-07,C,R,2015-16,77,36,28,64,0.83,3,216,16.67,38,91266.0,19:45,463,464,927,49.95,109,35,45,45,0,14,9,23,16094.0,3:29,1,2,3,3576.0,0:46,7500000
8474565,Alex,Pietrangelo,1990-01-18,D,R,2015-16,73,7,30,37,0.51,10,182,3.85,20,115215.0,26:18,0,0,0,0.0,48,136,41,39,2,1,4,5,10041.0,2:17,0,1,1,13969.0,3:11,6500000
8474567,Zach,Bogosian,1990-07-15,D,R,2015-16,64,7,17,24,0.38,-11,121,5.79,68,85815.0,22:20,0,0,0,0.0,86,98,17,21,-4,3,3,6,5668.0,1:28,0,1,1,5362.0,1:23,5142857
8474568,Luke,Schenn,1989-11-02,D,R,2015-16,72,4,12,16,0.22,-2,76,5.26,82,75908.0,17:34,1,1,2,50.0,234,106,11,53,-42,1,0,1,1117.0,0:15,0,0,0,9240.0,2:8,3600000
8474569,Colin,Wilson,1989-10-20,C,L,2015-16,64,6,18,24,0.38,-1,108,5.56,14,55513.0,14:27,14,21,35,40.0,61,25,24,26,-2,1,0,1,5576.0,1:27,0,0,0,105.0,0:1,3937500
8474570,Cody,Hodgson,1990-02-18,C,R,2015-16,39,3,5,8,0.21,2,65,4.62,6,25115.0,10:43,46,52,98,46.94,25,6,7,7,0,0,1,1,282.0,0:7,0,0,0,74.0,0:1,4250000
8474571,Mikkel,Boedker,1989-12-16,LW,L,2015-16,80,17,34,51,0.64,-33,166,10.24,12,88941.0,18:31,1,2,3,33.33,51,31,38,32,6,3,16,19,18964.0,3:57,0,0,0,354.0,0:4,3750000
8474573,Josh,Bailey,1989-10-02,RW,L,2015-16,81,12,20,32,0.4,-7,105,11.43,22,77028.0,15:50,14,20,34,41.18,45,25,41,49,-8,4,1,5,6953.0,1:25,0,0,0,2494.0,0:30,3300000
8474574,Tyler,Myers,1990-02-01,D,R,2015-16,73,9,18,27,0.37,6,140,6.43,72,99068.0,22:37,0,1,1,0.0,54,95,45,47,-2,0,2,2,9936.0,2:16,0,1,1,9338.0,2:7,5500000
8474577,Joe,Colborne,1990-01-30,C,L,2015-16,73,19,25,44,0.6,-9,100,19.0,27,66425.0,15:9,85,70,155,54.84,122,28,27,32,-5,3,2,5,8908.0,2:2,0,0,0,1204.0,0:16,1275000
8474578,Erik,Karlsson,1990-05-31,D,R,2015-16,82,16,66,82,1.0,-2,248,6.45,50,142555.0,28:58,0,1,1,0.0,84,175,61,96,-35,1,25,26,22891.0,4:39,0,0,0,6538.0,1:19,6500000
8474579,Luca,Sbisa,1990-01-30,D,L,2015-16,41,2,6,8,0.2,5,29,6.9,26,42743.0,17:22,0,0,0,0.0,71,58,5,12,-7,0,0,0,200.0,0:4,0,1,1,4379.0,1:46,3600000
8474581,Jake,Gardiner,1990-07-04,D,L,2015-16,79,7,24,31,0.39,-15,122,5.74,32,97743.0,20:37,2,0,2,100.0,87,67,33,74,-41,1,11,12,11025.0,2:19,0,1,1,1673.0,0:21,4050000
8474584,Michael,Del Zotto,1990-06-24,D,L,2015-16,52,4,9,13,0.25,-8,98,4.08,16,73048.0,23:24,0,0,0,0.0,140,104,14,31,-17,0,1,1,4426.0,1:25,0,0,0,7880.0,2:31,3875000
8474586,Jordan,Eberle,1990-05-15,C,R,2015-16,69,25,22,47,0.68,-12,173,14.45,14,73924.0,17:51,5,3,8,62.5,28,23,30,41,-11,7,4,11,10924.0,2:38,0,0,0,105.0,0:1,6000000
8474588,Viktor,Tikhonov,1988-05-12,RW,R,2015-16,50,3,3,6,0.12,-10,41,7.32,20,34303.0,11:26,45,71,116,38.79,54,25,12,10,2,2,0,2,2124.0,0:42,0,0,0,279.0,0:5,1040000
8474589,Tyler,Ennis,1989-10-06,LW,L,2015-16,23,3,8,11,0.48,-9,57,5.26,11,24934.0,18:4,2,0,2,100.0,30,8,11,16,-5,2,2,4,3936.0,2:51,0,0,0,18.0,0:0,4600000
8474590,John,Carlson,1990-01-10,D,R,2015-16,56,8,31,39,0.7,16,124,6.45,14,79637.0,23:42,0,0,0,0.0,46,114,24,47,-23,2,12,14,11093.0,3:18,0,1,1,7328.0,2:10,3966667
8474597,Cody,Goloubef,1989-11-30,D,R,2015-16,43,1,7,8,0.19,-3,40,2.5,20,39027.0,15:7,0,0,0,0.0,31,48,3,11,-8,0,0,0,318.0,0:7,0,0,0,2181.0,0:50,750000
8474600,Roman,Josi,1990-06-01,D,L,2015-16,81,14,47,61,0.75,-3,198,7.07,43,123853.0,25:29,0,0,0,0.0,59,185,21,43,-22,6,18,24,14901.0,3:3,1,1,2,13112.0,2:41,4000000
8474602,Justin,Schultz,1990-07-06,D,R,2015-16,63,4,14,18,0.29,-15,82,4.88,16,69721.0,18:26,0,2,2,0.0,36,72,21,40,-19,2,6,8,8213.0,2:10,0,0,0,3085.0,0:48,3900000
8474604,Aaron,Ness,1990-05-18,D,L,2015-16,8,0,2,2,0.25,4,8,0.0,2,5946.0,12:23,0,0,0,0.0,4,7,0,2,-2,0,0,0,9.0,0:1,0,0,0,72.0,0:9,575000
8474605,Patrick,Wiercioch,1990-09-12,D,L,2015-16,52,0,5,5,0.1,2,56,0.0,24,54103.0,17:20,0,0,0,0.0,53,56,7,33,-26,0,2,2,1145.0,0:22,0,0,0,1774.0,0:34,2000000
8474610,Zac,Dalpe,1989-11-01,C,R,2015-16,2,1,0,1,0.5,0,3,33.33,0,1230.0,10:15,11,6,17,64.71,3,0,0,0,0,0,0,0,35.0,0:17,0,0,0,34.0,0:17,600000
8474612,Travis,Hamonic,1990-08-16,D,R,2015-16,72,5,16,21,0.29,-5,147,3.4,35,102918.0,23:49,0,0,0,0.0,148,128,44,61,-17,0,0,0,3588.0,0:49,1,0,1,9824.0,2:16,3857143
8474613,Derek,Stepan,1990-06-18,C,R,2015-16,72,22,31,53,0.74,5,192,11.46,20,76703.0,17:45,515,588,1103,46.69,38,39,62,30,32,5,9,14,10227.0,2:22,3,0,3,7395.0,1:42,6500000
8474616,Patrice,Cormier,1990-06-14,C,L,2015-16,2,0,0,0,0.0,0,1,0.0,0,539.0,4:29,3,6,9,33.33,1,0,0,0,0,0,0,0,44.0,0:22,0,0,0,0.0,0:0,650000
8474618,Marco,Scandella,1990-02-23,D,L,2015-16,73,5,16,21,0.29,6,126,3.97,22,90666.0,20:42,0,0,0,0.0,66,105,23,39,-16,2,1,3,2576.0,0:35,0,1,1,7943.0,1:48,4000000
8474625,Jimmy,Hayes,1989-11-21,RW,R,2015-16,75,13,16,29,0.39,-12,127,10.24,60,62219.0,13:49,42,70,112,37.5,128,15,25,28,-3,3,2,5,5829.0,1:17,0,0,0,14.0,0:0,2300000
8474627,Jori,Lehtera,1987-12-23,C,L,2015-16,79,9,25,34,0.43,12,83,10.84,38,76232.0,16:4,485,484,969,50.05,43,26,29,19,10,1,8,9,8786.0,1:51,0,0,0,3900.0,0:49,2750000
8474628,Michael,Stone,1990-06-07,D,R,2015-16,75,6,30,36,0.48,-10,161,3.73,62,101099.0,22:27,0,2,2,0.0,137,143,15,20,-5,0,14,14,13022.0,2:53,0,0,0,9484.0,2:6,1150000
8474638,Andrew,Campbell,1988-02-04,D,L,2015-16,6,0,1,1,0.17,0,1,0.0,2,4170.0,11:35,0,0,0,0.0,5,10,1,1,0,0,0,0,3.0,0:0,0,0,0,138.0,0:23,575000
8474641,Adam,Henrique,1990-02-06,C,L,2015-16,80,30,20,50,0.62,10,149,20.13,23,95167.0,19:49,617,764,1381,44.68,66,56,38,27,11,7,5,12,12886.0,2:41,2,1,3,12636.0,2:37,4000000
8474642,Lance,Bouma,1990-03-25,LW,L,2015-16,44,2,5,7,0.16,-6,49,4.08,31,31774.0,12:2,5,8,13,38.46,110,42,6,10,-4,0,0,0,87.0,0:1,0,2,2,4784.0,1:48,2200000
8474660,David,Warsofsky,1990-05-30,D,L,2015-16,22,1,1,2,0.09,-9,40,2.5,2,22603.0,17:7,0,0,0,0.0,5,23,4,17,-13,1,1,2,2853.0,2:9,0,0,0,70.0,0:3,600000
8474661,Michal,Jordan,1990-07-17,D,L,2015-16,36,1,0,1,0.03,-5,36,2.78,12,32768.0,15:10,0,0,0,0.0,24,34,6,8,-2,0,0,0,155.0,0:4,0,0,0,1137.0,0:31,625000
8474668,Dale,Weise,1988-08-05,RW,R,2015-16,71,14,13,27,0.38,4,136,10.29,24,57147.0,13:24,16,19,35,45.71,127,26,18,16,2,3,3,6,6011.0,1:24,0,0,0,740.0,0:10,1025000
8474673,TJ,Brodie,1990-06-07,D,L,2015-16,70,6,39,45,0.64,4,79,7.59,18,106094.0,25:15,0,0,0,0.0,15,104,47,91,-44,2,7,9,9764.0,2:19,0,2,2,10908.0,2:35,4650400
8474679,Gustav,Nyquist,1989-09-01,RW,L,2015-16,82,17,26,43,0.52,-2,161,10.56,34,74638.0,15:10,0,2,2,0.0,58,19,28,26,2,7,5,12,13719.0,2:47,0,0,0,67.0,0:0,4750000
8474683,Derek,Grant,1990-04-20,C,L,2015-16,15,0,1,1,0.07,-7,22,0.0,2,9791.0,10:52,61,50,111,54.95,25,11,3,1,2,0,0,0,236.0,0:15,0,0,0,877.0,0:58,700000
8474685,Matt,Calvert,1989-12-24,LW,L,2015-16,73,11,13,24,0.33,1,114,9.65,51,66261.0,15:7,7,7,14,50.0,91,46,36,10,26,1,0,1,719.0,0:9,0,0,0,9342.0,2:7,2200000
8474688,Greg,Pateryn,1990-06-20,D,R,2015-16,38,1,6,7,0.18,-8,32,3.12,49,38187.0,16:44,0,0,0,0.0,100,52,12,31,-19,0,0,0,547.0,0:14,0,0,0,3026.0,1:19,562500
8474697,Mark,Borowiecki,1989-07-12,D,L,2015-16,63,1,1,2,0.03,-4,27,3.7,107,55290.0,14:37,0,1,1,0.0,271,99,3,22,-19,0,0,0,104.0,0:1,0,0,0,8905.0,2:21,1100000
8474698,Brent,Regner,1989-05-17,D,R,2015-16,7,0,0,0,0.0,-2,7,0.0,4,4865.0,11:35,0,0,0,0.0,4,7,0,1,-1,0,0,0,19.0,0:2,0,0,0,136.0,0:19,600000
8474709,Matt,Martin,1989-05-08,LW,L,2015-16,80,10,9,19,0.24,2,86,11.63,119,50671.0,10:33,1,3,4,25.0,365,24,8,15,-7,0,0,0,429.0,0:5,0,0,0,213.0,0:2,1000000
8474715,Cam,Atkinson,1989-06-05,RW,R,2015-16,81,27,26,53,0.65,-8,226,11.95,22,86499.0,17:47,2,2,4,50.0,47,40,43,18,25,4,6,10,10949.0,2:15,2,0,2,9123.0,1:52,3500000
8474716,Jared,Spurgeon,1989-11-29,D,R,2015-16,77,11,18,29,0.38,11,122,9.02,14,104775.0,22:40,0,0,0,0.0,51,157,19,22,-3,5,8,13,8173.0,1:46,0,3,3,8132.0,1:45,2666667
8474717,Mark,Barberio,1990-03-23,D,L,2015-16,30,2,8,10,0.33,0,32,6.25,6,26996.0,14:59,0,0,0,0.0,12,18,11,19,-8,0,0,0,1296.0,0:43,0,0,0,685.0,0:22,600000
8474722,Luke,Witkowski,1990-04-14,RW,R,2015-16,4,0,0,0,0.0,0,1,0.0,4,1711.0,7:7,0,0,0,0.0,8,1,0,1,-1,0,0,0,0.0,0:0,0,0,0,0.0,0:0,575000
8474727,Ben,Smith,1988-07-11,RW,R,2015-16,22,2,4,6,0.27,2,17,11.76,0,15962.0,12:5,100,85,185,54.05,18,16,8,3,5,0,0,0,120.0,0:5,0,0,0,2184.0,1:39,1500000
8474736,Zac,Rinaldo,1990-06-15,C,L,2015-16,52,1,2,3,0.06,-5,38,2.63,83,25883.0,8:17,0,1,1,0.0,154,15,8,9,-1,0,0,0,83.0,0:1,0,0,0,558.0,0:10,850000
8474739,Tommy,Wingels,1988-04-12,C,R,2015-16,68,7,11,18,0.26,-10,111,6.31,63,55630.0,13:38,38,55,93,40.86,203,54,21,30,-9,1,2,3,2799.0,0:41,0,2,2,4611.0,1:7,2475000
8474743,Zach,Redmond,1988-07-26,D,R,2015-16,37,2,4,6,0.16,5,22,9.09,10,26149.0,11:46,0,0,0,0.0,47,39,6,12,-6,1,0,1,133.0,0:3,0,0,0,516.0,0:13,750000
8474749,Matt,Bartkowski,1988-06-04,D,L,2015-16,80,6,12,18,0.22,-19,85,7.06,50,89372.0,18:37,0,0,0,0.0,141,42,18,49,-31,0,0,0,1161.0,0:14,0,0,0,6018.0,1:15,1750000
8474774,Dalton,Prout,1990-03-13,D,R,2015-16,64,3,6,9,0.14,-6,69,4.35,102,62103.0,16:10,0,1,1,0.0,139,70,7,25,-18,0,0,0,237.0,0:3,0,0,0,4847.0,1:15,1075000
8474818,Jordie,Benn,1987-07-26,D,L,2015-16,64,3,9,12,0.19,2,58,5.17,21,60107.0,15:39,0,0,0,0.0,90,94,12,39,-27,1,0,1,1019.0,0:15,0,1,1,7449.0,1:56,700000
8474849,Antoine,Roussel,1989-11-21,LW,L,2015-16,80,13,16,29,0.36,11,111,11.71,123,66514.0,13:51,15,20,35,42.86,123,58,30,24,6,0,1,1,2098.0,0:26,0,1,1,6362.0,1:19,2000000
8474850,Brandon,Mashinter,1988-09-20,LW,L,2015-16,41,4,1,5,0.12,-7,25,16.0,23,18431.0,7:29,0,0,0,0.0,62,3,6,7,-1,0,0,0,68.0,0:1,0,0,0,0.0,0:0,562500
8474870,Tyler,Johnson,1990-07-29,C,R,2015-16,69,14,24,38,0.55,4,167,8.38,20,70957.0,17:8,479,507,986,48.58,46,25,19,31,-12,3,10,13,11355.0,2:44,0,0,0,2560.0,0:37,3333333
8474884,Mike,Hoffman,1989-11-24,LW,L,2015-16,78,29,30,59,0.76,1,242,11.98,18,82102.0,17:32,8,10,18,44.44,22,29,44,45,-1,9,4,13,11437.0,2:26,0,0,0,187.0,0:2,2000000
8475060,Matt,Taormina,1986-10-20,D,L,2015-16,3,0,0,0,0.0,0,2,0.0,0,2507.0,13:55,0,0,0,0.0,1,3,0,2,-2,0,0,0,127.0,0:42,0,0,0,22.0,0:7,600000
8475098,Tyler,Bozak,1986-03-19,C,R,2015-16,57,12,23,35,0.61,-9,99,12.12,18,59308.0,17:20,597,462,1059,56.37,46,24,33,18,15,3,7,10,9248.0,2:42,0,0,0,694.0,0:12,4200000
8475119,Zach,Sill,1988-05-24,C,L,2015-16,10,1,0,1,0.1,0,13,7.69,2,5960.0,9:56,33,44,77,42.86,20,6,4,3,1,0,0,0,34.0,0:3,0,0,0,438.0,0:43,575000
8475147,Jordan,Schroeder,1990-09-29,LW,R,2015-16,26,2,2,4,0.15,2,30,6.67,2,14689.0,9:24,1,2,3,33.33,15,13,1,6,-5,0,0,0,389.0,0:14,0,0,0,26.0,0:1,600000
8475149,Marcus,Johansson,1990-10-06,LW,L,2015-16,74,17,29,46,0.62,12,132,12.88,16,73880.0,16:38,128,150,278,46.04,38,24,35,39,-4,6,8,14,12158.0,2:44,0,0,0,219.0,0:2,3750000
8475150,Jordan,Caron,1990-11-02,RW,L,2015-16,4,0,0,0,0.0,-3,1,0.0,0,1950.0,8:7,0,0,0,0.0,6,0,0,0,0,0,0,0,0.0,0:0,0,0,0,1.0,0:0,600000
8475151,Kyle,Palmieri,1991-02-01,RW,R,2015-16,82,30,27,57,0.7,3,222,13.51,39,87600.0,17:48,10,17,27,37.04,129,51,43,35,8,11,12,23,12935.0,2:37,0,0,0,3132.0,0:38,1466667
8475153,Dylan,Olsen,1991-01-03,D,L,2015-16,8,0,1,1,0.12,-1,9,0.0,2,6601.0,13:45,0,0,0,0.0,6,7,0,1,-1,0,0,0,32.0,0:4,0,0,0,4.0,0:0,775000
8475155,Simon,Despres,1991-07-27,D,L,2015-16,32,0,4,4,0.12,2,32,0.0,8,37685.0,19:37,0,0,0,0.0,67,71,11,27,-16,0,1,1,446.0,0:13,0,0,0,4322.0,2:15,900000
8475157,Landon,Ferraro,1991-08-08,C,R,2015-16,68,5,5,10,0.15,-11,77,6.49,27,43294.0,10:36,29,57,86,33.72,101,29,16,17,-1,0,0,0,217.0,0:3,0,0,0,5446.0,1:20,600000
8475158,Ryan,O'Reilly,1991-02-07,C,L,2015-16,71,21,39,60,0.85,-16,157,13.38,8,92591.0,21:44,1024,788,1812,56.51,17,43,47,28,19,8,14,22,13918.0,3:16,1,0,1,8909.0,2:5,6000000
8475160,Kyle,Clifford,1991-01-13,LW,L,2015-16,56,3,6,9,0.16,-1,68,4.41,55,31415.0,9:20,3,4,7,42.86,111,11,5,6,-1,0,0,0,223.0,0:3,0,0,0,333.0,0:5,1600000
8475161,Chris,Brown,1991-02-03,RW,R,2015-16,1,0,0,0,0.0,0,1,0.0,0,461.0,7:41,0,0,0,0.0,2,0,0,0,0,0,0,0,0.0,0:0,0,0,0,0.0,0:0,575000
8475163,Alex,Chiasson,1990-10-01,RW,R,2015-16,77,8,6,14,0.18,2,88,9.09,45,63005.0,13:38,3,2,5,60.0,103,28,26,16,10,2,0,2,5073.0,1:5,1,0,1,6977.0,1:30,1200000
8475164,Jakob,Silfverberg,1990-10-13,RW,R,2015-16,82,20,19,39,0.48,8,215,9.3,32,83514.0,16:58,4,16,20,20.0,87,58,44,39,5,2,2,4,4211.0,0:51,0,1,1,11847.0,2:24,3750000
8475165,Anton,Lander,1991-04-24,C,L,2015-16,61,1,2,3,0.05,-9,54,1.85,18,44221.0,12:4,378,315,693,54.55,58,19,23,18,5,0,0,0,2991.0,0:49,0,0,0,7103.0,1:56,987500
8475166,John,Tavares,1990-09-20,C,L,2015-16,78,33,37,70,0.9,6,250,13.2,38,93574.0,19:59,741,629,1370,54.09,51,29,69,82,-13,7,12,19,14762.0,3:9,0,0,0,209.0,0:2,5500000
8475167,Victor,Hedman,1990-12-18,D,L,2015-16,78,10,37,47,0.6,21,180,5.56,46,107950.0,23:3,0,0,0,0.0,62,132,48,62,-14,1,10,11,12224.0,2:36,0,1,1,9363.0,2:0,4000000
8475168,Matt,Duchene,1991-01-16,C,L,2015-16,76,30,29,59,0.78,-8,200,15.0,24,84773.0,18:35,428,311,739,57.92,41,37,43,31,12,8,7,15,12779.0,2:48,0,0,0,900.0,0:11,6000000
8475169,Evander,Kane,1991-08-02,LW,L,2015-16,65,20,15,35,0.54,-14,271,7.38,91,82045.0,21:2,62,62,124,50.0,171,23,37,37,0,2,4,6,9967.0,2:33,1,0,1,4325.0,1:6,5250000
8475170,Brayden,Schenn,1991-08-22,C,L,2015-16,80,26,33,59,0.74,3,178,14.61,33,81091.0,16:53,52,64,116,44.83,187,30,30,35,-5,11,11,22,16934.0,3:31,0,0,0,48.0,0:0,2500000
8475171,Oliver,Ekman-Larsson,1991-07-17,D,L,2015-16,75,21,34,55,0.73,-6,228,9.21,96,111463.0,24:46,0,0,0,0.0,154,67,40,39,1,12,15,27,23292.0,5:10,0,0,0,3232.0,0:43,5500000
8475172,Nazem,Kadri,1990-10-06,C,L,2015-16,76,17,28,45,0.59,-15,260,6.54,73,83327.0,18:16,641,663,1304,49.16,148,43,47,41,6,4,10,14,12162.0,2:40,0,0,0,336.0,0:4,4100000
8475174,Jared,Cowen,1991-01-25,D,L,2015-16,37,0,4,4,0.11,7,23,0.0,16,37694.0,16:58,0,0,0,0.0,116,58,7,34,-27,0,0,0,52.0,0:1,0,0,0,5531.0,2:29,3100000
8475175,Magnus,Paajarvi,1991-04-12,LW,L,2015-16,48,3,6,9,0.19,-9,88,3.41,8,37008.0,12:51,0,2,2,0.0,44,16,8,4,4,0,0,0,372.0,0:7,0,0,0,626.0,0:13,700000
8475176,Ryan,Ellis,1991-01-03,D,R,2015-16,79,10,22,32,0.41,13,152,6.58,35,99059.0,20:53,0,0,0,0.0,61,100,24,23,1,3,4,7,9836.0,2:4,1,0,1,6957.0,1:28,2500000
8475177,Calvin,de Haan,1991-05-09,D,L,2015-16,72,2,14,16,0.22,3,102,1.96,20,89134.0,20:37,0,1,1,0.0,128,198,19,57,-38,0,1,1,1020.0,0:14,0,0,0,9694.0,2:14,1966667
8475178,Zack,Kassian,1991-01-24,RW,R,2015-16,36,3,5,8,0.22,-7,42,7.14,114,26896.0,12:27,1,3,4,25.0,95,6,11,15,-4,0,0,0,504.0,0:14,0,0,0,392.0,0:10,1750000
8475179,Dmitry,Kulikov,1990-10-29,D,L,2015-16,74,1,16,17,0.23,8,99,1.01,51,93393.0,21:2,0,0,0,0.0,122,121,31,54,-23,0,6,6,6207.0,1:23,0,0,0,10523.0,2:22,4333333
8475180,Peter,Holland,1991-01-14,C,L,2015-16,65,9,18,27,0.42,-16,138,6.52,28,57197.0,14:39,216,249,465,46.45,78,19,34,21,13,5,6,11,9677.0,2:28,0,0,0,1158.0,0:17,775000
8475181,Nick,Leddy,1991-03-20,D,L,2015-16,81,5,35,40,0.49,-9,121,4.13,25,109929.0,22:37,0,0,0,0.0,83,87,40,52,-12,3,16,19,13357.0,2:44,0,0,0,2226.0,0:27,5500000
8475182,David,Rundblad,1990-10-08,D,R,2015-16,9,0,2,2,0.22,-2,13,0.0,6,7761.0,14:22,0,0,0,0.0,3,3,4,12,-8,0,2,2,1122.0,2:4,0,0,0,13.0,0:1,1050000
8475184,Chris,Kreider,1991-04-30,LW,L,2015-16,79,21,22,43,0.54,10,158,13.29,58,75636.0,15:57,5,1,6,83.33,177,33,23,37,-14,5,3,8,11350.0,2:23,0,0,0,30.0,0:0,2475000
8475185,Jacob,Josefson,1991-03-02,C,L,2015-16,58,4,10,14,0.24,-21,86,4.65,20,54017.0,15:31,323,344,667,48.43,67,40,19,18,1,3,8,11,8590.0,2:28,0,1,1,5427.0,1:33,800000
8475186,John,Moore,1990-11-19,D,L,2015-16,73,4,15,19,0.26,-12,106,3.77,28,86891.0,19:50,0,0,0,0.0,93,83,23,42,-19,1,5,6,6617.0,1:30,0,0,0,8809.0,2:0,1666667
8475188,Brayden,McNabb,1991-01-21,D,L,2015-16,81,2,12,14,0.17,11,91,2.2,92,91441.0,18:48,0,0,0,0.0,206,95,19,56,-37,0,1,1,1432.0,0:17,0,1,1,8400.0,1:43,650000
8475191,Reilly,Smith,1991-04-01,RW,L,2015-16,82,25,25,50,0.61,19,173,14.45,31,91566.0,18:36,0,2,2,0.0,85,39,51,31,20,5,6,11,12640.0,2:34,0,1,1,11237.0,2:17,3425000
8475193,Tomas,Tatar,1990-12-01,LW,L,2015-16,81,21,24,45,0.56,4,165,12.73,24,69747.0,14:21,6,18,24,25.0,74,18,30,24,6,7,8,15,11508.0,2:22,0,0,0,24.0,0:0,2750000
8475194,Philip,Samuelsson,1991-07-26,D,L,2015-16,4,0,0,0,0.0,0,5,0.0,2,3813.0,15:53,0,0,0,0.0,3,11,1,1,0,0,0,0,22.0,0:5,0,0,0,621.0,2:35,600000
8475197,Tyson,Barrie,1991-07-26,D,R,2015-16,78,13,36,49,0.63,-16,172,7.56,31,108574.0,23:11,0,0,0,0.0,37,84,29,59,-30,3,18,21,14662.0,3:7,1,1,2,2369.0,0:30,2600000
8475199,Eric,Gelinas,1991-05-08,D,L,2015-16,40,1,5,6,0.15,-6,55,1.82,16,33203.0,13:50,0,0,0,0.0,61,23,7,20,-13,1,3,4,3219.0,1:20,0,0,0,193.0,0:4,1575000
8475200,Dmitry,Orlov,1991-07-23,D,L,2015-16,82,8,21,29,0.35,8,90,8.89,26,78850.0,16:1,0,0,0,0.0,121,61,37,41,-4,0,2,2,2555.0,0:31,0,0,0,681.0,0:8,2000000
8475204,Brandon,Pirri,1991-04-10,RW,L,2015-16,61,14,15,29,0.48,-4,128,10.94,30,53130.0,14:30,66,77,143,46.15,66,14,20,26,-6,3,7,10,7888.0,2:9,0,0,0,119.0,0:1,925000
8475206,Stefan,Elliott,1991-01-30,D,R,2015-16,21,2,4,6,0.29,-3,37,5.41,4,17850.0,14:10,0,0,0,0.0,12,18,4,5,-1,0,0,0,1396.0,1:6,0,0,0,149.0,0:7,650000
8475208,Brian,Dumoulin,1991-09-06,D,L,2015-16,79,0,16,16,0.2,11,101,0.0,14,89518.0,18:53,1,0,1,100.0,77,68,32,36,-4,0,0,0,2160.0,0:27,0,0,0,6158.0,1:17,800000
8475209,Richard,Panik,1991-02-07,RW,L,2015-16,30,6,2,8,0.27,4,39,15.38,6,19501.0,10:50,1,1,2,50.0,54,11,6,8,-2,0,0,0,519.0,0:17,0,0,0,0.0,0:0,975000
8475213,Drew,Shore,1991-01-29,C,R,2015-16,2,0,1,1,0.5,0,3,0.0,2,1679.0,13:59,4,6,10,40.0,0,1,1,0,1,0,0,0,22.0,0:11,0,0,0,346.0,2:53,850500
8475218,Mattias,Ekholm,1990-05-24,D,L,2015-16,82,8,27,35,0.43,14,114,7.02,44,99589.0,20:14,0,0,0,0.0,67,106,26,54,-28,1,4,5,5589.0,1:8,1,1,2,8455.0,1:43,1037500
8475220,Marcus,Foligno,1991-08-10,LW,L,2015-16,75,10,13,23,0.31,4,81,12.35,79,59330.0,13:11,1,3,4,25.0,193,44,30,17,13,0,2,2,963.0,0:12,2,0,2,1815.0,0:24,1875000
8475222,Sami,Vatanen,1991-06-03,D,R,2015-16,71,9,29,38,0.54,8,140,6.43,20,90797.0,21:18,0,0,0,0.0,85,105,34,54,-20,4,15,19,12243.0,2:52,0,0,0,9546.0,2:14,1262500
8475223,Linden,Vey,1991-07-17,RW,R,2015-16,41,4,11,15,0.37,-14,40,10.0,6,38749.0,15:45,193,256,449,42.98,4,9,16,16,0,3,2,5,5594.0,2:16,0,0,0,1431.0,0:34,1000000
8475225,Craig,Smith,1989-09-05,RW,R,2015-16,82,21,16,37,0.45,4,199,10.55,40,74709.0,15:11,76,154,230,33.04,84,18,42,44,-2,2,3,5,10449.0,2:7,0,0,0,162.0,0:1,4250000
8475227,Chris,Wideman,1990-01-07,D,R,2015-16,64,6,7,13,0.2,4,87,6.9,34,53569.0,13:57,0,0,0,0.0,57,71,5,29,-24,1,1,2,2360.0,0:36,0,0,0,419.0,0:6,600000
8475231,Casey,Cizikas,1991-02-27,C,L,2015-16,80,8,21,29,0.36,4,84,9.52,31,60873.0,12:40,469,490,959,48.91,158,62,58,23,35,0,0,0,386.0,0:4,1,2,3,10488.0,2:11,1000000
8475233,David,Savard,1990-10-22,D,R,2015-16,65,4,21,25,0.38,-7,122,3.28,45,90373.0,23:10,0,0,0,0.0,122,111,14,14,0,1,4,5,8301.0,2:7,0,1,1,11394.0,2:55,1300000
8475235,Nicolas,Deslauriers,1991-02-22,LW,L,2015-16,70,6,6,12,0.17,-14,72,8.33,59,43379.0,10:19,0,1,1,0.0,206,30,14,8,6,0,0,0,207.0,0:2,0,0,0,439.0,0:6,637500
8475236,Cody,Eakin,1991-05-24,C,L,2015-16,82,16,19,35,0.43,3,132,12.12,42,80531.0,16:22,567,621,1188,47.73,98,47,42,46,-4,2,2,4,6709.0,1:21,3,1,4,7714.0,1:34,1900000
8475246,Kevin,Connauton,1990-02-23,D,L,2015-16,65,5,12,17,0.26,7,109,4.59,60,65278.0,16:44,0,0,0,0.0,100,58,15,13,2,0,3,3,5067.0,1:17,0,0,0,1670.0,0:25,683333
8475247,Michael,Latta,1991-05-25,C,R,2015-16,43,3,4,7,0.16,0,29,10.34,50,20861.0,8:5,102,96,198,51.52,58,10,8,4,4,0,0,0,52.0,0:1,0,0,0,59.0,0:1,575000
8475250,Andrej,Nestrasil,1991-02-22,C,L,2015-16,55,9,14,23,0.42,4,105,8.57,8,47358.0,14:21,8,17,25,32.0,27,13,29,16,13,2,0,2,4238.0,1:17,0,0,0,12.0,0:0,912500
8475253,Garrett,Wilson,1991-03-16,LW,L,2015-16,29,0,0,0,0.0,-3,28,0.0,24,16308.0,9:22,0,1,1,0.0,75,4,2,2,0,0,0,0,220.0,0:7,0,0,0,0.0,0:0,675000
8475260,Corban,Knight,1990-09-10,C,R,2015-16,20,2,5,7,0.35,3,11,18.18,4,11558.0,9:37,54,52,106,50.94,18,2,6,1,5,0,0,0,126.0,0:6,0,0,0,65.0,0:3,750000
8475268,Gabriel,Bourque,1990-09-23,LW,L,2015-16,22,1,3,4,0.18,0,25,4.0,18,16321.0,12:21,0,1,1,0.0,55,22,3,5,-2,0,0,0,372.0,0:16,0,0,0,2746.0,2:4,866250
8475274,Seth,Helgeson,1990-10-08,D,L,2015-16,19,0,1,1,0.05,-5,9,0.0,17,15910.0,13:57,0,0,0,0.0,46,23,2,8,-6,0,0,0,2.0,0:0,0,0,0,566.0,0:29,587500
8475278,Byron,Froese,1991-03-12,C,R,2015-16,56,2,3,5,0.09,-11,64,3.12,16,42424.0,12:37,310,332,642,48.29,51,23,20,10,10,0,0,0,923.0,0:16,0,0,0,8719.0,2:35,575000
8475279,Ben,Chiarot,1991-05-09,D,L,2015-16,70,1,9,10,0.14,-9,74,1.35,43,60723.0,14:27,0,0,0,0.0,130,105,15,34,-19,0,0,0,217.0,0:3,0,0,0,3245.0,0:46,850000
8475287,Erik,Haula,1991-03-23,LW,L,2015-16,76,14,20,34,0.45,21,99,14.14,24,58036.0,12:43,416,365,781,53.27,57,55,34,13,21,0,1,1,394.0,0:5,2,2,4,7959.0,1:44,1000000
8475292,Tyler,Randell,1991-06-15,RW,R,2015-16,27,6,0,6,0.22,-2,18,33.33,47,11312.0,6:58,0,0,0,0.0,39,8,6,1,5,0,0,0,9.0,0:0,0,0,0,0.0,0:0,600000
8475310,Curtis,McKenzie,1991-02-22,LW,L,2015-16,3,0,0,0,0.0,-1,3,0.0,0,1584.0,8:48,0,0,0,0.0,4,1,1,0,1,0,0,0,0.0,0:0,0,0,0,22.0,0:7,675000
8475314,Anders,Lee,1990-07-03,LW,L,2015-16,80,15,21,36,0.45,-2,183,8.2,51,69967.0,14:34,1,5,6,16.67,164,31,32,21,11,8,6,14,11951.0,2:29,0,0,0,121.0,0:1,3750000
8475321,Phil,Varone,1990-12-04,C,L,2015-16,6,1,2,3,0.5,2,2,50.0,2,3063.0,8:30,10,8,18,55.56,4,6,1,0,1,0,0,0,0.0,0:0,0,0,0,0.0,0:0,600000
8475323,Marcus,Kruger,1990-05-27,C,L,2015-16,41,0,4,4,0.1,-5,50,0.0,24,33262.0,13:31,233,241,474,49.16,25,31,10,4,6,0,0,0,213.0,0:5,0,0,0,5857.0,2:22,1500000
8475325,Jordan,Nolan,1989-06-23,C,L,2015-16,52,0,5,5,0.1,0,49,0.0,38,27759.0,8:53,0,1,1,0.0,78,8,4,8,-4,0,0,0,183.0,0:3,0,0,0,77.0,0:1,950000
8475343,Nic,Dowd,1990-05-27,C,R,2015-16,5,0,0,0,0.0,1,3,0.0,2,3173.0,10:34,18,16,34,52.94,6,0,3,3,0,0,0,0,134.0,0:26,0,0,0,139.0,0:27,600000
8475414,Craig,Cunningham,1990-09-13,LW,R,2015-16,10,0,1,1,0.1,-1,13,0.0,2,6050.0,10:5,2,1,3,66.67,15,4,2,1,1,0,0,0,50.0,0:5,0,0,0,57.0,0:5,700000
8475430,Brandon,Manning,1990-06-04,D,L,2015-16,56,1,6,7,0.12,2,67,1.49,66,55533.0,16:31,0,1,1,0.0,94,57,7,19,-12,0,0,0,1089.0,0:19,0,0,0,3859.0,1:8,625000
8475455,Brenden,Dillon,1990-11-13,D,L,2015-16,76,2,9,11,0.14,8,93,2.15,61,76097.0,16:41,0,0,0,0.0,154,89,12,42,-30,0,0,0,493.0,0:6,0,0,0,4559.0,0:59,3270000
8475461,Andrew,Agozzino,1991-01-03,LW,L,2015-16,9,0,2,2,0.22,-1,3,0.0,0,4623.0,8:33,24,21,45,53.33,8,4,0,1,-1,0,1,1,136.0,0:15,0,0,0,0.0,0:0,600000
8475462,Radko,Gudas,1990-06-05,D,R,2015-16,76,5,9,14,0.18,-3,150,3.33,116,90487.0,19:50,0,0,0,0.0,304,157,11,57,-46,0,0,0,706.0,0:9,0,0,0,12406.0,2:43,991667
8475613,Nate,Prosser,1986-05-07,D,R,2015-16,54,0,3,3,0.06,1,20,0.0,39,36882.0,11:23,0,0,0,0.0,34,73,5,16,-11,0,0,0,40.0,0:0,0,1,1,4087.0,1:15,625000
8475625,Matt,Irwin,1987-11-29,D,L,2015-16,2,0,0,0,0.0,-5,3,0.0,0,1792.0,14:56,0,0,0,0.0,1,0,0,0,0,0,0,0,124.0,1:2,0,0,0,135.0,1:7,800000
8475650,Brandon,Bollig,1987-01-31,LW,L,2015-16,54,2,2,4,0.07,-10,56,3.57,103,30099.0,9:17,2,1,3,66.67,117,25,11,8,3,0,0,0,173.0,0:3,0,0,0,56.0,0:1,1250000
8475661,Dave,Dziurzynski,1989-10-06,LW,L,2015-16,14,1,3,4,0.29,-4,14,7.14,9,8465.0,10:4,3,4,7,42.86,55,7,2,2,0,0,0,0,0.0,0:0,0,0,0,185.0,0:13,750000
8475690,Christopher,Tanev,1989-12-20,D,R,2015-16,69,4,14,18,0.26,-8,42,9.52,8,90060.0,21:45,0,0,0,0.0,18,166,14,39,-25,2,1,3,5546.0,1:20,0,1,1,11476.0,2:46,4450000
8475692,Mats,Zuccarello,1987-09-01,RW,L,2015-16,81,26,35,61,0.75,2,166,15.66,34,89796.0,18:28,5,6,11,45.45,88,69,59,43,16,7,11,18,13154.0,2:42,0,0,0,594.0,0:7,4500000
8475714,Calle,Jarnkrok,1991-09-25,C,R,2015-16,81,16,14,30,0.37,1,125,12.8,14,78418.0,16:8,366,433,799,45.81,35,24,32,19,13,3,1,4,3256.0,0:40,1,0,1,9511.0,1:57,735000
8475715,Oscar,Lindberg,1991-10-29,C,L,2015-16,68,13,15,28,0.41,12,114,11.4,43,49681.0,12:10,134,143,277,48.38,132,36,16,14,2,1,2,3,3323.0,0:48,0,0,0,1360.0,0:20,650000
8475716,Martin,Marincin,1992-02-18,D,L,2015-16,65,1,6,7,0.11,-3,55,1.82,34,65400.0,16:46,0,0,0,0.0,37,63,25,41,-16,0,0,0,489.0,0:7,0,0,0,9178.0,2:21,700000
8475722,Jason,Zucker,1992-01-16,LW,L,2015-16,71,13,10,23,0.32,-4,158,8.23,20,66367.0,15:34,1,0,1,100.0,83,33,40,27,13,0,2,2,3920.0,0:55,1,1,2,2119.0,0:29,900250
8475726,Tyler,Toffoli,1992-04-24,C,R,2015-16,82,31,27,58,0.71,35,213,14.55,20,85179.0,17:18,0,4,4,0.0,70,19,32,38,-6,9,2,11,10316.0,2:5,1,0,1,6339.0,1:17,3250000
8475727,Ryan,Spooner,1992-01-30,C,L,2015-16,80,13,36,49,0.61,-9,162,8.02,35,72677.0,15:8,304,407,711,42.76,53,19,25,35,-10,6,11,17,13371.0,2:47,0,0,0,728.0,0:9,950000
8475728,Johan,Larsson,1992-07-25,C,L,2015-16,74,10,7,17,0.23,-4,95,10.53,27,65799.0,14:49,388,371,759,51.12,113,33,21,16,5,1,3,4,4267.0,0:57,0,0,0,1473.0,0:19,800000
8475730,Stephen,Johns,1992-04-18,D,R,2015-16,14,1,2,3,0.21,-6,13,7.69,6,14977.0,17:49,0,0,0,0.0,55,21,6,11,-5,0,0,0,238.0,0:17,0,0,0,300.0,0:21,800000
8475735,Greg,McKegg,1992-06-17,C,L,2015-16,15,2,0,2,0.13,1,14,14.29,2,7432.0,8:15,50,61,111,45.05,20,6,4,1,3,0,0,0,70.0,0:4,0,0,0,234.0,0:15,700000
8475736,Connor,Brickley,1992-02-25,C,L,2015-16,23,1,4,5,0.22,1,13,7.69,14,12041.0,8:43,0,0,0,0.0,46,6,4,3,1,0,0,0,192.0,0:8,0,0,0,2.0,0:0,592500
8475738,Jordan,Weal,1992-04-15,C,R,2015-16,14,0,0,0,0.0,1,4,0.0,2,7863.0,9:21,33,35,68,48.53,5,2,5,4,1,0,0,0,577.0,0:41,0,0,0,44.0,0:3,632500
8475744,Evgeny,Kuznetsov,1992-05-19,C,L,2015-16,82,20,57,77,0.94,27,193,10.36,32,85683.0,17:24,543,594,1137,47.76,73,29,61,54,7,5,13,18,10813.0,2:11,0,0,0,160.0,0:1,3000000
8475745,Charlie,Coyle,1992-03-02,C,R,2015-16,82,21,21,42,0.51,1,140,15.0,16,85152.0,17:18,228,274,502,45.42,131,61,36,30,6,2,4,6,9381.0,1:54,0,1,1,2690.0,0:32,3200000
8475747,Patrik,Nemeth,1992-02-08,D,L,2015-16,38,0,8,8,0.21,-1,36,0.0,14,35660.0,15:38,0,0,0,0.0,58,47,5,19,-14,0,1,1,173.0,0:4,0,0,0,2464.0,1:4,900000
8475749,Christian,Thomas,1992-05-26,LW,R,2015-16,6,0,2,2,0.33,1,9,0.0,2,3218.0,8:56,0,0,0,0.0,5,1,1,1,0,0,0,0,27.0,0:4,0,0,0,0.0,0:0,600000
8475750,Jon,Merrill,1992-02-03,D,L,2015-16,47,1,4,5,0.11,-15,30,3.33,28,47648.0,16:53,0,0,0,0.0,48,54,7,17,-10,0,1,1,324.0,0:6,0,0,0,3566.0,1:15,840000
8475753,Justin,Faulk,1992-03-20,D,R,2015-16,64,16,21,37,0.58,-22,184,8.7,27,92331.0,24:2,0,1,1,0.0,109,65,45,42,3,12,5,17,12326.0,3:12,0,0,0,7278.0,1:53,4833333
8475754,Brock,Nelson,1991-10-15,C,L,2015-16,81,26,14,40,0.49,-3,165,15.76,30,76804.0,15:48,186,202,388,47.94,59,50,48,24,24,3,2,5,8618.0,1:46,0,0,0,2292.0,0:28,2500000
8475755,Alex,Petrovic,1992-03-03,D,R,2015-16,66,2,15,17,0.26,17,53,3.77,90,67144.0,16:57,0,0,0,0.0,157,76,9,24,-15,0,0,0,629.0,0:9,0,1,1,7040.0,1:46,1050000
8475756,John,McFarland,1992-04-02,LW,R,2015-16,3,0,0,0,0.0,-1,2,0.0,0,1784.0,9:54,0,0,0,0.0,5,3,0,1,-1,0,0,0,47.0,0:15,0,0,0,0.0,0:0,850500
8475757,Brett,Bulmer,1992-04-26,RW,R,2015-16,3,0,0,0,0.0,-1,2,0.0,7,1209.0,6:43,0,0,0,0.0,2,0,0,0,0,0,0,0,0.0,0:0,0,0,0,19.0,0:6,600000
8475758,Devante,Smith-Pelly,1992-06-14,RW,R,2015-16,64,14,11,25,0.39,-3,94,14.89,30,47203.0,12:17,2,3,5,40.0,105,23,7,18,-11,0,1,1,3060.0,0:47,0,0,0,1127.0,0:17,800000
8475759,Brandon,Gormley,1992-02-18,D,L,2015-16,26,0,1,1,0.04,-3,11,0.0,8,18994.0,12:10,0,0,0,0.0,18,19,5,12,-7,0,0,0,274.0,0:10,0,0,0,206.0,0:7,850500
8475760,Nick,Bjugstad,1992-07-17,C,R,2015-16,67,15,19,34,0.51,-8,171,8.77,41,62350.0,15:30,449,419,868,51.73,87,28,25,26,-1,6,9,15,10396.0,2:35,0,0,0,630.0,0:9,4100000
8475761,Beau,Bennett,1991-11-27,RW,R,2015-16,33,6,6,12,0.36,-1,52,11.54,10,23553.0,11:53,2,4,6,33.33,65,6,5,10,-5,1,2,3,2789.0,1:24,0,0,0,174.0,0:5,800000
8475762,Derek,Forbort,1992-03-04,D,L,2015-16,14,1,1,2,0.14,-1,14,7.14,17,9278.0,11:2,0,0,0,0.0,9,7,0,3,-3,0,0,0,12.0,0:0,0,0,0,571.0,0:40,863333
8475763,Kevin,Hayes,1992-05-08,C,L,2015-16,79,14,22,36,0.46,4,133,10.53,30,64762.0,13:39,137,244,381,35.96,59,23,24,42,-18,3,3,6,7141.0,1:30,0,0,0,115.0,0:1,900000
8475764,Cam,Fowler,1991-12-05,D,L,2015-16,69,5,23,28,0.41,-8,113,4.42,27,94312.0,22:46,0,0,0,0.0,43,112,17,32,-15,3,14,17,12395.0,2:59,0,0,0,8993.0,2:10,4000000
8475765,Vladimir,Tarasenko,1991-12-13,RW,L,2015-16,80,40,34,74,0.92,7,292,13.7,37,89461.0,18:38,0,1,1,0.0,32,28,38,34,4,12,12,24,13492.0,2:48,0,0,0,2043.0,0:25,7500000
8475766,Austin,Watson,1992-01-13,LW,R,2015-16,57,3,7,10,0.18,-4,55,5.45,32,34209.0,10:0,6,7,13,46.15,74,45,11,10,1,0,0,0,116.0,0:2,0,0,0,2648.0,0:46,575000
8475768,Jaden,Schwartz,1992-06-25,LW,L,2015-16,33,8,14,22,0.67,8,63,12.7,8,34063.0,17:12,15,17,32,46.88,26,21,16,18,-2,1,4,5,4349.0,2:11,0,0,0,1695.0,0:51,2350000
8475769,Quinton,Howden,1992-01-21,C,L,2015-16,58,6,5,11,0.19,-1,54,11.11,18,36095.0,10:22,3,3,6,50.0,116,10,9,7,2,0,0,0,385.0,0:6,0,0,0,394.0,0:6,850500
8475770,Emerson,Etem,1992-06-16,RW,L,2015-16,58,7,8,15,0.26,-12,100,7.0,11,45762.0,13:9,2,2,4,50.0,87,43,20,20,0,0,0,0,239.0,0:4,0,0,0,737.0,0:12,850500
8475772,Riley,Sheahan,1991-12-07,C,L,2015-16,81,14,11,25,0.31,-8,128,10.94,12,74022.0,15:13,358,424,782,45.78,72,40,20,21,-1,3,1,4,5644.0,1:9,1,0,1,9919.0,2:2,950000
8475774,Petter,Granberg,1992-08-27,D,R,2015-16,27,0,2,2,0.07,1,12,0.0,13,22226.0,13:43,0,0,0,0.0,48,26,0,7,-7,0,0,0,0.0,0:0,0,0,0,836.0,0:30,600000
8475775,Tye,McGinn,1990-07-29,LW,L,2015-16,2,0,0,0,0.0,0,1,0.0,0,1025.0,8:32,0,0,0,0.0,0,0,1,0,1,0,0,0,0.0,0:0,0,0,0,0.0,0:0,625000
8475780,Chris,Wagner,1991-05-27,RW,R,2015-16,43,4,2,6,0.14,-2,55,7.27,28,23620.0,9:9,148,126,274,54.01,95,27,3,11,-8,0,0,0,124.0,0:2,0,0,0,1384.0,0:32,600000
8475782,Morgan,Ellis,1992-04-30,D,R,2015-16,3,0,0,0,0.0,0,3,0.0,2,1612.0,8:57,0,0,0,0.0,1,2,0,2,-2,0,0,0,18.0,0:6,0,0,0,45.0,0:15,632500
8475784,Jeff,Skinner,1992-05-16,LW,L,2015-16,82,28,23,51,0.62,-2,258,10.85,38,80129.0,16:17,20,27,47,42.55,21,17,77,43,34,4,3,7,9587.0,1:56,0,0,0,119.0,0:1,5725000
8475786,Zach,Hyman,1992-06-09,C,R,2015-16,16,4,2,6,0.38,0,37,10.81,18,15059.0,15:41,1,2,3,33.33,31,8,9,2,7,0,0,0,263.0,0:16,0,0,0,1555.0,1:37,900000
8475788,Alexander,Burmistrov,1991-10-21,C,L,2015-16,81,7,14,21,0.26,-11,102,6.86,32,78599.0,16:10,205,307,512,40.04,125,35,36,48,-12,0,1,1,4576.0,0:56,0,1,1,9763.0,2:0,1550000
8475790,Erik,Gudbranson,1992-01-07,D,R,2015-16,64,2,7,9,0.14,3,73,2.74,49,77232.0,20:6,0,0,0,0.0,150,73,11,28,-17,0,0,0,1275.0,0:19,0,0,0,12427.0,3:14,2500000
8475791,Taylor,Hall,1991-11-14,LW,L,2015-16,82,26,39,65,0.79,-4,286,9.09,54,94485.0,19:12,14,25,39,35.9,82,50,64,73,-9,4,8,12,13866.0,2:49,0,0,0,245.0,0:2,6000000
8475792,Brett,Connolly,1992-05-02,RW,R,2015-16,71,9,16,25,0.35,-1,95,9.47,20,55214.0,12:57,14,17,31,45.16,137,36,11,20,-9,2,3,5,3567.0,0:50,0,0,0,24.0,0:0,1025000
8475793,Ryan,Johansen,1992-07-31,C,R,2015-16,80,14,46,60,0.75,6,185,7.57,61,84301.0,17:33,652,594,1246,52.33,115,30,38,42,-4,4,18,22,13547.0,2:49,0,0,0,837.0,0:10,4000000
8475794,Tyler,Seguin,1992-01-31,C,R,2015-16,72,33,40,73,1.01,2,278,11.87,16,83991.0,19:26,470,376,846,55.56,80,27,21,46,-25,7,17,24,14339.0,3:19,0,0,0,96.0,0:1,5750000
8475795,Dylan,McIlrath,1992-04-20,D,R,2015-16,34,2,2,4,0.12,7,28,7.14,64,28813.0,14:7,0,0,0,0.0,93,35,9,12,-3,0,0,0,70.0,0:2,0,0,0,1885.0,0:55,600000
8475796,Mark,Pysyk,1992-01-11,D,R,2015-16,55,1,10,11,0.2,-1,44,2.27,32,52480.0,15:54,0,0,0,0.0,37,49,9,21,-12,0,1,1,2117.0,0:38,0,1,1,1536.0,0:27,1125000
8475797,Jarred,Tinordi,1992-02-20,D,L,2015-16,10,0,0,0,0.0,-5,3,0.0,17,8579.0,14:17,0,0,0,0.0,22,11,1,1,0,0,0,0,36.0,0:3,0,0,0,1148.0,1:54,850500
8475798,Mikael,Granlund,1992-02-26,RW,L,2015-16,82,13,31,44,0.54,-12,160,8.12,20,89148.0,18:7,528,557,1085,48.66,86,57,51,40,11,2,9,11,12914.0,2:37,1,0,1,2812.0,0:34,3000000
8475799,Nino,Niederreiter,1992-09-08,RW,L,2015-16,82,20,23,43,0.52,9,159,12.58,36,76474.0,15:32,11,16,27,40.74,129,19,35,23,12,2,3,5,9292.0,1:53,0,0,0,159.0,0:1,2666667
8475800,Teemu,Pulkkinen,1992-01-02,LW,R,2015-16,36,6,6,12,0.33,2,65,9.23,14,24985.0,11:34,0,1,1,0.0,5,8,12,12,0,1,2,3,3757.0,1:44,0,0,0,24.0,0:0,735000
8475807,Joakim,Nordstrom,1992-02-25,LW,L,2015-16,71,10,14,24,0.34,1,81,12.35,12,66566.0,15:37,6,4,10,60.0,98,32,26,33,-7,0,0,0,427.0,0:6,1,0,1,7110.0,1:40,605000
8475808,Michael,Chaput,1992-04-09,C,L,2015-16,8,1,1,2,0.25,3,10,10.0,5,4319.0,8:59,49,26,75,65.33,13,3,0,3,-3,0,0,0,19.0,0:2,0,0,0,0.0,0:0,650000
8475810,Bryan,Rust,1992-05-11,RW,R,2015-16,41,4,7,11,0.27,1,68,5.88,12,30744.0,12:29,1,3,4,25.0,62,23,10,8,2,0,1,1,739.0,0:18,0,0,0,647.0,0:15,652500
8475815,Julian,Melchiori,1991-12-06,D,L,2015-16,11,0,0,0,0.0,1,12,0.0,0,8973.0,13:35,0,0,0,0.0,18,9,2,5,-3,0,0,0,0.0,0:0,0,0,0,259.0,0:23,600000
8475816,Stanislav,Galiev,1992-01-17,RW,R,2015-16,24,0,3,3,0.12,2,30,0.0,4,13133.0,9:7,0,0,0,0.0,14,4,6,8,-2,0,0,0,1000.0,0:41,0,0,0,40.0,0:1,575000
8475820,Joonas,Donskoi,1992-04-13,RW,R,2015-16,76,11,25,36,0.47,4,107,10.28,20,64539.0,14:9,2,1,3,66.67,31,46,33,37,-4,3,5,8,6654.0,1:27,0,0,0,311.0,0:4,925000
8475832,Tom,Kuhnhackl,1992-01-21,RW,L,2015-16,42,5,10,15,0.36,3,52,9.62,24,30744.0,12:12,0,3,3,0.0,57,32,5,6,-1,0,0,0,80.0,0:1,2,0,2,2476.0,0:58,575000
8475836,Alex,Friesen,1991-01-30,C,L,2015-16,1,0,0,0,0.0,-2,1,0.0,0,703.0,11:43,0,1,1,0.0,1,0,1,0,1,0,0,0,0.0,0:0,0,0,0,0.0,0:0,575000
8475842,Sam,Carrick,1992-02-04,C,R,2015-16,3,0,0,0,0.0,-2,4,0.0,4,2064.0,11:28,1,0,1,100.0,4,0,0,0,0,0,0,0,0.0,0:0,0,0,0,286.0,1:35,600000
8475844,Kenny,Agostino,1992-04-30,LW,L,2015-16,2,0,0,0,0.0,-2,3,0.0,0,1626.0,13:33,0,0,0,0.0,3,0,2,5,-3,0,0,0,163.0,1:21,0,0,0,0.0,0:0,735000
8475848,Brendan,Gallagher,1992-05-06,RW,R,2015-16,53,19,21,40,0.75,13,173,10.98,24,52712.0,16:34,12,17,29,41.38,43,25,30,14,16,7,3,10,9353.0,2:56,0,0,0,44.0,0:0,3750000
8475855,Jesper,Fast,1991-12-02,RW,R,2015-16,79,10,20,30,0.38,9,75,13.33,18,70807.0,14:56,1,5,6,16.67,109,55,35,18,17,0,0,0,1043.0,0:13,0,0,0,10328.0,2:10,950000
8475857,Kevin,Gravel,1992-03-06,D,L,2015-16,5,0,0,0,0.0,0,2,0.0,0,3503.0,11:40,0,0,0,0.0,4,4,0,2,-2,0,0,0,232.0,0:46,0,0,0,101.0,0:20,667500
8475868,Anthony,Bitetto,1990-07-15,D,L,2015-16,28,1,5,6,0.21,0,19,5.26,19,20385.0,12:8,0,0,0,0.0,62,41,2,8,-6,0,0,0,129.0,0:4,0,0,0,85.0,0:3,665500
8475869,Brandon,Davidson,1991-08-21,D,L,2015-16,51,4,7,11,0.22,7,63,6.35,20,58741.0,19:11,0,0,0,0.0,74,92,19,45,-26,2,0,2,1334.0,0:26,0,1,1,8075.0,2:38,585000
8475878,Freddie,Hamilton,1992-01-01,C,R,2015-16,4,1,1,2,0.5,1,7,14.29,0,3048.0,12:42,12,9,21,57.14,8,2,1,2,-1,0,0,0,0.0,0:0,1,0,1,202.0,0:50,687500
8475902,Zach,Trotman,1990-08-26,D,R,2015-16,38,2,5,7,0.18,3,60,3.33,22,42303.0,18:33,0,0,0,0.0,71,49,2,16,-14,0,0,0,689.0,0:18,0,0,0,4020.0,1:45,625000
8475906,John,Klingberg,1992-08-14,D,R,2015-16,76,10,48,58,0.76,22,171,5.85,30,103458.0,22:41,0,0,0,0.0,44,68,36,78,-42,2,20,22,14581.0,3:11,0,0,0,452.0,0:5,4250000
8475907,Micheal,Ferland,1992-04-20,LW,L,2015-16,71,4,14,18,0.25,-15,122,3.28,45,53730.0,12:36,7,5,12,58.33,207,22,37,25,12,1,1,2,4425.0,1:2,0,0,0,648.0,0:9,825000
8475913,Mark,Stone,1992-05-13,RW,R,2015-16,75,23,38,61,0.81,-4,151,15.23,38,90511.0,20:6,8,11,19,42.11,55,54,128,54,74,5,10,15,13470.0,2:59,1,2,3,5484.0,1:13,3500000
8475949,Marek,Hrivik,1991-08-28,LW,R,2015-16,5,0,1,1,0.2,3,3,0.0,0,3215.0,10:43,3,2,5,60.0,6,1,0,3,-3,0,0,0,33.0,0:6,0,0,0,252.0,0:50,575000
8475980,Brody,Sutter,1991-09-26,C,R,2015-16,8,0,0,0,0.0,-4,7,0.0,0,4304.0,8:58,9,4,13,69.23,21,0,1,1,0,0,0,0,0.0,0:0,0,0,0,0.0,0:0,600000
8476043,Ben,Street,1987-02-13,C,L,2015-16,7,0,0,0,0.0,-1,8,0.0,4,3085.0,7:20,26,21,47,55.32,6,4,0,2,-2,0,0,0,0.0,0:0,0,0,0,0.0,0:0,650000
8476062,Mark,Arcobello,1988-08-12,RW,R,2015-16,20,3,1,4,0.2,0,43,6.98,0,15213.0,12:40,132,110,242,54.55,22,3,9,4,5,0,0,0,2484.0,2:4,0,0,0,130.0,0:6,1100000
8476116,Ryan,Garbutt,1985-08-12,C,L,2015-16,80,7,7,14,0.18,-11,135,5.19,48,52009.0,10:50,1,7,8,12.5,165,28,12,18,-6,0,0,0,446.0,0:5,1,0,1,3138.0,0:39,1800000
8476147,Kael,Mouillierat,1987-12-09,LW,L,2015-16,1,0,0,0,0.0,0,1,0.0,2,641.0,10:41,5,6,11,45.45,4,0,1,0,1,0,0,0,0.0,0:0,0,0,0,0.0,0:0,575000
8476158,Harry,Zolnierczyk,1987-09-01,LW,L,2015-16,1,0,0,0,0.0,-1,1,0.0,0,528.0,8:48,0,0,0,0.0,3,0,0,0,0,0,0,0,0.0,0:0,0,0,0,0.0,0:0,600000
8476177,Matt,Read,1986-06-14,RW,R,2015-16,79,11,15,26,0.33,-5,127,8.66,27,72300.0,15:15,24,26,50,48.0,81,60,34,20,14,2,5,7,6242.0,1:19,0,0,0,7937.0,1:40,3625000
8476191,Kevan,Miller,1987-11-15,D,R,2015-16,71,5,13,18,0.25,15,64,7.81,53,81190.0,19:3,0,0,0,0.0,164,123,12,33,-21,0,1,1,235.0,0:3,0,0,0,10791.0,2:31,800000
8476200,Paul,Thompson,1988-11-30,RW,R,2015-16,3,0,0,0,0.0,0,3,0.0,2,2255.0,12:31,0,0,0,0.0,3,0,1,0,1,0,0,0,8.0,0:2,0,0,0,7.0,0:2,575000
8476209,Mike,Sislo,1988-01-20,RW,R,2015-16,18,3,1,4,0.22,-2,29,10.34,4,13419.0,12:25,0,2,2,0.0,25,6,3,2,1,1,0,1,1265.0,1:10,0,0,0,9.0,0:0,562500
8476235,Justin,Fontaine,1987-11-06,RW,R,2015-16,60,5,11,16,0.27,3,54,9.26,20,42680.0,11:51,1,3,4,25.0,9,24,17,12,5,0,0,0,484.0,0:8,0,1,1,3943.0,1:5,1000000
8476279,Jyrki,Jokipakka,1991-08-20,D,L,2015-16,58,2,10,12,0.21,4,45,4.44,14,54145.0,15:33,0,0,0,0.0,69,66,14,35,-21,0,0,0,390.0,0:6,0,0,0,3882.0,1:6,900000
8476288,Ryan,Dzingel,1992-03-09,LW,L,2015-16,30,3,6,9,0.3,4,23,13.04,11,19436.0,10:47,2,2,4,50.0,54,4,6,2,4,0,0,0,66.0,0:2,0,0,0,192.0,0:6,715000
8476289,Alexey,Marchenko,1992-01-02,D,R,2015-16,66,2,9,11,0.17,-5,40,5.0,10,66651.0,16:49,0,0,0,0.0,47,100,7,33,-26,0,0,0,158.0,0:2,0,1,1,8396.0,2:7,666667
8476292,Ondrej,Palat,1991-03-28,LW,L,2015-16,62,16,24,40,0.65,10,117,13.68,20,66659.0,17:55,2,6,8,25.0,108,39,32,31,1,1,6,7,10230.0,2:45,2,1,3,5206.0,1:23,3333333
8476293,Scott,Wilson,1992-04-24,C,L,2015-16,24,5,1,6,0.25,0,39,12.82,12,15387.0,10:41,0,0,0,0.0,38,6,5,5,0,0,0,0,1158.0,0:48,0,0,0,58.0,0:2,655000
8476300,Nikita,Nesterov,1993-03-28,D,L,2015-16,57,3,6,9,0.16,-6,57,5.26,41,50922.0,14:53,0,0,0,0.0,95,31,8,30,-22,2,2,4,4269.0,1:14,0,0,0,164.0,0:2,742500
8476302,Frank,Corrado,1993-03-26,D,R,2015-16,39,1,5,6,0.15,-12,46,2.17,26,33822.0,14:27,0,0,0,0.0,46,37,2,16,-14,0,1,1,1215.0,0:31,0,0,0,1574.0,0:40,632500
8476312,Josh,Manson,1991-10-07,D,R,2015-16,71,5,10,15,0.21,11,88,5.68,74,80013.0,18:46,0,0,0,0.0,158,67,18,51,-33,0,0,0,487.0,0:6,0,0,0,9142.0,2:8,925000
8476323,Max,McCormick,1992-05-01,LW,L,2015-16,20,2,2,4,0.2,-4,37,5.41,37,12550.0,10:27,39,37,76,51.32,46,11,8,5,3,0,0,0,75.0,0:3,0,0,0,80.0,0:4,642500
8476331,Dylan,DeMelo,1993-05-01,D,R,2015-16,45,2,2,4,0.09,0,42,4.76,14,36769.0,13:37,0,0,0,0.0,39,35,8,22,-14,2,2,4,2974.0,1:6,0,0,0,349.0,0:7,633333
8476336,Iiro,Pakarinen,1991-08-25,RW,R,2015-16,63,5,8,13,0.21,-10,76,6.58,8,40629.0,10:44,5,8,13,38.46,152,21,10,9,1,0,2,2,1234.0,0:19,0,0,0,4399.0,1:9,817500
8476344,Tyler,Graovac,1993-04-27,C,L,2015-16,2,0,0,0,0.0,-1,2,0.0,0,1393.0,11:36,13,6,19,68.42,1,0,2,0,2,0,0,0,0.0,0:0,0,0,0,0.0,0:0,747500
8476346,Johnny,Gaudreau,1993-08-13,LW,L,2015-16,79,30,48,78,0.99,4,217,13.82,20,94471.0,19:55,2,3,5,40.0,26,10,41,90,-49,6,15,21,17066.0,3:36,0,0,0,310.0,0:3,925000
8476352,Michael,Mersch,1992-10-02,LW,L,2015-16,17,1,2,3,0.18,1,23,4.35,0,10588.0,10:22,1,3,4,25.0,26,10,3,3,0,0,0,0,408.0,0:24,0,0,0,445.0,0:26,786667
8476356,Tobias,Rieder,1993-01-10,C,L,2015-16,82,14,23,37,0.45,-21,189,7.41,10,85143.0,17:18,10,19,29,34.48,54,43,31,11,20,2,6,8,11061.0,2:14,0,1,1,9571.0,1:56,853333
8476368,Fredrik,Claesson,1992-11-24,D,L,2015-16,16,0,2,2,0.12,-6,15,0.0,2,18518.0,19:17,0,0,0,0.0,33,30,9,14,-5,0,0,0,79.0,0:4,0,0,0,1350.0,1:24,600000
8476370,Blake,Pietila,1993-02-20,LW,L,2015-16,7,1,1,2,0.29,0,10,10.0,2,5054.0,12:2,0,0,0,0.0,19,3,0,0,0,0,0,0,135.0,0:19,0,0,0,444.0,1:3,662500
8476379,Darren,Dietz,1993-07-17,D,R,2015-16,13,1,4,5,0.38,-1,13,7.69,13,11339.0,14:32,0,0,0,0.0,38,14,3,12,-9,0,0,0,134.0,0:10,0,0,0,241.0,0:18,665000
8476381,Andrew,Shaw,1991-07-20,RW,R,2015-16,78,14,20,34,0.44,11,153,9.15,69,68567.0,14:39,146,168,314,46.5,148,21,21,23,-2,4,4,8,8915.0,1:54,0,0,0,75.0,0:0,2000000
8476384,Max,Friberg,1992-11-20,RW,R,2015-16,5,0,0,0,0.0,-1,1,0.0,2,2652.0,8:50,0,0,0,0.0,7,2,0,0,0,0,0,0,2.0,0:0,0,0,0,149.0,0:29,587500
8476386,Shane,Prince,1992-11-16,LW,L,2015-16,62,6,11,17,0.27,5,88,6.82,10,41776.0,11:13,4,1,5,80.0,24,14,19,24,-5,0,0,0,708.0,0:11,0,0,0,222.0,0:3,700000
8476388,Andrey,Pedan,1993-07-03,D,L,2015-16,13,0,0,0,0.0,-3,11,0.0,18,8543.0,10:57,0,0,0,0.0,40,8,0,5,-5,0,0,0,9.0,0:0,0,0,0,327.0,0:25,792500
8476389,Vincent,Trocheck,1993-07-11,C,R,2015-16,76,25,28,53,0.7,15,174,14.37,44,81032.0,17:46,547,559,1106,49.46,125,41,43,33,10,4,9,13,12223.0,2:40,1,0,1,3615.0,0:47,661667
8476392,Adam,Lowry,1993-03-29,C,L,2015-16,74,7,10,17,0.23,-9,73,9.59,53,62242.0,14:1,391,454,845,46.27,187,48,33,18,15,0,0,0,837.0,0:11,0,0,0,9317.0,2:5,828333
8476393,Nick,Cousins,1993-07-20,C,L,2015-16,36,6,5,11,0.31,5,41,14.63,4,23179.0,10:43,109,128,237,45.99,38,17,18,13,5,0,2,2,903.0,0:25,0,0,0,13.0,0:0,842500
8476394,Michael,Paliotta,1993-04-06,D,R,2015-16,1,0,0,0,0.0,0,2,0.0,4,452.0,7:32,0,0,0,0.0,0,1,0,0,0,0,0,0,0.0,0:0,0,0,0,0.0,0:0,925000
8476400,Logan,Shaw,1992-10-05,RW,R,2015-16,53,5,2,7,0.13,-7,72,6.94,13,38926.0,12:14,16,21,37,43.24,88,20,21,5,16,1,0,1,3303.0,1:2,0,0,0,1710.0,0:32,674167
8476401,Daniel,Catenacci,1993-03-09,C,L,2015-16,11,0,0,0,0.0,-2,7,0.0,0,5768.0,8:44,2,0,2,100.0,22,2,2,0,2,0,0,0,25.0,0:2,0,0,0,6.0,0:0,611667
8476403,Klas,Dahlbeck,1991-07-06,D,L,2015-16,71,2,6,8,0.11,-5,64,3.12,28,67022.0,15:43,0,0,0,0.0,178,76,10,15,-5,0,0,0,205.0,0:2,0,1,1,11718.0,2:45,605000
8476404,Andy,Andreoff,1991-05-17,LW,L,2015-16,60,8,2,10,0.17,1,46,17.39,76,31655.0,8:47,134,134,268,50.0,82,11,12,12,0,0,0,0,343.0,0:5,0,0,0,151.0,0:2,587500
8476406,Nick,Shore,1992-09-26,C,R,2015-16,68,3,7,10,0.15,-10,90,3.33,32,50617.0,12:24,384,357,741,51.82,97,17,13,7,6,0,2,2,1240.0,0:18,0,0,0,4114.0,1:0,600000
8476409,Alan,Quine,1993-02-25,C,L,2015-16,2,1,0,1,0.5,0,5,20.0,0,2131.0,17:45,16,10,26,61.54,3,3,1,2,-1,0,0,0,232.0,1:56,1,0,1,187.0,1:33,595000
8476410,Josh,Leivo,1993-05-26,LW,R,2015-16,12,5,0,5,0.42,2,20,25.0,6,8868.0,12:19,1,1,2,50.0,7,3,4,4,0,1,0,1,1918.0,2:39,0,0,0,0.0,0:0,792500
8476414,Alexandre,Grenier,1991-09-05,RW,R,2015-16,6,0,0,0,0.0,-4,9,0.0,2,4131.0,11:28,1,1,2,50.0,5,3,3,3,0,0,0,0,0.0,0:0,0,0,0,0.0,0:0,585000
8476415,Kyle,Rau,1992-10-24,C,L,2015-16,9,0,0,0,0.0,-1,15,0.0,2,6799.0,12:35,0,0,0,0.0,4,3,3,1,2,0,0,0,272.0,0:30,0,0,0,132.0,0:14,858750
8476419,Jean-Gabriel,Pageau,1992-11-11,C,R,2015-16,82,19,24,43,0.52,17,133,14.29,26,82175.0,16:42,614,563,1177,52.17,166,60,30,37,-7,1,1,2,4115.0,0:50,7,2,9,10325.0,2:5,900000
8476422,Mike,Reilly,1993-07-13,D,L,2015-16,29,1,6,7,0.24,-4,27,3.7,8,21024.0,12:4,0,0,0,0.0,3,23,2,10,-8,0,2,2,3197.0,1:50,0,0,0,58.0,0:2,925000
8476423,Reid,Boucher,1993-09-08,C,L,2015-16,39,8,11,19,0.49,-13,74,10.81,6,33392.0,14:16,1,2,3,33.33,32,14,9,9,0,2,4,6,4395.0,1:52,0,0,0,1.0,0:0,692500
8476427,Ty,Rattie,1993-02-05,RW,R,2015-16,13,4,2,6,0.46,1,16,25.0,4,7244.0,9:17,0,0,0,0.0,6,2,2,2,0,0,0,0,95.0,0:7,0,0,0,0.0,0:0,772500
8476428,Rocco,Grimaldi,1993-02-08,C,R,2015-16,20,3,2,5,0.25,-4,29,10.34,2,14238.0,11:51,47,61,108,43.52,17,2,10,5,5,0,0,0,612.0,0:30,0,0,0,18.0,0:0,925000
8476429,Scott,Mayfield,1992-10-14,D,R,2015-16,6,1,0,1,0.17,-4,4,25.0,11,6159.0,17:6,0,0,0,0.0,12,15,0,3,-3,0,0,0,203.0,0:33,0,0,0,504.0,1:24,925000
8476430,Tomas,Jurco,1992-12-28,LW,L,2015-16,44,4,2,6,0.14,-6,43,9.3,16,24243.0,9:10,1,0,1,100.0,50,4,6,7,-1,0,0,0,1112.0,0:25,0,0,0,152.0,0:3,900000
8476431,Adam,Clendening,1992-10-26,D,R,2015-16,29,1,6,7,0.24,6,43,2.33,20,25745.0,14:47,0,0,0,0.0,19,34,5,19,-14,0,0,0,1402.0,0:48,0,0,0,5.0,0:0,761250
8476432,Boone,Jenner,1993-06-15,C,L,2015-16,82,30,19,49,0.6,-15,225,13.33,77,80733.0,16:24,156,138,294,53.06,213,71,39,25,14,9,5,14,10182.0,2:4,1,0,1,1269.0,0:15,778333
8476435,Alex,Khokhlachev,1993-09-09,C,L,2015-16,5,0,0,0,0.0,-2,4,0.0,0,3076.0,10:15,0,2,2,0.0,2,1,0,1,-1,0,0,0,0.0,0:0,0,0,0,2.0,0:0,786667
8476436,Dmitrij,Jaskin,1993-03-23,RW,L,2015-16,65,4,9,13,0.2,3,92,4.35,26,46251.0,11:51,8,20,28,28.57,126,16,21,8,13,0,0,0,1018.0,0:15,0,0,0,35.0,0:0,775000
8476437,Victor,Rask,1993-03-01,C,L,2015-16,80,21,27,48,0.6,-6,160,13.12,24,81519.0,16:58,479,456,935,51.23,32,34,42,31,11,5,13,18,12563.0,2:37,0,0,0,954.0,0:11,680833
8476438,Brandon,Saad,1992-10-27,LW,L,2015-16,78,31,22,53,0.68,1,233,13.3,14,80582.0,17:13,19,15,34,55.88,43,25,33,31,2,6,2,8,9906.0,2:7,0,1,1,2991.0,0:38,6000000
8476439,Brett,Ritchie,1993-07-01,RW,R,2015-16,8,0,1,1,0.12,-3,15,0.0,7,5569.0,11:36,0,0,0,0.0,30,3,2,3,-1,0,0,0,622.0,1:17,0,0,0,0.0,0:0,814167
8476440,Markus,Granlund,1993-04-16,C,L,2015-16,47,6,4,10,0.21,-4,56,10.71,14,38881.0,13:47,202,270,472,42.8,31,23,19,11,8,0,0,0,2106.0,0:44,1,1,2,3303.0,1:10,767500
8476441,Joel,Edmundson,1993-06-28,D,L,2015-16,67,1,8,9,0.13,0,90,1.11,63,60016.0,14:55,0,0,0,0.0,165,62,7,19,-12,0,0,0,79.0,0:1,0,0,0,4434.0,1:6,742500
8476442,Matt,Nieto,1992-11-05,LW,L,2015-16,67,8,9,17,0.25,-8,90,8.89,10,52901.0,13:9,2,6,8,25.0,33,33,17,27,-10,0,1,1,286.0,0:4,2,0,2,4842.0,1:12,759167
8476443,Xavier,Ouellet,1993-07-29,D,L,2015-16,5,0,1,1,0.2,-2,4,0.0,2,4873.0,16:14,0,0,0,0.0,5,3,3,1,2,0,0,0,0.0,0:0,0,0,0,339.0,1:7,670000
8476447,Miikka,Salomaki,1993-03-09,RW,L,2015-16,61,5,5,10,0.16,-1,61,8.2,28,43923.0,12:0,2,1,3,66.67,164,30,17,12,5,0,0,0,130.0,0:2,0,1,1,4815.0,1:18,780833
8476448,William,Karlsson,1993-01-08,C,L,2015-16,81,9,11,20,0.25,-9,108,8.33,6,70324.0,14:28,416,495,911,45.66,40,48,42,21,21,0,0,0,1314.0,0:16,0,0,0,10381.0,2:8,830833
8476449,Scott,Harrington,1993-03-10,D,L,2015-16,15,0,1,1,0.07,0,9,0.0,4,11785.0,13:5,0,0,0,0.0,23,16,1,3,-2,0,0,0,22.0,0:1,0,0,0,648.0,0:43,589167
8476451,Lucas,Lessio,1993-01-23,LW,L,2015-16,12,1,1,2,0.17,1,14,7.14,2,7542.0,10:28,0,2,2,0.0,24,5,2,2,0,0,0,0,330.0,0:27,0,0,0,0.0,0:0,830833
8476452,Tyler,Wotherspoon,1993-03-12,D,L,2015-16,11,0,1,1,0.09,0,9,0.0,0,9352.0,14:10,0,0,0,0.0,14,16,1,6,-5,0,0,0,47.0,0:4,0,0,0,763.0,1:9,925000
8476453,Nikita,Kucherov,1993-06-17,RW,L,2015-16,77,30,36,66,0.86,9,209,14.35,30,84141.0,18:12,0,1,1,0.0,61,28,34,58,-24,9,16,25,15072.0,3:15,0,0,0,127.0,0:1,711667
8476454,Ryan,Nugent-Hopkins,1993-04-12,C,L,2015-16,55,12,22,34,0.62,-9,108,11.11,18,62906.0,19:3,369,454,823,44.84,39,36,43,30,13,4,7,11,8631.0,2:36,0,0,0,3145.0,0:57,6000000
8476455,Gabriel,Landeskog,1992-11-23,LW,L,2015-16,75,20,33,53,0.71,-5,169,11.83,69,85166.0,18:55,31,25,56,55.36,141,66,37,30,7,4,10,14,12411.0,2:45,1,2,3,6467.0,1:26,5571429
8476456,Jonathan,Huberdeau,1993-06-04,LW,L,2015-16,76,20,39,59,0.78,17,174,11.49,43,82735.0,18:8,7,11,18,38.89,53,36,32,46,-14,4,9,13,12298.0,2:41,1,0,1,2398.0,0:31,3250000
8476457,Adam,Larsson,1992-11-12,D,R,2015-16,82,3,15,18,0.22,15,65,4.62,77,110747.0,22:30,0,0,0,0.0,163,148,22,27,-5,0,0,0,833.0,0:10,0,1,1,16460.0,3:20,4166666
8476458,Ryan,Strome,1993-07-11,C,R,2015-16,71,8,20,28,0.39,-9,132,6.06,28,66702.0,15:39,39,56,95,41.05,77,19,35,38,-3,1,3,4,6276.0,1:28,0,0,0,134.0,0:1,863333
8476459,Mika,Zibanejad,1993-04-18,C,R,2015-16,81,21,30,51,0.63,-2,184,11.41,18,86315.0,17:45,659,647,1306,50.46,111,43,39,52,-13,2,9,11,12202.0,2:30,2,0,2,6918.0,1:25,2625000
8476460,Mark,Scheifele,1993-03-15,C,R,2015-16,71,29,32,61,0.86,16,194,14.95,48,79018.0,18:32,515,651,1166,44.17,53,36,61,35,26,7,4,11,11423.0,2:40,0,0,0,1257.0,0:17,863333
8476461,Sean,Couturier,1992-12-07,C,L,2015-16,63,11,28,39,0.62,8,119,9.24,30,70311.0,18:36,537,568,1105,48.6,31,30,27,29,-2,2,5,7,7273.0,1:55,0,1,1,6972.0,1:50,1750000
8476462,Dougie,Hamilton,1993-06-17,D,R,2015-16,82,12,31,43,0.52,-14,190,6.32,46,97257.0,19:46,0,0,0,0.0,78,106,15,63,-48,5,11,16,11919.0,2:25,0,0,0,2338.0,0:28,5750000
8476463,Jonas,Brodin,1993-07-12,D,L,2015-16,68,2,5,7,0.1,-5,58,3.45,18,83311.0,20:25,0,0,0,0.0,34,110,27,23,4,0,0,0,424.0,0:6,0,0,0,7186.0,1:45,4166667
8476465,Ryan,Murphy,1993-03-31,D,R,2015-16,35,0,10,10,0.29,-1,47,0.0,10,36232.0,17:15,0,0,0,0.0,25,22,11,18,-7,0,1,1,3821.0,1:49,0,0,0,223.0,0:6,863333
8476466,Sven,Baertschi,1992-10-05,LW,L,2015-16,69,15,13,28,0.41,-14,108,13.89,14,55717.0,13:27,0,1,1,0.0,30,36,26,22,4,2,5,7,7110.0,1:43,0,0,0,125.0,0:1,900000
8476467,Jamie,Oleksiak,1992-12-21,D,L,2015-16,19,0,2,2,0.11,-5,13,0.0,21,14496.0,12:42,0,0,0,0.0,54,29,4,17,-13,0,0,0,11.0,0:0,0,0,0,700.0,0:36,875000
8476468,J.T.,Miller,1993-03-14,C,L,2015-16,82,22,21,43,0.52,10,135,16.3,46,73971.0,15:2,68,89,157,43.31,174,48,40,61,-21,2,2,4,6913.0,1:24,0,0,0,60.0,0:0,874000
8476469,Joel,Armia,1993-05-31,RW,R,2015-16,43,4,6,10,0.23,2,52,7.69,12,31376.0,12:9,0,2,2,0.0,59,20,23,13,10,0,0,0,1404.0,0:32,0,2,2,1009.0,0:23,894167
8476470,Nathan,Beaulieu,1992-12-05,D,L,2015-16,64,2,17,19,0.3,-6,74,2.7,55,67035.0,17:27,0,0,0,0.0,59,89,17,48,-31,1,2,3,4742.0,1:14,0,0,0,1928.0,0:30,1000000
8476472,Oscar,Klefbom,1993-07-20,D,L,2015-16,30,4,8,12,0.4,-4,48,8.33,6,39393.0,21:53,0,0,0,0.0,21,62,10,31,-21,0,3,3,3374.0,1:52,0,0,0,4779.0,2:39,894167
8476473,Connor,Murphy,1993-03-26,D,R,2015-16,78,6,11,17,0.22,5,101,5.94,48,95985.0,20:30,0,0,0,0.0,175,139,21,29,-8,1,2,3,5234.0,1:7,0,0,0,9973.0,2:7,863333
8476476,Joe,Morrow,1992-12-09,D,L,2015-16,33,1,6,7,0.21,-7,44,2.27,4,31498.0,15:54,0,0,0,0.0,28,35,9,8,1,0,2,2,1766.0,0:53,0,0,0,733.0,0:22,863333
8476477,Matt,Puempel,1993-01-24,LW,L,2015-16,26,2,1,3,0.12,-3,26,7.69,9,17687.0,11:20,1,1,2,50.0,18,10,6,5,1,0,0,0,790.0,0:30,0,0,0,0.0,0:0,863333
8476478,Stuart,Percy,1993-05-18,D,L,2015-16,3,0,0,0,0.0,-2,1,0.0,0,2369.0,13:9,0,0,0,0.0,4,3,1,1,0,0,0,0,0.0,0:0,0,0,0,0.0,0:0,863333
8476479,Phillip,Danault,1993-02-24,C,L,2015-16,51,4,6,10,0.2,-5,72,5.56,14,39037.0,12:45,247,272,519,47.59,45,28,18,11,7,0,0,0,323.0,0:6,0,0,0,2097.0,0:41,863333
8476480,Vladislav,Namestnikov,1992-11-22,C,L,2015-16,80,14,21,35,0.44,17,106,13.21,45,67756.0,14:6,175,216,391,44.76,49,33,15,18,-3,1,3,4,8663.0,1:48,0,0,0,119.0,0:1,874125
8476483,Rickard,Rakell,1993-05-05,C,R,2015-16,72,20,23,43,0.6,-1,169,11.83,19,69431.0,16:4,197,254,451,43.68,121,30,29,36,-7,4,6,10,9683.0,2:14,0,0,0,464.0,0:6,894167
8476495,Seth,Griffith,1993-01-04,C,R,2015-16,4,0,1,1,0.25,-4,2,0.0,4,2392.0,9:58,0,0,0,0.0,4,0,0,1,-1,0,1,1,460.0,1:55,0,0,0,0.0,0:0,759167
8476525,Colin,Miller,1992-10-29,D,R,2015-16,42,3,13,16,0.38,0,59,5.08,39,39803.0,15:47,0,0,0,0.0,45,36,6,20,-14,0,5,5,3179.0,1:15,0,0,0,139.0,0:3,602500
8476539,Jonathan,Marchessault,1990-12-27,C,R,2015-16,45,7,11,18,0.4,-10,81,8.64,17,32641.0,12:5,38,41,79,48.1,61,9,10,12,-2,4,3,7,7765.0,2:52,0,0,0,3.0,0:0,600000
8476545,Kurtis,Gabriel,1993-04-20,RW,R,2015-16,3,0,0,0,0.0,1,1,0.0,10,809.0,4:29,0,0,0,0.0,4,0,1,0,1,0,0,0,0.0,0:0,0,0,0,0.0,0:0,666667
8476624,Barclay,Goodrow,1993-02-26,RW,L,2015-16,14,0,3,3,0.21,1,7,0.0,16,8627.0,10:16,4,2,6,66.67,8,4,3,4,-1,0,0,0,28.0,0:2,0,1,1,789.0,0:56,626667
8476766,Cole,Schneider,1990-08-26,LW,L,2015-16,2,0,0,0,0.0,0,5,0.0,0,1515.0,12:37,0,0,0,0.0,3,0,0,0,0,0,0,0,91.0,0:45,0,0,0,0.0,0:0,700000
8476769,Bobby,Farnham,1989-01-21,RW,L,2015-16,53,8,2,10,0.19,-2,50,16.0,97,29616.0,9:18,2,2,4,50.0,93,19,11,7,4,0,0,0,180.0,0:3,0,0,0,216.0,0:4,575000
8476772,Brian,O'Neill,1988-06-01,RW,L,2015-16,22,0,2,2,0.09,-3,14,0.0,8,13677.0,10:21,2,4,6,33.33,36,9,4,3,1,0,0,0,430.0,0:19,0,0,0,615.0,0:27,562500
8476779,Brad,Hunt,1988-08-24,D,L,2015-16,7,0,0,0,0.0,-1,12,0.0,2,5955.0,14:10,0,0,0,0.0,7,7,2,6,-4,0,0,0,1059.0,2:31,0,0,0,15.0,0:2,600000
8476792,Torey,Krug,1991-04-12,D,L,2015-16,81,4,40,44,0.54,9,244,1.64,33,105043.0,21:36,2,0,2,100.0,61,94,20,57,-37,1,18,19,16016.0,3:17,0,0,0,3114.0,0:38,3400000
8476806,J.T.,Brown,1990-07-02,RW,R,2015-16,78,8,14,22,0.28,16,140,5.71,59,62531.0,13:21,23,27,50,46.0,103,40,21,14,7,0,0,0,479.0,0:6,0,2,2,6743.0,1:26,950000
8476807,Matt,Tennyson,1990-04-23,D,R,2015-16,29,1,3,4,0.14,1,23,4.35,0,18288.0,10:30,0,0,0,0.0,23,18,1,14,-13,1,0,1,2192.0,1:15,0,0,0,118.0,0:4,625000
8476808,Brian,Flynn,1988-07-26,C,R,2015-16,56,4,6,10,0.18,-3,73,5.48,6,39423.0,11:43,200,146,346,57.8,23,33,20,11,9,0,0,0,394.0,0:7,1,1,2,5447.0,1:37,950000
8476822,Luke,Glendening,1989-04-28,RW,R,2015-16,81,8,13,21,0.26,4,88,9.09,46,70848.0,14:34,614,511,1125,54.58,143,71,20,11,9,0,0,0,462.0,0:5,0,0,0,15265.0,3:8,628333
8476850,Ryan,Murray,1993-09-27,D,L,2015-16,82,4,21,25,0.3,-10,90,4.44,40,112403.0,22:50,0,0,0,0.0,51,171,17,39,-22,1,10,11,12986.0,2:38,0,0,0,10565.0,2:8,894167
8476851,Alex,Galchenyuk,1994-02-12,LW,L,2015-16,82,30,26,56,0.68,-8,201,14.93,20,79996.0,16:15,359,390,749,47.93,62,36,31,36,-5,9,7,16,12583.0,2:33,0,0,0,182.0,0:2,2800000
8476852,Griffin,Reinhart,1994-01-24,D,L,2015-16,29,0,1,1,0.03,-6,24,0.0,20,31450.0,18:4,0,0,0,0.0,62,46,6,26,-20,0,0,0,192.0,0:6,0,0,0,2999.0,1:43,863333
8476853,Morgan,Rielly,1994-03-09,D,L,2015-16,82,9,27,36,0.44,-17,167,5.39,28,114277.0,23:13,0,0,0,0.0,58,122,35,72,-37,2,6,8,8994.0,1:49,1,0,1,11619.0,2:21,894167
8476854,Hampus,Lindholm,1994-01-20,D,L,2015-16,80,10,18,28,0.35,7,149,6.71,40,105609.0,22:0,0,0,0,0.0,68,115,18,65,-47,4,11,15,9764.0,2:2,1,0,1,10385.0,2:9,894167
8476855,Nail,Yakupov,1993-10-06,RW,L,2015-16,60,8,15,23,0.38,-16,127,6.3,24,51198.0,14:13,0,1,1,0.0,54,21,27,41,-14,1,5,6,6415.0,1:46,0,0,0,15.0,0:0,2500000
8476856,Matt,Dumba,1994-07-25,D,R,2015-16,81,10,16,26,0.32,1,152,6.58,38,81845.0,16:50,0,0,0,0.0,83,56,13,44,-31,6,6,12,10543.0,2:10,0,0,0,756.0,0:9,894167
8476858,Phillip,Di Giuseppe,1993-10-09,LW,L,2015-16,41,7,10,17,0.41,0,68,10.29,18,35095.0,14:15,7,13,20,35.0,113,21,17,5,12,0,0,0,1887.0,0:46,0,0,0,10.0,0:0,817500
8476867,Brendan,Gaunce,1994-03-25,C,L,2015-16,20,1,0,1,0.05,-9,34,2.94,2,15310.0,12:45,49,58,107,45.79,34,3,11,7,4,0,0,0,496.0,0:24,0,0,0,1297.0,1:4,863333
8476869,Brady,Skjei,1994-03-26,D,L,2015-16,7,0,0,0,0.0,1,6,0.0,4,7448.0,17:44,0,0,0,0.0,11,11,4,3,1,0,0,0,119.0,0:17,0,0,0,1046.0,2:29,925000
8476870,Stefan,Matteau,1994-02-23,C,L,2015-16,32,1,1,2,0.06,-13,27,3.7,17,19743.0,10:16,0,0,0,0.0,67,7,2,9,-7,0,0,0,842.0,0:26,0,0,0,22.0,0:0,612500
8476871,Tanner,Pearson,1992-08-10,LW,L,2015-16,79,15,21,36,0.46,11,137,10.95,18,68543.0,14:27,8,17,25,32.0,104,34,27,18,9,2,2,4,4607.0,0:58,0,0,0,5638.0,1:11,1400000
8476872,Scott,Laughton,1994-05-30,C,L,2015-16,71,7,14,21,0.3,-2,85,8.24,34,44448.0,10:26,170,218,388,43.81,86,29,23,21,2,0,0,0,345.0,0:4,0,0,0,3030.0,0:42,863333
8476874,Olli,Maatta,1994-08-22,D,L,2015-16,67,6,13,19,0.28,27,95,6.32,22,80240.0,19:57,0,0,0,0.0,81,87,8,34,-26,0,1,1,2767.0,0:41,0,1,1,7220.0,1:47,894167
8476875,Mike,Matheson,1994-02-27,D,L,2015-16,3,0,0,0,0.0,1,4,0.0,2,3156.0,17:32,0,0,0,0.0,1,1,1,1,0,0,0,0,3.0,0:1,0,0,0,24.0,0:8,925000
8476878,Zemgus,Girgensons,1994-01-05,C,L,2015-16,71,7,11,18,0.25,0,110,6.36,20,64054.0,15:2,153,182,335,45.67,125,41,16,18,-2,1,1,2,3653.0,0:51,0,1,1,4458.0,1:2,894167
8476879,Cody,Ceci,1993-12-21,D,R,2015-16,75,10,16,26,0.35,9,116,8.62,18,86851.0,19:18,0,0,0,0.0,70,130,15,41,-26,0,2,2,2423.0,0:32,0,0,0,11108.0,2:28,894167
8476880,Tom,Wilson,1994-03-29,RW,R,2015-16,82,7,16,23,0.28,3,99,7.07,163,63531.0,12:54,8,6,14,57.14,253,48,16,21,-5,0,1,1,515.0,0:6,0,1,1,7799.0,1:35,894167
8476881,Tomas,Hertl,1993-11-12,C,L,2015-16,81,21,25,46,0.57,16,202,10.4,26,77629.0,15:58,256,201,457,56.02,90,60,35,41,-6,3,4,7,7862.0,1:37,0,0,0,190.0,0:2,925000
8476882,Teuvo,Teravainen,1994-09-11,LW,L,2015-16,78,13,22,35,0.45,-2,136,9.56,20,71814.0,15:20,125,184,309,40.45,24,31,35,25,10,2,7,9,8224.0,1:45,0,1,1,3644.0,0:46,894167
8476884,Derrick,Pouliot,1994-01-16,D,L,2015-16,22,0,7,7,0.32,4,25,0.0,2,20398.0,15:27,0,0,0,0.0,16,18,6,3,3,0,0,0,1248.0,0:56,0,0,0,196.0,0:8,863333
8476885,Jacob,Trouba,1994-02-26,D,R,2015-16,81,6,15,21,0.26,10,133,4.51,62,107243.0,22:3,0,1,1,0.0,144,177,29,65,-36,0,4,4,6264.0,1:17,1,1,2,13222.0,2:43,894167
8476886,Slater,Koekkoek,1994-02-18,D,L,2015-16,9,0,1,1,0.11,-1,11,0.0,2,5569.0,10:18,0,0,0,0.0,6,5,3,3,0,0,0,0,11.0,0:1,0,0,0,18.0,0:2,894167
8476887,Filip,Forsberg,1994-08-13,LW,R,2015-16,82,33,31,64,0.78,1,247,13.36,47,93739.0,19:3,2,7,9,22.22,114,41,72,52,20,8,15,23,13027.0,2:38,1,0,1,8694.0,1:46,894167
8476888,Mikhail,Grigorenko,1994-05-16,C,L,2015-16,74,6,21,27,0.36,2,84,7.14,8,58904.0,13:16,151,198,349,43.27,23,39,21,18,3,1,3,4,6026.0,1:21,0,0,0,2476.0,0:33,675000
8476889,Radek,Faksa,1994-01-09,C,L,2015-16,45,5,7,12,0.27,9,67,7.46,16,33355.0,12:21,197,204,401,49.13,48,33,20,9,11,0,1,1,203.0,0:4,0,0,0,3543.0,1:18,863333
8476890,Patrick,Sieloff,1994-05-15,D,L,2015-16,1,1,0,1,1.0,1,1,100.0,2,1079.0,17:59,0,0,0,0.0,3,2,0,0,0,0,0,0,0.0,0:0,0,0,0,154.0,2:34,894167
8476892,Colton,Parayko,1993-05-12,D,R,2015-16,79,9,24,33,0.42,28,165,5.45,29,91894.0,19:23,0,0,0,0.0,102,122,33,21,12,3,4,7,7717.0,1:37,0,0,0,4646.0,0:58,858750
8476894,Brendan,Leipsic,1994-05-19,LW,L,2015-16,6,1,2,3,0.5,-1,11,9.09,2,5126.0,14:14,2,1,3,66.67,12,6,3,1,2,0,1,1,730.0,2:1,0,0,0,0.0,0:0,653333
8476897,Oskar,Sundqvist,1994-03-23,C,R,2015-16,18,1,3,4,0.22,0,13,7.69,4,11136.0,10:18,64,75,139,46.04,18,5,6,1,5,0,0,0,48.0,0:2,1,0,1,442.0,0:24,700833
8476902,Esa,Lindell,1994-05-23,D,L,2015-16,4,0,0,0,0.0,-3,2,0.0,0,3371.0,14:2,0,0,0,0.0,4,9,0,3,-3,0,0,0,0.0,0:0,0,0,0,97.0,0:24,745833
8476905,Chandler,Stephenson,1994-04-22,C,L,2015-16,9,0,0,0,0.0,-3,2,0.0,2,4243.0,7:51,30,25,55,54.55,5,4,3,1,2,0,0,0,25.0,0:2,0,0,0,8.0,0:0,725833
8476906,Shayne,Gostisbehere,1993-04-20,D,L,2015-16,64,17,29,46,0.72,8,152,11.18,24,77147.0,20:5,1,0,1,100.0,27,59,28,51,-23,8,14,22,15384.0,4:0,0,0,0,379.0,0:5,925000
8476910,Scott,Kosmachuk,1994-01-24,RW,R,2015-16,8,0,3,3,0.38,1,9,0.0,2,5536.0,11:32,0,0,0,0.0,7,2,1,2,-1,0,0,0,207.0,0:25,0,0,0,0.0,0:0,720000
8476913,Devin,Shore,1994-07-19,C,L,2015-16,3,0,0,0,0.0,2,1,0.0,0,2181.0,12:7,0,1,1,0.0,2,0,0,1,-1,0,0,0,5.0,0:1,0,0,0,0.0,0:0,870000
8476915,Jujhar,Khaira,1994-08-13,LW,L,2015-16,15,0,2,2,0.13,-2,14,0.0,13,9319.0,10:21,0,1,1,0.0,29,6,6,4,2,0,0,0,55.0,0:3,0,0,0,0.0,0:0,875000
8476917,Adam,Pelech,1994-08-16,D,L,2015-16,9,0,2,2,0.22,-1,8,0.0,0,9493.0,17:34,0,0,0,0.0,16,16,1,7,-6,0,0,0,284.0,0:31,0,0,0,1063.0,1:58,854333
8476919,Chris,Tierney,1994-07-01,C,L,2015-16,79,7,13,20,0.25,-16,96,7.29,20,62531.0,13:11,368,437,805,45.71,24,39,31,40,-9,1,0,1,820.0,0:10,1,0,1,7196.0,1:31,711667
8476921,Jordan,Martinook,1992-07-25,LW,L,2015-16,81,9,15,24,0.3,-9,109,8.26,18,73827.0,15:11,18,15,33,54.55,52,40,52,12,40,0,1,1,1709.0,0:21,1,1,2,12568.0,2:35,612500
8476923,Damon,Severson,1994-08-07,D,R,2015-16,72,1,20,21,0.29,-8,94,1.06,32,78472.0,18:9,0,0,0,0.0,66,41,16,36,-20,0,5,5,7360.0,1:42,0,0,0,1307.0,0:18,605833
8476925,Colton,Sissons,1993-11-05,C,R,2015-16,34,4,2,6,0.18,5,25,16.0,12,20317.0,9:57,141,111,252,55.95,35,20,7,5,2,0,0,0,140.0,0:4,0,0,0,2204.0,1:4,635000
8476931,Jake,McCabe,1993-10-12,D,L,2015-16,77,4,10,14,0.18,6,62,6.45,51,88323.0,19:7,0,2,2,0.0,114,109,17,34,-17,0,0,0,745.0,0:9,0,0,0,6542.0,1:24,925000
8476934,Brock,McGinn,1994-02-02,LW,L,2015-16,21,3,1,4,0.19,-14,25,12.0,10,14092.0,11:11,0,1,1,0.0,28,6,4,4,0,0,0,0,198.0,0:9,0,0,0,428.0,0:20,811667
8476941,Connor,Carrick,1994-04-13,D,R,2015-16,19,2,2,4,0.21,-5,21,9.52,15,17708.0,15:32,0,0,0,0.0,38,19,6,17,-11,0,1,1,624.0,0:32,0,0,0,454.0,0:23,636667
8476944,Brendan,Woods,1992-06-11,LW,L,2015-16,5,0,0,0,0.0,0,5,0.0,7,2612.0,8:42,0,1,1,0.0,3,0,1,1,0,0,0,0,0.0,0:0,0,0,0,0.0,0:0,725000
8476948,Charles,Hudon,1994-06-23,LW,L,2015-16,3,0,2,2,0.67,2,3,0.0,0,1925.0,10:41,0,1,1,0.0,7,1,2,0,2,0,0,0,131.0,0:43,0,0,0,0.0,0:0,625000
8476953,Trevor,Carrick,1994-07-04,D,L,2015-16,2,0,0,0,0.0,-1,3,0.0,0,1999.0,16:39,0,0,0,0.0,1,2,4,1,3,0,0,0,57.0,0:28,0,0,0,0.0,0:0,675000
8476955,Taylor,Leier,1994-02-15,LW,L,2015-16,6,0,0,0,0.0,0,3,0.0,0,2780.0,7:43,0,0,0,0.0,2,3,3,1,2,0,0,0,7.0,0:1,0,0,0,17.0,0:2,779617
8476958,Jaccob,Slavin,1994-05-01,D,L,2015-16,63,2,18,20,0.32,1,84,2.38,8,79331.0,20:59,0,0,0,0.0,41,119,54,25,29,0,4,4,3255.0,0:51,0,1,1,7960.0,2:6,742500
8476960,Andreas,Athanasiou,1994-08-06,LW,L,2015-16,37,9,5,14,0.38,1,53,16.98,5,20019.0,9:1,53,76,129,41.09,17,8,11,7,4,0,0,0,42.0,0:1,1,0,1,1127.0,0:30,628333
8476967,Brett,Kulak,1994-01-06,D,L,2015-16,8,0,0,0,0.0,-2,9,0.0,0,5926.0,12:20,0,0,0,0.0,2,3,3,4,-1,0,0,0,0.0,0:0,0,0,0,50.0,0:6,656667
8476975,Cedric,Paquette,1993-08-13,C,L,2015-16,56,6,5,11,0.2,-2,50,12.0,51,42804.0,12:44,141,142,283,49.82,137,31,16,13,3,0,0,0,534.0,0:9,1,0,1,5064.0,1:30,633333
8476979,Erik,Gustafsson,1992-03-14,D,L,2015-16,41,0,14,14,0.34,11,58,0.0,4,38006.0,15:26,0,0,0,0.0,29,37,9,12,-3,0,1,1,4129.0,1:40,0,0,0,181.0,0:4,667500
8476981,Josh,Anderson,1994-05-07,RW,R,2015-16,12,1,3,4,0.33,0,11,9.09,2,7703.0,10:41,0,0,0,0.0,40,4,4,1,3,0,0,0,15.0,0:1,0,0,0,47.0,0:3,678333
8476989,Petteri,Lindbohm,1993-09-23,D,L,2015-16,10,0,0,0,0.0,-4,9,0.0,7,8273.0,13:47,0,0,0,0.0,14,11,2,1,1,0,0,0,8.0,0:0,0,0,0,58.0,0:5,636667
8476994,Vinnie,Hinostroza,1994-04-03,LW,R,2015-16,7,0,0,0,0.0,-1,6,0.0,6,3650.0,8:41,13,19,32,40.62,2,2,3,1,2,0,0,0,62.0,0:8,0,0,0,0.0,0:0,717500
8477006,Christoph,Bertschy,1994-04-05,C,R,2015-16,3,0,0,0,0.0,0,3,0.0,0,1250.0,6:56,0,0,0,0.0,7,2,0,0,0,0,0,0,0.0,0:0,0,0,0,0.0,0:0,775833
8477010,Joseph,Blandisi,1994-07-18,LW,L,2015-16,41,5,12,17,0.41,-14,43,11.63,34,38382.0,15:36,11,22,33,33.33,39,13,19,8,11,4,2,6,5129.0,2:5,0,0,0,77.0,0:1,648333
8477015,Connor,Brown,1994-01-14,RW,R,2015-16,7,1,5,6,0.86,-2,11,9.09,0,6288.0,14:58,0,0,0,0.0,1,2,4,0,4,1,3,4,1443.0,3:26,0,1,1,197.0,0:28,686667
8477018,Ben,Hutton,1993-04-20,D,L,2015-16,75,1,24,25,0.33,-21,104,0.96,14,89430.0,19:52,0,0,0,0.0,42,100,30,53,-23,0,7,7,10273.0,2:16,0,0,0,4102.0,0:54,896250
8477033,Viktor,Loov,1992-11-16,D,L,2015-16,4,0,2,2,0.5,4,1,0.0,0,2510.0,10:27,0,0,0,0.0,8,1,0,0,0,0,0,0,0.0,0:0,0,0,0,78.0,0:19,692500
8477076,JC,Lipon,1993-07-10,RW,R,2015-16,9,0,1,1,0.11,0,4,0.0,5,3762.0,6:58,0,0,0,0.0,29,2,1,0,1,0,0,0,0.0,0:0,0,0,0,0.0,0:0,645000
8477126,Jayson,Megna,1990-02-01,C,R,2015-16,6,1,1,2,0.33,-1,9,11.11,2,4409.0,12:14,1,0,1,100.0,6,1,1,2,-1,0,0,0,625.0,1:44,0,0,0,0.0,0:0,600000
8477205,Andrej,Sustr,1990-11-29,D,R,2015-16,77,4,17,21,0.27,-2,65,6.15,30,77784.0,16:50,0,0,0,0.0,29,66,16,34,-18,0,0,0,390.0,0:5,0,0,0,8426.0,1:49,1450000
8477210,Buddy,Robinson,1991-09-30,RW,R,2015-16,3,1,1,2,0.67,2,5,20.0,4,1548.0,8:36,0,1,1,0.0,11,1,0,1,-1,0,0,0,4.0,0:1,0,0,0,0.0,0:0,925000
8477213,Tim,Schaller,1990-11-16,C,L,2015-16,17,1,2,3,0.18,3,18,5.56,2,8490.0,8:19,40,73,113,35.4,13,9,3,4,-1,0,0,0,10.0,0:0,1,0,1,1205.0,1:10,874125
8477215,Danny,DeKeyser,1990-03-07,D,L,2015-16,78,8,12,20,0.26,2,72,11.11,44,102045.0,21:48,0,0,0,0.0,88,107,17,38,-21,0,0,0,2401.0,0:30,0,0,0,12570.0,2:41,2187500
8477220,Nate,Schmidt,1991-07-16,D,L,2015-16,72,2,14,16,0.22,12,80,2.5,16,78061.0,18:4,0,0,0,0.0,69,111,34,42,-8,0,0,0,257.0,0:3,0,0,0,5816.0,1:20,812500
8477244,Chad,Ruhwedel,1990-05-07,D,R,2015-16,1,0,0,0,0.0,0,1,0.0,2,930.0,15:30,0,0,0,0.0,3,2,0,1,-1,0,0,0,121.0,2:1,0,0,0,0.0,0:0,650000
8477249,Andrew,Miller,1988-09-18,C,R,2015-16,6,0,0,0,0.0,-1,3,0.0,0,3284.0,9:7,13,16,29,44.83,4,0,1,0,1,0,0,0,67.0,0:11,0,0,0,0.0,0:0,630000
8477290,Michael,Raffl,1988-12-01,LW,L,2015-16,82,13,18,31,0.38,9,132,9.85,30,70353.0,14:17,33,49,82,40.24,135,34,31,22,9,1,1,2,6362.0,1:17,0,0,0,355.0,0:4,1100000
8477300,Viktor,Svedberg,1991-05-24,D,L,2015-16,27,2,2,4,0.15,-5,40,5.0,4,25520.0,15:45,0,0,0,0.0,11,28,7,10,-3,0,0,0,402.0,0:14,0,0,0,1466.0,0:54,575000
8477326,Joel,Vermin,1992-02-05,RW,L,2015-16,6,0,1,1,0.17,1,1,0.0,0,3290.0,9:8,1,0,1,100.0,6,2,0,1,-1,0,0,0,302.0,0:50,0,0,0,0.0,0:0,600000
8477392,Hudson,Fasching,1995-07-28,RW,R,2015-16,7,1,1,2,0.29,2,9,11.11,4,4839.0,11:31,0,0,0,0.0,8,1,4,2,2,0,0,0,0.0,0:0,0,0,0,0.0,0:0,925000
8477406,Mattias,Janmark,1992-12-08,C,L,2015-16,73,15,14,29,0.4,12,108,13.89,16,62077.0,14:10,94,166,260,36.15,4,21,26,36,-10,0,1,1,2747.0,0:37,1,0,1,1888.0,0:25,733750
8477407,Anthony,Duclair,1995-08-26,LW,L,2015-16,81,20,24,44,0.54,12,105,19.05,49,69884.0,14:22,0,1,1,0.0,27,27,26,18,8,8,4,12,13776.0,2:50,0,0,0,34.0,0:0,772500
8477413,Sven,Andrighetto,1993-03-21,RW,L,2015-16,44,7,10,17,0.39,1,74,9.46,6,37271.0,14:7,3,4,7,42.86,71,17,9,13,-4,1,1,2,3548.0,1:20,0,0,0,28.0,0:0,633333
8477415,Anton,Slepyshev,1994-05-13,LW,R,2015-16,11,0,1,1,0.09,-5,5,0.0,2,5736.0,8:41,1,0,1,100.0,13,1,2,2,0,0,0,0,134.0,0:12,0,0,0,0.0,0:0,925000
8477416,Oliver,Bjorkstrand,1995-04-10,RW,R,2015-16,12,4,4,8,0.67,6,25,16.0,0,11503.0,15:58,0,0,0,0.0,9,5,6,6,0,0,0,0,1533.0,2:7,0,0,0,31.0,0:2,655833
8477425,Miles,Wood,1995-09-13,LW,L,2015-16,1,0,0,0,0.0,0,2,0.0,0,786.0,13:6,0,0,0,0.0,1,0,0,0,0,0,0,0,7.0,0:7,0,0,0,0.0,0:0,925000
8477426,Nick,Paul,1995-03-20,LW,L,2015-16,24,2,3,5,0.21,-3,28,7.14,6,17559.0,12:11,31,29,60,51.67,43,9,9,2,7,0,0,0,245.0,0:10,0,0,0,134.0,0:5,670000
8477427,Tobias,Lindberg,1995-07-22,RW,L,2015-16,6,0,2,2,0.33,0,12,0.0,4,5702.0,15:50,0,3,3,0.0,10,1,2,2,0,0,0,0,693.0,1:55,0,0,0,232.0,0:38,693333
8477429,Andrew,Copp,1994-07-08,C,L,2015-16,77,7,6,13,0.17,8,54,12.96,6,36975.0,8:0,224,262,486,46.09,87,18,10,18,-8,0,0,0,147.0,0:1,0,0,0,3725.0,0:48,925000
8477433,Ben,Harpur,1995-01-12,D,L,2015-16,5,0,1,1,0.2,1,3,0.0,2,4098.0,13:39,0,0,0,0.0,9,7,0,2,-2,0,0,0,0.0,0:0,0,0,0,88.0,0:17,653333
8477444,Andre,Burakovsky,1995-02-09,LW,L,2015-16,79,17,21,38,0.48,4,126,13.49,12,61736.0,13:1,17,20,37,45.95,37,24,34,30,4,0,4,4,3785.0,0:47,0,0,0,1.0,0:0,894167
8477445,Hunter,Shinkaruk,1994-10-13,C,L,2015-16,8,2,1,3,0.38,-4,12,16.67,2,7183.0,14:57,0,1,1,0.0,9,3,1,2,-1,1,1,2,894.0,1:51,0,0,0,16.0,0:2,863333
8477446,Michael,McCarron,1995-03-07,RW,R,2015-16,20,1,1,2,0.1,-10,41,2.44,37,14018.0,11:40,85,84,169,50.3,49,8,4,7,-3,0,0,0,1462.0,1:13,0,0,0,0.0,0:0,863333
8477447,Shea,Theodore,1995-08-03,D,L,2015-16,19,3,5,8,0.42,7,28,10.71,2,21784.0,19:6,0,0,0,0.0,6,22,10,17,-7,2,1,3,3169.0,2:46,0,0,0,1355.0,1:11,863333
8477448,Marko,Dano,1994-11-30,C,L,2015-16,34,5,5,10,0.29,-7,54,9.26,10,24993.0,12:15,2,4,6,33.33,62,15,10,15,-5,0,1,1,1697.0,0:49,0,0,0,17.0,0:0,925000
8477450,Jason,Dickinson,1995-07-04,C,L,2015-16,1,1,0,1,1.0,1,2,50.0,0,715.0,11:55,1,6,7,14.29,0,1,0,1,-1,0,0,0,0.0,0:0,0,0,0,0.0,0:0,894167
8477451,Ryan,Hartman,1994-09-20,RW,R,2015-16,3,0,1,1,0.33,-1,3,0.0,0,1663.0,9:14,1,3,4,25.0,5,3,3,1,2,0,0,0,0.0,0:0,0,0,0,0.0,0:0,863333
8477453,Chris,Bigras,1995-02-22,D,L,2015-16,31,1,2,3,0.1,-2,21,4.76,16,24816.0,13:20,0,0,0,0.0,17,17,4,8,-4,0,0,0,44.0,0:1,0,0,0,1024.0,0:33,843333
8477455,Jacob,de la Rose,1995-05-20,LW,L,2015-16,22,0,1,1,0.05,-6,20,0.0,6,16414.0,12:26,67,63,130,51.54,39,19,6,3,3,0,0,0,57.0,0:2,0,0,0,1734.0,1:18,925000
8477460,Laurent,Dauphin,1995-03-27,C,L,2015-16,8,1,0,1,0.12,0,7,14.29,4,5431.0,11:18,32,41,73,43.84,6,7,3,0,3,0,0,0,55.0,0:6,0,0,0,425.0,0:53,745000
8477463,Steven,Santini,1995-03-07,D,R,2015-16,1,0,0,0,0.0,2,1,0.0,2,875.0,14:35,0,0,0,0.0,0,2,0,1,-1,0,0,0,22.0,0:22,0,0,0,0.0,0:0,925000
8477464,Nic,Petan,1995-03-22,LW,L,2015-16,26,2,4,6,0.23,2,25,8.0,10,18326.0,11:44,12,9,21,57.14,7,4,11,8,3,0,1,1,2827.0,1:48,0,0,0,29.0,0:1,758333
8477467,Gustav,Olofsson,1994-12-01,D,L,2015-16,2,0,0,0,0.0,0,1,0.0,0,1103.0,9:11,0,0,0,0.0,2,0,0,2,-2,0,0,0,0.0,0:0,0,0,0,39.0,0:19,795000
8477473,Justin,Bailey,1995-07-01,RW,R,2015-16,8,0,0,0,0.0,-2,22,0.0,2,5569.0,11:36,0,0,0,0.0,8,6,4,3,1,0,0,0,133.0,0:16,0,0,0,0.0,0:0,670000
8477486,Emile,Poirier,1994-12-14,LW,L,2015-16,2,0,0,0,0.0,-1,3,0.0,2,1667.0,13:53,0,0,0,0.0,4,1,1,0,1,0,0,0,56.0,0:28,0,0,0,0.0,0:0,863333
8477488,Brett,Pesce,1994-11-15,D,R,2015-16,69,4,12,16,0.23,-7,85,4.71,16,77700.0,18:46,0,1,1,0.0,30,83,43,22,21,1,4,5,3965.0,0:57,0,0,0,4656.0,1:7,809167
8477492,Nathan,MacKinnon,1995-09-01,C,R,2015-16,72,21,31,52,0.72,-4,245,8.57,20,81501.0,18:51,507,540,1047,48.42,46,53,28,39,-11,7,9,16,12620.0,2:55,0,1,1,2503.0,0:34,925000
8477493,Aleksander,Barkov,1995-09-02,C,L,2015-16,66,28,31,59,0.89,18,171,16.37,8,76943.0,19:25,569,587,1156,49.22,43,39,45,29,16,9,7,16,11255.0,2:50,1,1,2,7086.0,1:47,925000
8477494,Jonathan,Drouin,1995-03-28,LW,L,2015-16,21,4,6,10,0.48,1,25,16.0,4,18198.0,14:26,9,10,19,47.37,18,2,8,11,-3,0,2,2,2539.0,2:0,0,0,0,29.0,0:1,894167
8477495,Seth,Jones,1994-10-03,D,R,2015-16,81,3,28,31,0.38,-14,157,1.91,22,107292.0,22:4,0,0,0,0.0,86,118,25,69,-44,1,12,13,12373.0,2:32,0,1,1,9966.0,2:3,925000
8477496,Elias,Lindholm,1994-12-02,C,R,2015-16,82,11,28,39,0.48,-23,176,6.25,24,89108.0,18:6,213,221,434,49.08,112,45,33,34,-1,2,14,16,12771.0,2:35,0,0,0,4017.0,0:48,925000
8477497,Sean,Monahan,1994-10-12,C,L,2015-16,81,27,36,63,0.78,-6,197,13.71,18,93166.0,19:10,887,852,1739,51.01,38,37,55,38,17,7,13,20,15727.0,3:14,0,0,0,3901.0,0:48,925000
8477498,Darnell,Nurse,1995-02-04,D,L,2015-16,69,3,7,10,0.14,-13,120,2.5,60,83755.0,20:13,0,0,0,0.0,160,103,13,43,-30,0,1,1,922.0,0:13,0,1,1,8457.0,2:2,863333
8477499,Rasmus,Ristolainen,1994-10-27,D,R,2015-16,82,9,32,41,0.5,-21,202,4.46,33,124381.0,25:16,0,0,0,0.0,139,137,20,48,-28,4,17,21,15377.0,3:7,0,0,0,12990.0,2:38,925000
8477500,Bo,Horvat,1995-04-05,C,L,2015-16,82,16,24,40,0.49,-30,155,10.32,18,84291.0,17:7,760,733,1493,50.9,69,53,27,17,10,4,8,12,8843.0,1:47,0,0,0,11145.0,2:15,894167
8477501,Valeri,Nichushkin,1995-03-04,RW,L,2015-16,79,9,20,29,0.37,2,139,6.47,12,66036.0,13:55,0,1,1,0.0,68,33,33,46,-13,1,1,2,4693.0,0:59,0,0,0,32.0,0:0,925000
8477503,Max,Domi,1995-03-02,LW,L,2015-16,81,18,34,52,0.64,3,156,11.54,72,79579.0,16:22,20,35,55,36.36,34,25,28,41,-13,3,12,15,14652.0,3:0,0,1,1,1129.0,0:13,863333
8477504,Josh,Morrissey,1995-03-28,D,L,2015-16,1,0,0,0,0.0,0,1,0.0,0,954.0,15:54,0,0,0,0.0,1,2,0,1,-1,0,0,0,9.0,0:9,0,0,0,0.0,0:0,863333
8477505,Alexander,Wennberg,1994-09-22,C,L,2015-16,69,8,32,40,0.58,-1,97,8.25,2,65663.0,15:51,400,522,922,43.38,32,46,42,21,21,1,11,12,8988.0,2:10,0,0,0,2916.0,0:42,925000
8477506,Ryan,Pulock,1994-10-06,D,R,2015-16,15,2,2,4,0.27,1,15,13.33,5,14156.0,15:43,0,0,0,0.0,13,11,3,5,-2,0,0,0,1082.0,1:12,0,0,0,311.0,0:20,863333
8477507,Nikita,Zadorov,1995-04-16,D,L,2015-16,22,0,2,2,0.09,-5,18,0.0,12,22351.0,16:55,0,0,0,0.0,53,16,6,10,-4,0,0,0,576.0,0:26,0,0,0,1127.0,0:51,894167
8477508,Curtis,Lazar,1995-02-02,C,R,2015-16,76,6,14,20,0.26,-1,78,7.69,18,63196.0,13:51,168,216,384,43.75,118,47,24,15,9,1,1,2,3895.0,0:51,1,3,4,6453.0,1:24,894167
8477509,Mirco,Mueller,1995-03-21,D,L,2015-16,11,0,0,0,0.0,-4,8,0.0,7,6998.0,10:36,0,0,0,0.0,2,3,1,6,-5,0,0,0,234.0,0:21,0,0,0,0.0,0:0,894167
8477510,Kerby,Rychel,1994-10-07,LW,L,2015-16,32,2,7,9,0.28,5,32,6.25,15,18267.0,9:30,1,2,3,33.33,39,9,9,9,0,0,0,0,72.0,0:2,0,0,0,9.0,0:0,863333
8477511,Anthony,Mantha,1994-09-16,RW,L,2015-16,10,2,1,3,0.3,-6,18,11.11,2,7020.0,11:42,0,0,0,0.0,4,3,4,2,2,2,0,2,1170.0,1:57,0,0,0,0.0,0:0,863333
8477512,Frederik,Gauthier,1995-04-26,C,L,2015-16,7,0,1,1,0.14,-5,3,0.0,0,5815.0,13:50,52,58,110,47.27,10,7,1,1,0,0,0,0,19.0,0:2,0,1,1,1254.0,2:59,863333
8477566,Sergey,Tolchinsky,1995-02-03,LW,L,2015-16,2,0,1,1,0.5,1,1,0.0,0,1415.0,11:47,0,1,1,0.0,1,0,1,0,1,0,0,0,0.0,0:0,0,0,0,0.0,0:0,616667
8477589,Ronalds,Kenins,1991-02-28,LW,L,2015-16,8,0,0,0,0.0,-1,6,0.0,6,5477.0,11:24,1,2,3,33.33,19,2,3,2,1,0,0,0,2.0,0:0,0,0,0,50.0,0:6,600000
8477591,Josh,Jooris,1990-07-14,RW,R,2015-16,59,4,9,13,0.22,-1,80,5.0,39,43501.0,12:17,114,143,257,44.36,62,33,14,14,0,0,0,0,589.0,0:9,0,2,2,5486.0,1:32,975000
8477642,Rinat,Valiev,1995-05-11,D,L,2015-16,10,0,0,0,0.0,0,7,0.0,0,7350.0,12:15,0,0,0,0.0,9,4,1,3,-2,0,0,0,0.0,0:0,0,0,0,5.0,0:0,778333
8477715,Tyler,Gaudet,1993-04-04,C,L,2015-16,14,1,2,3,0.21,-2,6,16.67,0,8904.0,10:36,43,49,92,46.74,23,4,2,3,-1,0,0,0,34.0,0:2,0,0,0,1153.0,1:22,925000
8477810,Joel,Hanley,1991-06-08,D,L,2015-16,10,0,6,6,0.6,0,10,0.0,0,9599.0,15:59,0,0,0,0.0,6,19,2,4,-2,0,0,0,441.0,0:44,0,0,0,556.0,0:55,667500
8477816,Michael,Zalewski,1992-08-18,LW,L,2015-16,3,0,1,1,0.33,1,2,0.0,2,2134.0,11:51,6,4,10,60.0,7,0,0,1,-1,0,0,0,0.0,0:0,0,0,0,0.0,0:0,575000
8477839,Conor,Sheary,1992-06-08,LW,L,2015-16,44,7,3,10,0.23,-1,51,13.73,8,25748.0,9:45,1,7,8,12.5,15,5,7,9,-2,0,0,0,2004.0,0:45,0,0,0,24.0,0:0,667500
8477845,Trevor,van Riemsdyk,1991-07-24,D,R,2015-16,82,3,11,14,0.17,-5,85,3.53,31,98320.0,19:59,0,0,0,0.0,44,155,17,45,-28,0,2,2,2842.0,0:34,0,1,1,8463.0,1:43,925000
8477850,Christian,Folin,1991-02-09,D,R,2015-16,26,0,4,4,0.15,-1,14,0.0,11,22745.0,14:34,0,0,0,0.0,38,30,4,10,-6,0,0,0,10.0,0:0,0,0,0,2301.0,1:28,725000
8477851,Jordan,Oesterle,1992-06-25,D,L,2015-16,17,0,5,5,0.29,1,24,0.0,0,22123.0,21:41,0,0,0,0.0,11,26,8,12,-4,0,0,0,1957.0,1:55,0,0,0,1331.0,1:18,767500
8477887,Patrick,Brown,1992-05-29,C,R,2015-16,7,1,1,2,0.29,4,8,12.5,4,5294.0,12:36,0,0,0,0.0,11,6,2,4,-2,0,0,0,40.0,0:5,0,0,0,0.0,0:0,652500
8477901,Daniel,Carr,1991-11-01,LW,L,2015-16,23,6,3,9,0.39,0,39,15.38,8,16661.0,12:4,0,0,0,0.0,25,5,7,4,3,1,0,1,1315.0,0:57,0,0,0,0.0,0:0,842500
8477902,Dennis,Everberg,1991-12-31,RW,L,2015-16,15,0,0,0,0.0,-5,9,0.0,0,8049.0,8:56,0,0,0,0.0,11,12,0,3,-3,0,0,0,16.0,0:1,0,0,0,772.0,0:51,612500
8477903,Garnet,Hathaway,1991-11-23,RW,R,2015-16,14,0,3,3,0.21,-1,11,0.0,31,10095.0,12:1,1,3,4,25.0,50,17,4,3,1,0,0,0,97.0,0:6,0,1,1,518.0,0:37,690000
8477916,Borna,Rendulic,1992-03-25,RW,R,2015-16,3,0,0,0,0.0,-2,1,0.0,0,1355.0,7:31,0,3,3,0.0,1,3,1,0,1,0,0,0,0.0,0:0,0,0,0,0.0,0:0,622500
8477922,Melker,Karlsson,1990-07-18,C,R,2015-16,65,10,9,19,0.29,5,96,10.42,16,52742.0,13:31,11,12,23,47.83,76,48,24,14,10,0,0,0,1762.0,0:27,0,0,0,4604.0,1:10,1650000
8477929,Dennis,Rasmussen,1990-07-03,C,L,2015-16,44,4,5,9,0.2,9,42,9.52,4,24192.0,9:9,144,163,307,46.91,36,20,7,5,2,0,0,0,118.0,0:2,0,0,0,98.0,0:2,575000
8477930,Pierre-Edouard,Bellemare,1985-03-06,LW,L,2015-16,74,7,7,14,0.19,-8,102,6.86,27,60246.0,13:34,272,307,579,46.98,65,61,37,23,14,0,0,0,255.0,0:3,1,1,2,11474.0,2:35,712500
8477931,Tomas,Nosek,1992-09-01,LW,L,2015-16,6,0,0,0,0.0,-2,2,0.0,2,3650.0,10:8,4,4,8,50.0,6,0,3,0,3,0,0,0,25.0,0:4,0,0,0,525.0,1:27,792500
8477932,Aaron,Ekblad,1996-02-07,D,R,2015-16,78,15,21,36,0.46,18,182,8.24,41,101449.0,21:40,0,0,0,0.0,87,59,24,41,-17,3,6,9,13275.0,2:50,0,0,0,3477.0,0:44,925000
8477933,Sam,Reinhart,1995-11-06,C,R,2015-16,79,23,19,42,0.53,-8,165,13.94,8,79803.0,16:50,36,72,108,33.33,26,26,19,20,-1,8,2,10,13904.0,2:56,0,0,0,120.0,0:1,894167
8477934,Leon,Draisaitl,1995-10-27,C,L,2015-16,72,19,32,51,0.71,-2,133,14.29,20,78014.0,18:3,502,536,1038,48.36,38,18,40,61,-21,5,4,9,11037.0,2:33,0,0,0,239.0,0:3,925000
8477935,Sam,Bennett,1996-06-20,C,L,2015-16,77,18,18,36,0.47,-11,136,13.24,37,69975.0,15:8,160,187,347,46.11,110,32,34,27,7,3,5,8,9058.0,1:57,0,0,0,134.0,0:1,925000
8477937,Jake,Virtanen,1996-08-17,RW,R,2015-16,55,7,6,13,0.24,-7,94,7.45,45,38161.0,11:33,2,3,5,40.0,128,22,22,15,7,1,0,1,3012.0,0:54,0,0,0,0.0,0:0,894167
8477939,William,Nylander,1996-05-01,C,R,2015-16,22,6,7,13,0.59,1,43,13.95,4,21566.0,16:20,143,148,291,49.14,5,5,16,10,6,1,2,3,3585.0,2:42,0,0,0,14.0,0:0,894167
8477940,Nikolaj,Ehlers,1996-02-14,LW,L,2015-16,72,15,23,38,0.53,3,167,8.98,21,69556.0,16:6,0,2,2,0.0,29,25,20,37,-17,4,7,11,9972.0,2:18,0,0,0,69.0,0:0,894167
8477941,Nick,Ritchie,1995-12-05,LW,L,2015-16,33,2,2,4,0.12,-2,55,3.64,37,23289.0,11:45,1,2,3,33.33,93,10,8,4,4,0,0,0,1376.0,0:41,0,0,0,22.0,0:0,894167
8477942,Kevin,Fiala,1996-07-22,LW,L,2015-16,5,1,0,1,0.2,0,11,9.09,0,3946.0,13:9,0,0,0,0.0,2,2,0,3,-3,0,0,0,193.0,0:38,0,0,0,0.0,0:0,894167
8477946,Dylan,Larkin,1996-07-30,C,L,2015-16,80,23,22,45,0.56,11,221,10.41,34,79412.0,16:32,41,59,100,41.0,65,25,43,39,4,4,1,5,9806.0,2:2,0,0,0,505.0,0:6,925000
8477947,Sonny,Milano,1996-05-12,LW,L,2015-16,3,0,1,1,0.33,1,2,0.0,0,2408.0,13:22,0,0,0,0.0,4,2,1,1,0,0,0,0,0.0,0:0,0,0,0,0.0,0:0,894167
8477952,Robby,Fabbri,1996-01-22,C,L,2015-16,72,18,19,37,0.51,-2,114,15.79,25,57521.0,13:18,6,9,15,40.0,51,9,27,20,7,2,6,8,6227.0,1:26,0,0,0,55.0,0:0,894167
8477953,Kasperi,Kapanen,1996-07-23,RW,R,2015-16,9,0,0,0,0.0,-3,14,0.0,2,7981.0,14:46,0,0,0,0.0,10,1,4,1,3,0,0,0,944.0,1:44,0,0,0,0.0,0:0,894167
8477955,Jared,McCann,1996-05-31,C,L,2015-16,69,9,9,18,0.26,-6,106,8.49,32,51841.0,12:31,181,341,522,34.67,45,19,30,26,4,1,2,3,4655.0,1:7,0,0,0,131.0,0:1,894167
8477956,David,Pastrnak,1996-05-25,RW,R,2015-16,51,15,11,26,0.51,3,108,13.89,20,42672.0,13:56,0,3,3,0.0,52,15,35,51,-16,0,1,1,1432.0,0:28,0,0,0,25.0,0:0,925000
8477958,Nikolay,Goldobin,1995-10-07,RW,L,2015-16,9,1,1,2,0.22,1,7,14.29,0,6040.0,11:11,0,0,0,0.0,0,1,3,1,2,0,0,0,13.0,0:1,0,0,0,13.0,0:1,894167
8477997,Nikita,Tryamkin,1994-08-30,D,L,2015-16,13,1,1,2,0.15,-3,11,9.09,10,13665.0,17:31,0,0,0,0.0,31,23,1,3,-2,0,0,0,87.0,0:6,0,0,0,972.0,1:14,925000
8478029,Chase,De Leo,1995-10-25,C,L,2015-16,2,0,0,0,0.0,1,2,0.0,0,1130.0,9:25,1,0,1,100.0,3,0,0,0,0,0,0,0,49.0,0:24,0,0,0,0.0,0:0,720833
8478042,Viktor,Arvidsson,1993-04-08,LW,R,2015-16,56,8,8,16,0.29,-8,139,5.76,35,41668.0,12:24,0,0,0,0.0,27,35,15,17,-2,1,0,1,1128.0,0:20,0,0,0,346.0,0:6,631667
8478137,Jiri,Sekac,1992-06-10,LW,L,2015-16,39,1,5,6,0.15,-5,49,2.04,16,27297.0,11:39,2,2,4,50.0,50,18,14,9,5,1,1,2,1850.0,0:47,0,0,0,22.0,0:0,925000
8478366,Frank,Vatrano,1994-03-14,C,L,2015-16,39,8,3,11,0.28,-3,99,8.08,14,27800.0,11:52,0,3,3,0.0,61,23,16,11,5,0,0,0,464.0,0:11,0,0,0,13.0,0:0,792500
8478373,Nikita,Soshnikov,1993-10-14,RW,L,2015-16,11,2,3,5,0.45,-4,33,6.06,6,10310.0,15:37,0,1,1,0.0,34,6,2,3,-1,1,0,1,1004.0,1:31,0,0,0,32.0,0:2,736666
8478393,Kyle,Baun,1992-05-04,RW,R,2015-16,2,0,0,0,0.0,-2,1,0.0,0,1086.0,9:3,0,0,0,0.0,3,0,0,0,0,0,0,0,0.0,0:0,0,0,0,0.0,0:0,858750
8478396,Noah,Hanifin,1997-01-25,D,L,2015-16,79,4,18,22,0.28,-14,122,3.28,22,84865.0,17:54,0,0,0,0.0,67,78,42,49,-7,1,6,7,11230.0,2:22,0,0,0,416.0,0:5,925000
8478401,Pavel,Zacha,1997-04-06,C,L,2015-16,1,0,2,2,2.0,4,3,0.0,0,1011.0,16:51,3,6,9,33.33,1,0,2,0,2,0,0,0,254.0,4:14,0,0,0,55.0,0:55,925000
8478402,Connor,McDavid,1997-01-13,C,L,2015-16,45,16,32,48,1.07,-1,105,15.24,18,50989.0,18:53,249,355,604,41.23,12,10,33,17,16,3,11,14,8002.0,2:57,0,0,0,2109.0,0:46,925000
8478403,Jack,Eichel,1996-10-28,C,R,2015-16,81,24,32,56,0.69,-16,238,10.08,22,92931.0,19:7,402,578,980,41.02,43,25,43,49,-6,8,13,21,14781.0,3:2,0,0,0,1827.0,0:22,925000
8478420,Mikko,Rantanen,1996-10-29,RW,L,2015-16,9,0,0,0,0.0,-7,9,0.0,2,4837.0,8:57,13,11,24,54.17,0,11,1,1,0,0,0,0,0.0,0:0,0,0,0,18.0,0:2,925000
8478430,Oliver,Kylington,1997-05-19,D,L,2015-16,1,0,0,0,0.0,0,1,0.0,0,1042.0,17:22,0,0,0,0.0,0,1,0,0,0,0,0,0,38.0,0:38,0,0,0,1.0,0:1,792500
8478466,Daniel,Sprong,1997-03-17,RW,R,2015-16,18,2,0,2,0.11,-1,23,8.7,0,9423.0,8:43,1,1,2,50.0,14,3,4,5,-1,0,0,0,442.0,0:24,0,0,0,64.0,0:3,692500
8478528,Tanner,Kero,1992-07-24,C,L,2015-16,17,1,2,3,0.18,-2,26,3.85,2,12539.0,12:17,55,68,123,44.72,19,10,8,0,8,0,0,0,173.0,0:10,0,0,0,1652.0,1:37,667500
8478541,Markus,Hannikainen,1993-03-26,LW,L,2015-16,4,0,0,0,0.0,-2,3,0.0,0,1715.0,7:8,0,0,0,0.0,7,0,1,0,1,0,0,0,14.0,0:3,0,0,0,12.0,0:3,717500
8478542,Evan,Rodrigues,1993-07-28,LW,R,2015-16,2,1,1,2,1.0,2,8,12.5,0,1410.0,11:45,0,0,0,0.0,3,0,0,0,0,0,0,0,91.0,0:45,0,0,0,0.0,0:0,842500
8478550,Artemi,Panarin,1991-10-30,LW,R,2015-16,80,30,47,77,0.96,8,187,16.04,32,88898.0,18:31,0,0,0,0.0,46,14,29,35,-6,8,16,24,13622.0,2:50,0,0,0,65.0,0:0,812500
8478561,Andreas,Martinsen,1990-06-13,LW,L,2015-16,55,4,7,11,0.2,-4,52,7.69,47,36621.0,11:5,1,3,4,25.0,155,27,11,5,6,0,0,0,258.0,0:4,0,0,0,114.0,0:2,742500
8478562,Jakub,Nakladal,1987-12-30,D,R,2015-16,27,2,3,5,0.19,-5,42,4.76,6,22988.0,14:11,0,0,0,0.0,41,23,4,11,-7,0,1,1,2590.0,1:35,0,0,0,15.0,0:0,817500
8478564,Joonas,Kemppainen,1988-04-07,C,L,2015-16,44,2,3,5,0.11,-6,35,5.71,4,33100.0,12:32,227,232,459,49.46,36,18,28,9,19,0,0,0,379.0,0:8,1,0,1,4258.0,1:36,792500
8478566,Sergey,Kalinin,1991-03-17,C,L,2015-16,78,8,7,15,0.19,-9,70,11.43,33,62366.0,13:19,134,188,322,41.61,146,30,25,17,8,3,0,3,6092.0,1:18,0,0,0,1131.0,0:14,925000
8478567,Dean,Kukan,1993-07-08,D,L,2015-16,8,0,0,0,0.0,9,3,0.0,0,8330.0,17:21,0,0,0,0.0,7,10,4,3,1,0,0,0,177.0,0:22,0,0,0,156.0,0:19,767500
8478569,Noel,Acciari,1991-12-01,C,R,2015-16,19,0,1,1,0.05,-4,18,0.0,8,11277.0,9:53,60,76,136,44.12,52,4,1,4,-3,0,0,0,101.0,0:5,0,0,0,1460.0,1:16,792500
8478584,Vojtech,Mozik,1992-12-26,D,R,2015-16,7,0,0,0,0.0,0,6,0.0,4,5561.0,13:14,0,0,0,0.0,12,5,0,1,-1,0,0,0,30.0,0:4,0,0,0,0.0,0:0,680000
8478585,Derek,Ryan,1986-12-29,C,R,2015-16,6,2,0,2,0.33,1,5,40.0,2,4393.0,12:12,35,24,59,59.32,2,0,4,2,2,1,0,1,323.0,0:53,0,0,0,0.0,0:0,600000
8478866,Dominik,Simon,1994-08-08,C,L,2015-16,3,0,1,1,0.33,0,2,0.0,0,1093.0,6:4,0,0,0,0.0,1,1,0,1,-1,0,0,0,0.0,0:0,0,0,0,0.0,0:0,692500
8478928,Sergei,Plotnikov,1990-06-03,LW,L,2015-16,45,0,3,3,0.07,-3,41,0.0,24,26672.0,9:52,1,1,2,50.0,107,10,12,15,-3,0,0,0,313.0,0:6,0,0,0,273.0,0:6,925000
8478963,Ryan,Johnston,1992-02-14,D,R,2015-16,3,0,0,0,0.0,1,1,0.0,0,2930.0,16:16,0,0,0,0.0,2,2,0,1,-1,0,0,0,63.0,0:21,0,0,0,0.0,0:0,680000
8479268,Casey,Nelson,1992-07-18,D,R,2015-16,7,0,4,4,0.57,1,5,0.0,8,6225.0,14:49,0,0,0,0.0,5,4,1,2,-1,0,2,2,785.0,1:52,0,0,0,0.0,0:0,1738026
8479293,Brandon,Tanev,1991-12-31,LW,L,2015-16,3,0,0,0,0.0,0,4,0.0,2,2168.0,12:2,0,0,0,0.0,7,2,0,0,0,0,0,0,21.0,0:7,0,0,0,187.0,1:2,2266250
8448208,Jaromir,Jagr,1972-02-15,RW,L,2016-17,82,16,30,46,0.56,2,181,8.84,56,83639.0,16:59,1,1,2,50.0,21,4,40,44,-4,8,5,13,13609.0,2:45,0,0,0,76.0,0:0,4000000
8462038,Shane,Doan,1976-10-10,RW,R,2016-17,74,6,21,27,0.36,-3,144,4.17,48,66813.0,15:2,94,105,199,47.24,101,22,26,34,-8,3,2,5,6909.0,1:33,0,0,0,1.0,0:0,3876134
8462042,Jarome,Iginla,1977-07-01,RW,R,2016-17,80,14,13,27,0.34,-30,153,9.15,70,72610.0,15:7,16,14,30,53.33,116,21,24,26,-2,7,4,11,10897.0,2:16,0,0,0,110.0,0:1,5333333
8464989,Matt,Cullen,1976-11-02,C,L,2016-17,72,13,18,31,0.43,4,93,13.98,30,60128.0,13:55,440,419,859,51.22,36,27,20,32,-12,2,2,4,1625.0,0:22,2,0,2,10060.0,2:19,1000000
8465009,Zdeno,Chara,1977-03-18,D,L,2016-17,75,10,19,29,0.39,18,136,7.35,59,104997.0,23:19,0,1,1,0.0,130,140,35,62,-27,1,2,3,2040.0,0:27,2,0,2,16973.0,3:46,6916667
8465058,Michal,Rozsival,1978-09-03,D,R,2016-17,22,1,2,3,0.14,-3,16,6.25,14,20454.0,15:29,0,0,0,0.0,47,25,5,10,-5,0,0,0,196.0,0:8,0,0,0,1483.0,1:7,600000
8465978,Shawn,Thornton,1977-07-23,LW,R,2016-17,50,2,2,4,0.08,-7,42,4.76,67,23069.0,7:41,5,10,15,33.33,52,8,8,8,0,0,0,0,458.0,0:9,0,0,0,11.0,0:0,600000
8466138,Joe,Thornton,1979-07-02,C,L,2016-17,79,7,43,50,0.63,7,81,8.64,51,85607.0,18:3,375,362,737,50.88,52,31,64,74,-10,1,18,19,15818.0,3:20,0,0,0,146.0,0:1,6750000
8466139,Patrick,Marleau,1979-09-15,C,L,2016-17,82,27,19,46,0.56,4,190,14.21,28,84416.0,17:9,115,100,215,53.49,82,32,46,51,-5,7,9,16,14866.0,3:1,0,0,0,484.0,0:5,6666667
8466148,Marian,Hossa,1979-01-12,RW,L,2016-17,73,26,19,45,0.62,7,167,15.57,8,73836.0,16:51,5,9,14,35.71,32,36,47,29,18,5,6,11,7585.0,1:43,1,0,1,6739.0,1:32,5275000
8466251,Jason,Chimera,1979-05-02,LW,L,2016-17,82,20,13,33,0.4,1,121,16.53,40,64270.0,13:3,16,18,34,47.06,149,30,20,26,-6,0,0,0,743.0,0:9,1,0,1,5894.0,1:11,2250000
8466285,Brian,Campbell,1979-05-23,D,L,2016-17,80,5,12,17,0.21,12,74,6.76,24,88462.0,18:25,0,0,0,0.0,43,83,11,59,-48,2,3,5,7737.0,1:36,0,0,0,549.0,0:6,1500000
8467370,Mike,Fisher,1980-06-05,C,R,2016-17,72,18,24,42,0.58,1,120,15.0,55,71785.0,16:37,703,577,1280,54.92,160,64,21,19,2,7,10,17,9970.0,2:18,0,0,0,7711.0,1:47,4400000
8467371,Mike,Ribeiro,1980-02-10,C,L,2016-17,46,4,21,25,0.54,-5,38,10.53,14,44077.0,15:58,183,261,444,41.22,33,6,10,27,-17,2,5,7,7085.0,2:34,0,0,0,81.0,0:1,5500000
8467400,Francois,Beauchemin,1980-06-04,D,L,2016-17,81,5,13,18,0.22,-14,132,3.79,32,104566.0,21:30,0,0,0,0.0,73,156,28,47,-19,0,3,3,5202.0,1:4,0,0,0,14746.0,3:2,4500000
8467407,Brian,Gionta,1979-01-18,RW,R,2016-17,82,15,20,35,0.43,-11,149,10.07,22,81698.0,16:36,46,60,106,43.4,54,30,28,26,2,3,4,7,7614.0,1:32,1,1,2,9077.0,1:50,4250000
8467493,Chris,Neil,1979-06-18,RW,R,2016-17,53,1,3,4,0.08,-11,42,2.38,63,24077.0,7:34,0,0,0,0.0,108,20,11,9,2,0,0,0,140.0,0:2,0,0,0,9.0,0:0,1500000
8467496,Andrei,Markov,1978-12-20,D,L,2016-17,62,6,30,36,0.58,18,98,6.12,16,81230.0,21:50,0,0,0,0.0,39,73,28,69,-41,1,11,12,9698.0,2:36,0,1,1,6433.0,1:43,5750000
8467875,Daniel,Sedin,1980-09-26,LW,L,2016-17,82,15,29,44,0.54,-16,216,6.94,32,90456.0,18:23,3,3,6,50.0,20,18,26,30,-4,6,8,14,14325.0,2:54,0,0,0,592.0,0:7,7000000
8467876,Henrik,Sedin,1980-09-26,C,L,2016-17,82,15,35,50,0.61,-27,99,15.15,28,93680.0,19:2,611,635,1246,49.04,15,11,29,52,-23,1,14,15,14656.0,2:58,0,0,0,805.0,0:9,7000000
8467967,Chris,Kelly,1980-11-11,C,L,2016-17,82,5,7,12,0.15,-17,85,5.88,23,58740.0,11:56,223,278,501,44.51,71,48,18,24,-6,0,0,0,187.0,0:2,1,0,1,10329.0,2:5,900000
8468001,Derek,MacKenzie,1981-06-11,C,L,2016-17,82,6,10,16,0.2,-7,91,6.59,50,61819.0,12:33,386,386,772,50.0,192,45,34,25,9,0,0,0,756.0,0:9,2,3,5,11070.0,2:15,1300000
8468083,Henrik,Zetterberg,1980-10-09,C,L,2016-17,82,17,51,68,0.83,15,195,8.72,22,97008.0,19:43,705,657,1362,51.76,58,30,38,37,1,2,11,13,14591.0,2:57,0,0,0,286.0,0:3,6083333
8468085,Radim,Vrbata,1981-06-13,RW,R,2016-17,81,20,35,55,0.68,-18,233,8.58,16,82121.0,16:53,17,30,47,36.17,48,31,34,32,2,4,11,15,13091.0,2:41,0,0,0,1215.0,0:15,1000000
8468208,Joel,Ward,1980-12-02,RW,R,2016-17,78,10,19,29,0.37,-2,105,9.52,30,74613.0,15:56,223,233,456,48.9,61,56,34,52,-18,1,2,3,5799.0,1:14,2,0,2,6398.0,1:22,3275000
8468309,Mark,Streit,1977-12-11,D,L,2016-17,68,6,21,27,0.4,-12,114,5.26,28,76492.0,18:44,0,0,0,0.0,38,92,16,39,-23,1,12,13,9340.0,2:17,0,0,0,2271.0,0:33,5250000
8468483,Marian,Gaborik,1982-02-14,RW,L,2016-17,56,10,11,21,0.38,-4,123,8.13,18,49693.0,14:47,0,1,1,0.0,21,15,7,24,-17,3,2,5,4949.0,1:28,0,0,0,244.0,0:4,4875000
8468486,Scott,Hartnell,1982-04-18,LW,L,2016-17,78,13,24,37,0.47,14,104,12.5,63,56450.0,12:3,3,3,6,50.0,94,40,17,30,-13,2,1,3,6589.0,1:24,0,0,0,26.0,0:0,4750000
8468493,Ron,Hainsey,1981-03-24,D,L,2016-17,72,4,13,17,0.24,-8,71,5.63,21,95169.0,22:1,0,0,0,0.0,93,120,25,47,-22,0,0,0,808.0,0:11,1,2,3,13032.0,3:1,2833333
8468498,Brooks,Orpik,1980-09-26,D,L,2016-17,79,0,14,14,0.18,32,93,0.0,48,84306.0,17:47,0,0,0,0.0,181,132,12,36,-24,0,0,0,92.0,0:1,0,0,0,11365.0,2:23,5500000
8468505,Steve,Ott,1982-08-19,C,L,2016-17,53,3,4,7,0.13,-8,45,6.67,80,34229.0,10:45,153,125,278,55.04,144,23,11,8,3,0,0,0,237.0,0:4,0,0,0,5496.0,1:43,800000
8468508,Justin,Williams,1981-10-04,RW,R,2016-17,80,24,24,48,0.6,14,167,14.37,50,74288.0,15:28,64,53,117,54.7,28,41,37,44,-7,5,5,10,9933.0,2:4,0,0,0,1854.0,0:23,3250000
8468509,Niklas,Kronwall,1981-01-12,D,L,2016-17,57,2,11,13,0.23,-7,67,2.99,32,66530.0,19:27,0,0,0,0.0,77,81,6,23,-17,0,6,6,8461.0,2:28,0,0,0,3472.0,1:0,4750000
8468513,Nick,Schultz,1982-08-25,D,L,2016-17,28,0,4,4,0.14,1,25,0.0,10,25627.0,15:15,0,0,0,0.0,45,61,2,13,-11,0,0,0,37.0,0:1,0,0,0,3107.0,1:50,2250000
8468535,Antoine,Vermette,1982-07-20,C,L,2016-17,72,9,19,28,0.39,-7,88,10.23,42,68703.0,15:54,744,451,1195,62.26,51,45,14,28,-14,5,6,11,8160.0,1:53,0,0,0,3968.0,0:55,3750000
8468542,Paul,Martin,1981-03-05,D,L,2016-17,81,4,22,26,0.32,10,57,7.02,20,93441.0,19:13,0,0,0,0.0,41,124,36,57,-21,0,0,0,866.0,0:10,0,0,0,9057.0,1:51,4850000
8468575,Dominic,Moore,1980-08-03,C,L,2016-17,82,11,14,25,0.3,2,96,11.46,44,63673.0,12:56,357,297,654,54.59,63,42,31,26,5,0,0,0,1071.0,0:13,3,1,4,9682.0,1:58,900000
8468611,Matt,Hendricks,1981-06-17,C,L,2016-17,42,4,3,7,0.17,-3,42,9.52,29,27087.0,10:44,132,100,232,56.9,79,39,10,9,1,0,0,0,194.0,0:4,0,0,0,3804.0,1:30,1850000
8468639,John-Michael,Liles,1980-11-25,D,L,2016-17,36,0,5,5,0.14,1,36,0.0,4,35007.0,16:12,2,0,2,100.0,25,41,11,8,3,0,3,3,3349.0,1:33,0,0,0,2885.0,1:20,2000000
8468674,Deryk,Engelland,1982-04-03,D,R,2016-17,81,4,12,16,0.2,2,107,3.74,85,89083.0,18:19,1,0,1,100.0,135,134,19,49,-30,0,0,0,125.0,0:1,0,0,0,15674.0,3:13,2916667
8469455,Jason,Spezza,1983-06-13,C,R,2016-17,68,15,35,50,0.74,-18,149,10.07,29,65977.0,16:10,354,324,678,52.21,13,31,32,49,-17,2,17,19,10912.0,2:40,1,0,1,1110.0,0:16,7500000
8469459,Mikko,Koivu,1983-03-12,C,L,2016-17,80,18,40,58,0.72,27,139,12.95,34,91753.0,19:6,938,761,1699,55.21,32,65,39,28,11,2,18,20,10691.0,2:13,0,2,2,8762.0,1:49,6750000
8469465,Dan,Hamhuis,1982-12-13,D,L,2016-17,79,1,15,16,0.2,-7,83,1.2,23,91766.0,19:21,0,0,0,0.0,93,100,19,37,-18,1,0,1,7434.0,1:34,0,2,2,9566.0,2:1,3750000
8469466,Ales,Hemsky,1983-08-13,RW,R,2016-17,15,4,3,7,0.47,-1,30,13.33,0,12978.0,14:25,0,0,0,0.0,1,4,9,6,3,1,1,2,1386.0,1:32,0,0,0,82.0,0:5,4000000
8469492,Fedor,Tyutin,1983-07-19,D,L,2016-17,69,1,12,13,0.19,-25,46,2.17,38,78405.0,18:56,0,0,0,0.0,116,90,15,19,-4,0,0,0,139.0,0:2,0,0,0,10362.0,2:30,4500000
8469500,Michael,Cammalleri,1982-06-08,LW,L,2016-17,61,10,21,31,0.51,-9,142,7.04,21,63519.0,17:21,17,11,28,60.71,44,14,24,32,-8,1,9,10,9215.0,2:31,0,0,0,204.0,0:3,5000000
8469501,Chris,Thorburn,1983-06-03,RW,R,2016-17,64,3,1,4,0.06,-7,36,8.33,95,26789.0,6:58,13,13,26,50.0,90,25,4,4,0,0,0,0,127.0,0:1,1,0,1,2376.0,0:37,1200000
8469506,Jason,Pominville,1982-11-30,RW,R,2016-17,78,13,34,47,0.6,2,176,7.39,4,66579.0,14:13,39,39,78,50.0,44,38,22,13,9,0,7,7,5287.0,1:7,0,0,0,4243.0,0:54,5600000
8469508,Jay,McClement,1983-03-02,C,L,2016-17,65,5,3,8,0.12,-8,37,13.51,18,44392.0,11:22,253,272,525,48.19,49,40,29,15,14,0,0,0,415.0,0:6,1,0,1,7252.0,1:51,1200000
8469521,Tomas,Plekanec,1982-10-31,C,L,2016-17,78,10,18,28,0.36,10,139,7.19,24,78712.0,16:49,692,660,1352,51.18,57,45,30,29,1,3,4,7,4452.0,0:57,2,0,2,9228.0,1:58,6000000
8469544,Patrick,Sharp,1981-12-27,LW,R,2016-17,48,8,10,18,0.38,-22,146,5.48,31,45917.0,15:56,29,32,61,47.54,24,24,16,21,-5,1,0,1,6038.0,2:5,1,0,1,787.0,0:16,5900000
8469547,Jordin,Tootoo,1983-02-02,RW,R,2016-17,50,2,1,3,0.06,-6,43,4.65,28,20241.0,6:44,1,0,1,100.0,52,8,9,9,0,0,0,0,64.0,0:1,0,0,0,0.0,0:0,750000
8469598,Kevin,Bieksa,1981-06-16,D,R,2016-17,81,3,11,14,0.17,0,94,3.19,63,91130.0,18:45,0,0,0,0.0,173,100,13,54,-41,1,2,3,4574.0,0:56,0,0,0,8215.0,1:41,4000000
8469619,Dennis,Seidenberg,1981-07-18,D,L,2016-17,73,5,17,22,0.3,25,89,5.62,32,85089.0,19:25,0,0,0,0.0,154,146,10,33,-23,0,0,0,848.0,0:11,0,0,0,8201.0,1:52,4000000
8469638,Jussi,Jokinen,1983-04-01,LW,L,2016-17,69,11,17,28,0.41,-15,118,9.32,39,72080.0,17:24,75,69,144,52.08,28,33,27,59,-32,4,6,10,10207.0,2:27,1,0,1,5627.0,1:21,4000000
8469665,Johnny,Oduya,1981-10-01,D,L,2016-17,52,2,7,9,0.17,-4,37,5.41,18,57011.0,18:16,0,0,0,0.0,29,123,14,37,-23,0,0,0,424.0,0:8,0,0,0,7243.0,2:19,3750000
8469707,PA,Parenteau,1983-03-24,RW,R,2016-17,67,13,15,28,0.42,-18,123,10.57,35,59084.0,14:41,6,14,20,30.0,60,9,21,31,-10,4,4,8,8893.0,2:12,0,0,0,154.0,0:2,1250000
8469759,Vernon,Fiddler,1980-05-09,C,L,2016-17,59,2,2,4,0.07,-15,48,4.17,66,41249.0,11:39,370,319,689,53.7,57,33,12,21,-9,0,0,0,266.0,0:4,1,0,1,6294.0,1:46,1250000
8469760,Zbynek,Michalek,1982-12-23,D,R,2016-17,3,0,0,0,0.0,1,3,0.0,0,3179.0,17:39,0,0,0,0.0,7,5,0,3,-3,0,0,0,0.0,0:0,0,0,0,235.0,1:18,3200000
8469770,Dennis,Wideman,1983-03-20,D,R,2016-17,57,5,13,18,0.32,-6,87,5.75,32,69185.0,20:13,0,0,0,0.0,61,74,21,49,-28,2,3,5,3586.0,1:2,0,0,0,7398.0,2:9,5250000
8470041,Rick,Nash,1984-06-16,LW,L,2016-17,67,23,15,38,0.57,9,195,11.79,26,66186.0,16:27,0,1,1,0.0,63,35,43,46,-3,6,3,9,8094.0,2:0,1,0,1,4842.0,1:12,7800000
8470047,Valtteri,Filppula,1984-03-20,C,L,2016-17,79,12,30,42,0.53,-1,97,12.37,26,82505.0,17:24,556,606,1162,47.85,26,39,30,39,-9,0,7,7,8952.0,1:53,0,0,0,8282.0,1:44,5000000
8470104,Tom,Gilbert,1983-01-10,D,R,2016-17,18,1,4,5,0.28,-4,12,8.33,6,16693.0,15:27,0,0,0,0.0,10,28,1,7,-6,0,1,1,1691.0,1:33,0,0,0,1217.0,1:7,1400000
8470105,Scottie,Upshall,1983-10-07,RW,L,2016-17,73,10,8,18,0.25,-1,85,11.76,45,48107.0,10:59,3,9,12,25.0,99,21,16,18,-2,0,0,0,247.0,0:3,2,0,2,7761.0,1:46,900000
8470110,Trevor,Daley,1983-10-09,D,L,2016-17,56,5,14,19,0.34,7,84,5.95,37,68471.0,20:22,0,0,0,0.0,29,83,20,18,2,1,3,4,5503.0,1:38,0,1,1,7982.0,2:22,3300000
8470121,Matt,Greene,1983-05-13,D,R,2016-17,26,1,1,2,0.08,3,14,7.14,19,20564.0,13:10,0,0,0,0.0,71,27,3,17,-14,0,0,0,6.0,0:0,0,0,0,1894.0,1:12,2500000
8470144,Frans,Nielsen,1984-04-24,C,L,2016-17,79,17,24,41,0.52,-19,162,10.49,18,81281.0,17:8,653,561,1214,53.79,64,54,29,26,3,4,11,15,11386.0,2:24,2,0,2,9087.0,1:55,5250000
8470151,Jay,Bouwmeester,1983-09-27,D,L,2016-17,81,1,14,15,0.19,6,106,0.94,28,108889.0,22:24,0,0,0,0.0,67,111,11,37,-26,0,1,1,715.0,0:8,0,0,0,14503.0,2:59,5400000
8470159,Boyd,Gordon,1983-10-19,C,R,2016-17,13,1,0,1,0.08,-5,8,12.5,2,6379.0,8:10,48,38,86,55.81,4,7,2,0,2,0,0,0,2.0,0:0,0,0,0,1190.0,1:31,950000
8470162,Matt,Stajan,1983-12-19,C,L,2016-17,81,6,17,23,0.28,3,59,10.17,40,61631.0,12:40,385,383,768,50.13,60,39,30,22,8,0,0,0,404.0,0:4,0,2,2,8700.0,1:47,3125000
8470187,Johnny,Boychuk,1984-01-19,D,R,2016-17,66,6,17,23,0.35,11,155,3.87,19,82095.0,20:43,1,0,1,100.0,160,133,13,45,-32,1,3,4,7194.0,1:49,1,1,2,8308.0,2:5,6000000
8470201,Jiri,Hudler,1984-01-04,RW,L,2016-17,32,3,8,11,0.34,-3,27,11.11,4,22752.0,11:51,3,2,5,60.0,9,3,12,7,5,1,0,1,3947.0,2:3,0,0,0,5.0,0:0,2000000
8470257,Alexander,Steen,1984-03-01,LW,L,2016-17,76,16,35,51,0.67,-2,117,13.68,53,88034.0,19:18,101,146,247,40.89,33,69,27,18,9,3,13,16,13297.0,2:54,0,0,0,8477.0,1:51,5800000
8470281,Duncan,Keith,1983-07-16,D,L,2016-17,80,6,47,53,0.66,22,183,3.28,16,122960.0,25:37,0,0,0,0.0,24,107,32,73,-41,2,13,15,15191.0,3:9,0,0,0,11716.0,2:26,5538462
8470318,Jonathan,Ericsson,1984-03-02,D,L,2016-17,51,1,8,9,0.18,-2,43,2.33,63,58815.0,19:13,0,0,0,0.0,86,36,9,27,-18,0,0,0,383.0,0:7,0,0,0,6309.0,2:3,4250000
8470324,Josh,Gorges,1984-08-14,D,L,2016-17,66,1,5,6,0.09,-3,40,2.5,50,73091.0,18:27,0,1,1,0.0,143,108,7,17,-10,0,0,0,95.0,0:1,0,0,0,10599.0,2:40,3900000
8470358,Alexandre,Burrows,1981-04-11,RW,L,2016-17,75,15,16,31,0.41,3,143,10.49,62,65910.0,14:38,5,9,14,35.71,68,34,35,19,16,1,0,1,3172.0,0:42,0,1,1,5310.0,1:10,4500000
8470543,Chris,Kunitz,1979-09-26,LW,L,2016-17,71,9,20,29,0.41,0,134,6.72,36,66088.0,15:30,3,10,13,23.08,216,28,25,28,-3,0,5,5,6713.0,1:34,0,0,0,3108.0,0:43,3850000
8470595,Eric,Staal,1984-10-29,C,L,2016-17,82,28,37,65,0.79,17,211,13.27,34,91548.0,18:36,577,597,1174,49.15,42,39,51,24,27,4,12,16,11679.0,2:22,1,1,2,6731.0,1:22,3500000
8470598,Thomas,Vanek,1984-01-19,LW,R,2016-17,68,17,31,48,0.71,-5,133,12.78,22,58769.0,14:24,6,9,15,40.0,29,5,21,34,-13,5,8,13,10909.0,2:40,0,0,0,65.0,0:0,6500000
8470599,Milan,Michalek,1984-12-07,LW,L,2016-17,5,1,1,2,0.4,-2,6,16.67,2,4281.0,14:16,0,1,1,0.0,7,9,3,1,2,0,0,0,399.0,1:19,0,0,0,325.0,1:5,4000000
8470600,Ryan,Suter,1985-01-21,D,L,2016-17,82,9,31,40,0.49,34,164,5.49,36,132469.0,26:55,0,0,0,0.0,72,105,41,38,3,4,8,12,13569.0,2:45,1,1,2,11451.0,2:19,7538462
8470601,Braydon,Coburn,1985-02-27,D,L,2016-17,80,5,7,12,0.15,-1,102,4.9,50,80335.0,16:44,0,0,0,0.0,109,76,6,35,-29,0,0,0,386.0,0:4,1,0,1,9765.0,2:2,3700000
8470602,Dion,Phaneuf,1985-04-10,D,L,2016-17,81,9,21,30,0.37,-6,156,5.77,100,111982.0,23:2,0,0,0,0.0,132,156,16,54,-38,4,12,16,12498.0,2:34,1,0,1,11880.0,2:26,7000000
8470604,Jeff,Carter,1985-01-01,C,R,2016-17,82,32,34,66,0.8,2,250,12.8,41,88717.0,18:1,735,680,1415,51.94,86,37,24,46,-22,10,12,22,14247.0,2:53,1,0,1,7469.0,1:31,5272727
8470606,Dustin,Brown,1984-11-04,RW,R,2016-17,80,14,22,36,0.45,-4,175,8.0,22,76801.0,16:0,2,3,5,40.0,190,31,25,27,-2,4,2,6,7221.0,1:30,1,0,1,6230.0,1:17,5875000
8470607,Brent,Seabrook,1985-04-20,D,R,2016-17,79,3,36,39,0.49,5,131,2.29,26,103767.0,21:53,0,1,1,0.0,111,147,24,88,-64,2,12,14,12772.0,2:41,0,0,0,8944.0,1:53,6875000
8470610,Zach,Parise,1984-07-28,LW,L,2016-17,69,19,23,42,0.61,-3,194,9.79,30,72156.0,17:25,8,5,13,61.54,46,69,33,17,16,6,6,12,9453.0,2:17,0,0,0,4316.0,1:2,7538462
8470611,Eric,Fehr,1985-09-07,C,R,2016-17,53,6,5,11,0.21,2,62,9.68,14,34751.0,10:55,79,75,154,51.3,82,35,24,10,14,0,0,0,809.0,0:15,0,0,0,5697.0,1:47,2000000
8470612,Ryan,Getzlaf,1985-05-10,C,R,2016-17,74,15,58,73,0.99,7,138,10.87,49,93553.0,21:4,509,503,1012,50.3,99,88,61,68,-7,6,14,20,13664.0,3:4,2,1,3,7471.0,1:40,8250000
8470613,Brent,Burns,1985-03-09,D,R,2016-17,82,29,47,76,0.93,19,320,9.06,40,122324.0,24:51,0,0,0,0.0,69,142,53,153,-100,8,17,25,17695.0,3:35,0,1,1,8510.0,1:43,5760000
8470614,Mark,Stuart,1984-04-27,D,L,2016-17,42,2,2,4,0.1,4,24,8.33,27,31385.0,12:27,0,0,0,0.0,68,79,3,23,-20,0,0,0,12.0,0:0,0,0,0,5716.0,2:16,2625000
8470616,Ryan,Kesler,1984-08-31,C,R,2016-17,82,22,36,58,0.71,8,186,11.83,83,104814.0,21:18,1029,764,1793,57.39,146,75,22,39,-17,8,12,20,14041.0,2:51,0,0,0,13391.0,2:43,6875000
8470619,Brian,Boyle,1984-12-18,C,L,2016-17,75,13,12,25,0.33,3,131,9.92,66,58649.0,13:1,303,278,581,52.15,115,41,22,19,3,3,3,6,5293.0,1:10,0,0,0,4841.0,1:4,2000000
8470621,Corey,Perry,1985-05-16,RW,R,2016-17,82,19,34,53,0.65,2,215,8.84,76,87162.0,17:42,7,13,20,35.0,81,35,32,38,-6,5,15,20,14206.0,2:53,0,0,0,146.0,0:1,8625000
8470622,Patrick,Eaves,1984-05-01,RW,R,2016-17,79,32,19,51,0.65,-2,209,15.31,24,77776.0,16:24,2,2,4,50.0,89,43,30,19,11,13,5,18,14001.0,2:57,0,0,0,812.0,0:10,1000000
8470626,Loui,Eriksson,1985-07-17,LW,L,2016-17,65,11,13,24,0.37,-9,132,8.33,8,72843.0,18:40,0,1,1,0.0,11,26,37,16,21,5,2,7,9645.0,2:28,0,1,1,5555.0,1:25,6000000
8470630,Kevin,Klein,1984-12-13,D,R,2016-17,60,3,11,14,0.23,5,54,5.56,31,63490.0,17:38,0,0,0,0.0,135,123,12,35,-23,0,1,1,210.0,0:3,0,1,1,4567.0,1:16,2900000
8470638,Patrice,Bergeron,1985-07-24,C,R,2016-17,79,21,32,53,0.67,12,302,6.95,24,92065.0,19:25,1089,723,1812,60.1,54,47,65,23,42,8,9,17,13995.0,2:57,0,3,3,10206.0,2:9,6875000
8470640,Matt,Carle,1984-09-25,D,L,2016-17,6,0,1,1,0.17,-1,2,0.0,0,4732.0,13:8,0,0,0,0.0,3,5,0,4,-4,0,0,0,11.0,0:1,0,0,0,231.0,0:38,5500000
8470642,Shea,Weber,1985-08-14,D,R,2016-17,78,17,25,42,0.54,20,183,9.29,38,117286.0,25:3,0,0,0,0.0,140,157,11,80,-69,12,10,22,15151.0,3:14,0,2,2,13750.0,2:56,7857143
8470644,Colin,McDonald,1984-09-30,RW,R,2016-17,3,1,0,1,0.33,1,5,20.0,0,1624.0,9:1,0,1,1,0.0,9,0,0,0,0,0,0,0,16.0,0:5,0,0,0,0.0,0:0,637500
8470655,David,Backes,1984-05-01,RW,R,2016-17,74,17,21,38,0.51,2,175,9.71,69,76007.0,17:7,60,63,123,48.78,226,47,28,35,-7,2,5,7,9504.0,2:8,0,0,0,2372.0,0:32,6000000
8470667,Clarke,MacArthur,1985-04-06,LW,L,2016-17,4,0,0,0,0.0,-1,5,0.0,0,3237.0,13:29,0,1,1,0.0,4,1,1,1,0,0,0,0,533.0,2:13,0,0,0,0.0,0:0,4650000
8470724,Kyle,Quincey,1985-08-12,D,L,2016-17,73,6,9,15,0.21,4,79,7.59,51,78375.0,17:53,0,0,0,0.0,97,97,19,38,-19,0,0,0,1158.0,0:15,0,0,0,8014.0,1:49,1250000
8470740,Lee,Stempniak,1983-02-04,RW,R,2016-17,82,16,24,40,0.49,2,131,12.21,32,77952.0,15:50,3,5,8,37.5,113,16,57,49,8,2,4,6,9602.0,1:57,0,0,0,49.0,0:0,2500000
8470750,John,Mitchell,1985-01-22,C,L,2016-17,65,3,4,7,0.11,-12,57,5.26,45,48960.0,12:33,298,240,538,55.39,88,45,29,17,12,0,0,0,830.0,0:12,0,0,0,2437.0,0:37,1800000
8470755,Brad,Richardson,1985-02-04,C,L,2016-17,16,5,4,9,0.56,-1,25,20.0,15,14732.0,15:20,121,109,230,52.61,19,7,10,3,7,0,0,0,181.0,0:11,2,1,3,1944.0,2:1,2083333
8470760,Marc,Methot,1985-06-21,D,L,2016-17,68,0,12,12,0.18,13,69,0.0,24,80877.0,19:49,0,0,0,0.0,164,77,11,38,-27,0,0,0,242.0,0:3,0,0,0,8438.0,2:4,4900000
8470775,Nate,Thompson,1984-10-05,C,L,2016-17,30,1,1,2,0.07,4,19,5.26,14,18694.0,10:23,130,115,245,53.06,69,9,6,5,1,0,0,0,220.0,0:7,0,0,0,2862.0,1:35,1600000
8470778,Drew,Miller,1984-02-17,LW,L,2016-17,55,5,2,7,0.13,-12,43,11.63,18,33929.0,10:16,2,1,3,66.67,71,52,13,5,8,0,0,0,166.0,0:3,0,0,0,4537.0,1:22,1025000
8470794,Joe,Pavelski,1984-07-11,C,R,2016-17,81,29,39,68,0.84,11,233,12.45,34,92910.0,19:7,449,407,856,52.45,130,73,33,84,-51,7,15,22,16230.0,3:20,1,0,1,1460.0,0:18,6000000
8470803,Kyle,Brodziak,1984-05-25,C,R,2016-17,69,8,7,15,0.22,2,55,14.55,27,46394.0,11:12,323,330,653,49.46,56,39,33,6,27,0,0,0,116.0,0:1,0,0,0,8369.0,2:1,950000
8470828,Toby,Enstrom,1984-11-05,D,L,2016-17,60,1,13,14,0.23,-7,46,2.17,42,78856.0,21:54,0,0,0,0.0,24,94,8,33,-25,0,6,6,5261.0,1:27,1,0,1,10789.0,2:59,5750000
8470834,Dustin,Byfuglien,1985-03-27,D,R,2016-17,80,13,39,52,0.65,10,241,5.39,117,131734.0,27:26,0,0,0,0.0,183,124,65,85,-20,1,13,14,15857.0,3:18,0,2,2,11252.0,2:20,7600000
8470852,Matt,Moulson,1983-11-01,LW,L,2016-17,81,14,18,32,0.4,-4,134,10.45,10,56408.0,11:36,1,3,4,25.0,37,18,18,12,6,11,7,18,10305.0,2:7,0,0,0,42.0,0:0,5000000
8470854,Tanner,Glass,1983-11-29,LW,L,2016-17,11,1,1,2,0.18,0,8,12.5,17,7201.0,10:54,2,0,2,100.0,37,4,2,0,2,0,0,0,31.0,0:2,0,0,0,166.0,0:15,1450000
8470886,Clayton,Stoner,1985-02-19,D,L,2016-17,14,1,2,3,0.21,0,16,6.25,28,14743.0,17:33,0,0,0,0.0,35,17,2,3,-1,0,0,0,46.0,0:3,0,0,0,1859.0,2:12,3250000
8470966,Mark,Giordano,1983-10-03,D,L,2016-17,81,12,27,39,0.48,22,151,7.95,59,114610.0,23:34,0,0,0,0.0,78,184,45,43,2,3,11,14,12582.0,2:35,2,1,3,15743.0,3:14,6750000
8471214,Alex,Ovechkin,1985-09-17,LW,R,2016-17,82,33,36,69,0.84,6,313,10.54,50,90361.0,18:21,0,1,1,0.0,216,29,29,46,-17,17,9,26,18321.0,3:43,0,0,0,134.0,0:1,9538462
8471215,Evgeni,Malkin,1986-07-31,C,L,2016-17,62,33,39,72,1.16,18,191,17.28,77,69263.0,18:37,365,481,846,43.14,40,25,52,54,-2,11,12,23,13653.0,3:40,0,0,0,149.0,0:2,9500000
8471217,Andrew,Ladd,1985-12-12,LW,L,2016-17,78,23,8,31,0.4,-14,142,16.2,45,75702.0,16:10,4,6,10,40.0,112,54,37,43,-6,3,2,5,9765.0,2:5,1,0,1,3920.0,0:50,5500000
8471218,Blake,Wheeler,1986-08-31,RW,R,2016-17,82,26,48,74,0.9,6,259,10.04,47,99099.0,20:8,43,51,94,45.74,100,51,39,44,-5,5,16,21,14504.0,2:56,2,1,3,6856.0,1:23,5600000
8471226,Drew,Stafford,1985-10-30,RW,R,2016-17,58,8,13,21,0.36,6,109,7.34,24,47331.0,13:36,7,15,22,31.82,62,3,13,28,-15,3,1,4,4599.0,1:19,0,0,0,702.0,0:12,4350000
8471228,Alexander,Radulov,1986-07-05,RW,L,2016-17,76,18,36,54,0.71,10,147,12.24,62,83405.0,18:17,6,6,12,50.0,76,41,42,52,-10,6,10,16,12988.0,2:50,0,0,0,93.0,0:1,5750000
8471232,Lauri,Korpikoski,1986-07-28,LW,L,2016-17,69,8,12,20,0.29,5,108,7.41,10,51364.0,12:24,0,7,7,0.0,37,36,12,21,-9,0,0,0,1127.0,0:16,0,1,1,5545.0,1:20,2500000
8471233,Travis,Zajac,1985-05-13,C,R,2016-17,80,14,31,45,0.56,-8,126,11.11,33,94682.0,19:43,884,733,1617,54.67,81,26,44,25,19,6,6,12,12333.0,2:34,1,1,2,11139.0,2:19,5750000
8471242,Mike,Green,1985-10-12,D,R,2016-17,72,14,22,36,0.5,-20,125,11.2,40,101763.0,23:33,0,0,0,0.0,67,92,24,52,-28,3,7,10,11872.0,2:44,0,0,0,2540.0,0:35,6000000
8471254,Bryan,Bickell,1986-03-09,LW,L,2016-17,11,1,0,1,0.09,-4,8,12.5,4,6891.0,10:26,0,2,2,0.0,16,3,3,2,1,1,0,1,892.0,1:21,0,0,0,0.0,0:0,4000000
8471260,Blake,Comeau,1986-02-18,LW,R,2016-17,77,8,12,20,0.26,-19,103,7.77,58,69229.0,14:59,114,132,246,46.34,129,22,35,18,17,2,0,2,2867.0,0:37,1,0,1,8822.0,1:54,2400000
8471262,Carl,Soderberg,1985-10-12,C,L,2016-17,80,6,8,14,0.18,-26,128,4.69,22,64537.0,13:26,365,337,702,51.99,34,42,30,19,11,1,1,2,4705.0,0:58,0,0,0,3347.0,0:41,4750000
8471269,Nicklas,Grossmann,1985-01-22,D,L,2016-17,3,0,0,0,0.0,-4,3,0.0,2,2342.0,13:0,0,0,0,0.0,7,1,0,1,-1,0,0,0,0.0,0:0,0,0,0,195.0,1:5,575000
8471273,Brandon,Dubinsky,1986-04-29,C,L,2016-17,80,12,29,41,0.51,16,115,10.43,91,85898.0,17:53,770,718,1488,51.75,248,60,38,32,6,1,3,4,6813.0,1:25,1,0,1,8283.0,1:43,5850000
8471274,Alex,Goligoski,1985-07-30,D,L,2016-17,82,6,30,36,0.44,-9,112,5.36,28,114780.0,23:19,0,0,0,0.0,137,143,15,57,-42,1,7,8,10706.0,2:10,1,1,2,12122.0,2:27,5475000
8471276,David,Krejci,1986-04-28,C,R,2016-17,82,23,31,54,0.66,-12,158,14.56,26,89860.0,18:15,659,620,1279,51.52,40,51,60,51,9,8,6,14,12404.0,2:31,0,0,0,2394.0,0:29,7250000
8471284,Andrej,Sekera,1986-06-08,D,L,2016-17,80,8,27,35,0.44,14,128,6.25,18,103118.0,21:28,0,0,0,0.0,55,166,38,95,-57,1,10,11,10554.0,2:11,1,0,1,9681.0,2:1,5500000
8471296,Alexei,Emelin,1986-04-25,D,L,2016-17,76,2,8,10,0.13,1,82,2.44,71,97227.0,21:19,0,0,0,0.0,241,127,16,84,-68,0,0,0,283.0,0:3,0,0,0,11749.0,2:34,4100000
8471303,Alexander,Edler,1986-04-21,D,L,2016-17,68,6,15,21,0.31,-20,138,4.35,36,99200.0,24:18,2,1,3,66.67,106,138,17,37,-20,2,2,4,8376.0,2:3,0,0,0,10528.0,2:34,5000000
8471338,Torrey,Mitchell,1985-01-30,C,R,2016-17,78,8,9,17,0.22,5,68,11.76,38,58992.0,12:36,410,342,752,54.52,47,56,43,39,4,0,0,0,379.0,0:4,0,0,0,8579.0,1:49,1200000
8471339,Ryan,Callahan,1985-03-21,RW,R,2016-17,18,2,2,4,0.22,-4,22,9.09,23,15274.0,14:8,5,4,9,55.56,48,13,7,10,-3,0,0,0,254.0,0:14,0,0,0,2139.0,1:58,5800000
8471346,Kris,Versteeg,1986-05-13,RW,R,2016-17,69,15,22,37,0.54,-3,136,11.03,46,60971.0,14:43,53,49,102,51.96,5,28,38,31,7,8,8,16,10540.0,2:32,0,0,0,94.0,0:1,950000
8471385,Adam,Pardy,1984-03-29,D,L,2016-17,4,0,0,0,0.0,-1,4,0.0,6,2638.0,10:59,0,0,0,0.0,3,3,1,0,1,0,0,0,0.0,0:0,0,0,0,20.0,0:5,575000
8471392,Roman,Polak,1986-04-28,D,R,2016-17,75,4,7,11,0.15,10,64,6.25,65,80643.0,17:55,0,1,1,0.0,232,133,16,49,-33,0,0,0,54.0,0:0,0,0,0,13061.0,2:54,2250000
8471426,Troy,Brouwer,1985-08-17,RW,R,2016-17,74,13,12,25,0.34,-11,86,15.12,31,72029.0,16:13,20,44,64,31.25,171,39,22,30,-8,5,6,11,10725.0,2:24,1,1,2,6894.0,1:33,4500000
8471436,Matt,Hunwick,1985-05-21,D,L,2016-17,72,1,18,19,0.26,8,73,1.37,18,77667.0,17:58,0,0,0,0.0,91,90,26,44,-18,0,0,0,241.0,0:3,0,0,0,11500.0,2:39,1200000
8471476,Daniel,Winnik,1985-03-06,LW,L,2016-17,72,12,13,25,0.35,15,82,14.63,49,55793.0,12:54,9,12,21,42.86,25,34,30,30,0,0,0,0,209.0,0:2,2,0,2,10901.0,2:31,2250000
8471490,Adam,Cracknell,1985-07-15,RW,R,2016-17,69,10,6,16,0.23,9,87,11.49,12,43305.0,10:27,135,160,295,45.76,91,37,19,16,3,0,0,0,426.0,0:6,1,0,1,2139.0,0:31,600000
8471498,Jannik,Hansen,1986-03-15,RW,R,2016-17,43,8,12,20,0.47,2,73,10.96,34,41414.0,16:3,0,1,1,0.0,43,15,21,14,7,0,0,0,510.0,0:11,0,0,0,3836.0,1:29,2500000
8471504,Rene,Bourque,1981-12-10,RW,L,2016-17,65,12,6,18,0.28,-19,111,10.81,56,54382.0,13:56,0,5,5,0.0,75,26,24,12,12,2,0,2,5927.0,1:31,0,0,0,666.0,0:10,650000
8471657,Cody,McLeod,1984-06-26,LW,L,2016-17,59,5,1,6,0.1,-3,30,16.67,145,25366.0,7:9,0,1,1,0.0,150,14,4,2,2,0,0,0,289.0,0:4,0,0,0,81.0,0:1,1333333
8471663,Mike,Blunden,1986-12-15,RW,R,2016-17,2,0,0,0,0.0,0,1,0.0,4,974.0,8:7,0,0,0,0.0,6,0,0,0,0,0,0,0,0.0,0:0,0,0,0,0.0,0:0,737500
8471664,Mason,Raymond,1985-09-17,LW,L,2016-17,4,0,0,0,0.0,-2,3,0.0,0,2138.0,8:54,0,1,1,0.0,3,0,0,1,-1,0,0,0,39.0,0:9,0,0,0,0.0,0:0,3150000
8471669,Paul,Stastny,1985-12-27,C,L,2016-17,66,18,22,40,0.61,4,112,16.07,36,75793.0,19:8,786,624,1410,55.74,51,35,24,9,15,5,8,13,10226.0,2:34,0,0,0,6451.0,1:37,7000000
8471675,Sidney,Crosby,1987-08-07,C,L,2016-17,75,44,45,89,1.19,17,255,17.25,24,89450.0,19:52,842,906,1748,48.17,80,27,39,70,-31,14,11,25,16185.0,3:35,0,0,0,531.0,0:7,8700000
8471676,Bobby,Ryan,1987-03-17,RW,R,2016-17,62,13,12,25,0.4,-3,111,11.71,24,57801.0,15:32,6,3,9,66.67,109,36,27,27,0,2,3,5,8943.0,2:24,0,0,0,66.0,0:1,7250000
8471677,Jack,Johnson,1987-01-13,D,L,2016-17,82,5,18,23,0.28,23,116,4.31,32,107366.0,21:49,1,0,1,100.0,94,134,20,27,-7,1,1,2,1202.0,0:14,0,1,1,11905.0,2:25,4357143
8471678,Benoit,Pouliot,1986-09-29,LW,L,2016-17,67,8,6,14,0.21,-5,77,10.39,34,56497.0,14:3,7,21,28,25.0,39,39,39,48,-9,0,0,0,3456.0,0:51,0,0,0,5443.0,1:21,4000000
8471681,Jack,Skille,1987-05-19,RW,R,2016-17,55,5,4,9,0.16,0,73,6.85,12,29037.0,8:47,2,0,2,100.0,74,24,14,9,5,0,0,0,218.0,0:3,0,0,0,2.0,0:0,700000
8471682,Devin,Setoguchi,1987-01-01,RW,R,2016-17,45,4,8,12,0.27,-5,60,6.67,14,33593.0,12:26,2,2,4,50.0,53,10,15,19,-4,0,1,1,1555.0,0:34,0,0,0,27.0,0:0,575000
8471685,Anze,Kopitar,1987-08-24,C,L,2016-17,76,12,40,52,0.68,-10,150,8.0,28,94694.0,20:45,892,801,1693,52.69,78,59,29,37,-8,5,14,19,13706.0,3:0,0,1,1,8681.0,1:54,10000000
8471686,Marc,Staal,1987-01-13,D,L,2016-17,72,3,7,10,0.14,9,70,4.29,34,82842.0,19:10,0,1,1,0.0,89,97,22,47,-25,0,0,0,206.0,0:2,0,1,1,8470.0,1:57,5700000
8471691,Martin,Hanzal,1987-02-20,C,L,2016-17,71,20,19,39,0.55,-17,169,11.83,53,75486.0,17:43,767,593,1360,56.4,145,58,31,30,1,5,4,9,10535.0,2:28,0,0,0,5800.0,1:21,3100000
8471693,Jakub,Kindl,1987-02-10,D,L,2016-17,39,0,4,4,0.1,-11,41,0.0,28,34376.0,14:41,0,0,0,0.0,49,37,9,13,-4,0,0,0,649.0,0:16,0,0,0,433.0,0:11,2400000
8471698,T.J.,Oshie,1986-12-23,RW,R,2016-17,68,33,23,56,0.82,28,143,23.08,36,72848.0,17:51,87,93,180,48.33,95,50,49,33,16,7,6,13,11835.0,2:54,1,2,3,4042.0,0:59,4175000
8471699,Andrew,Cogliano,1987-06-14,LW,L,2016-17,82,16,19,35,0.43,11,178,8.99,26,74479.0,15:8,8,10,18,44.44,76,27,19,26,-7,0,0,0,406.0,0:4,3,1,4,8735.0,1:46,3000000
8471702,Matt,Niskanen,1986-12-06,D,R,2016-17,78,5,34,39,0.5,20,154,3.25,32,103784.0,22:10,0,0,0,0.0,147,93,36,67,-31,1,8,9,8395.0,1:47,0,1,1,12119.0,2:35,5750000
8471707,James,Neal,1987-09-03,LW,L,2016-17,70,23,18,41,0.59,-10,202,11.39,35,74312.0,17:41,3,3,6,50.0,84,18,40,30,10,5,8,13,11523.0,2:44,0,0,0,262.0,0:3,5000000
8471709,Marc-Edouard,Vlasic,1987-03-30,D,L,2016-17,75,6,22,28,0.37,4,144,4.17,35,95555.0,21:14,0,0,0,0.0,18,146,23,62,-39,1,6,7,8663.0,1:55,0,1,1,9351.0,2:4,4250000
8471710,Taylor,Chorney,1987-04-27,D,L,2016-17,18,1,4,5,0.28,8,19,5.26,11,15405.0,14:15,0,0,0,0.0,27,29,3,7,-4,0,0,0,0.0,0:0,0,0,0,770.0,0:42,800000
8471716,Justin,Abdelkader,1987-02-25,LW,L,2016-17,64,7,14,21,0.33,-20,104,6.73,50,63969.0,16:39,5,12,17,29.41,144,27,15,18,-3,5,2,7,8902.0,2:19,0,1,1,4665.0,1:12,4250000
8471717,Adam,McQuaid,1986-10-12,D,R,2016-17,77,2,8,10,0.13,4,64,3.12,71,84300.0,18:14,0,0,0,0.0,157,144,10,24,-14,0,0,0,306.0,0:3,0,1,1,11016.0,2:23,2750000
8471724,Kris,Letang,1987-04-24,D,R,2016-17,41,5,29,34,0.83,2,122,4.1,32,62774.0,25:31,0,0,0,0.0,70,70,30,43,-13,2,12,14,9041.0,3:40,0,1,1,5270.0,2:8,7250000
8471729,Kris,Russell,1987-05-02,D,L,2016-17,68,1,12,13,0.19,5,68,1.47,23,86565.0,21:13,0,0,0,0.0,67,213,36,60,-24,0,1,1,1192.0,0:17,0,0,0,9435.0,2:18,3100000
8471735,Keith,Yandle,1986-09-09,D,L,2016-17,82,5,36,41,0.5,-6,178,2.81,39,108436.0,22:2,0,0,0,0.0,28,76,24,76,-52,2,16,18,15178.0,3:5,0,1,1,8354.0,1:41,6350000
8471742,Cody,Franson,1987-08-08,D,R,2016-17,68,3,16,19,0.28,-5,93,3.23,34,75408.0,18:28,0,0,0,0.0,87,68,14,30,-16,1,1,2,5955.0,1:27,0,0,0,3427.0,0:50,3325000
8471743,Vladimir,Sobotka,1987-07-02,LW,L,2016-17,1,1,0,1,1.0,0,2,50.0,0,1001.0,16:41,6,6,12,50.0,0,0,1,0,1,0,0,0,262.0,4:22,0,0,0,108.0,1:48,2725000
8471760,Cody,Bass,1987-01-07,C,R,2016-17,9,0,0,0,0.0,-1,1,0.0,19,3654.0,6:46,0,2,2,0.0,14,4,2,1,1,0,0,0,0.0,0:0,0,0,0,329.0,0:36,612500
8471761,Chris,Butler,1986-10-27,D,L,2016-17,1,0,0,0,0.0,0,1,0.0,0,1288.0,21:28,0,0,0,0.0,0,2,0,1,-1,0,0,0,17.0,0:17,0,0,0,95.0,1:35,600000
8471762,Chris,VandeVelde,1987-03-15,C,L,2016-17,81,6,9,15,0.19,-5,69,8.7,16,56187.0,11:33,22,20,42,52.38,114,60,14,12,2,0,0,0,271.0,0:3,0,0,0,12159.0,2:30,712500
8471766,Jared,Boll,1986-05-13,RW,R,2016-17,51,0,3,3,0.06,-3,13,0.0,87,17793.0,5:48,0,1,1,0.0,68,14,2,5,-3,0,0,0,138.0,0:2,0,0,0,0.0,0:0,1700000
8471768,Tom,Pyatt,1987-02-14,LW,L,2016-17,82,9,14,23,0.28,9,95,9.47,16,76887.0,15:37,21,28,49,42.86,46,89,35,20,15,0,0,0,677.0,0:8,0,2,2,10401.0,2:6,800000
8471769,Niklas,Hjalmarsson,1987-06-06,D,L,2016-17,73,5,13,18,0.25,12,61,8.2,20,94148.0,21:29,0,0,0,0.0,23,181,23,70,-47,0,0,0,435.0,0:5,0,1,1,12265.0,2:48,4100000
8471794,Darren,Helm,1987-01-21,LW,L,2016-17,50,8,9,17,0.34,-6,98,8.16,20,46108.0,15:22,216,204,420,51.43,71,18,17,20,-3,2,2,4,2504.0,0:50,0,1,1,4946.0,1:38,3850000
8471811,Cal,O'Reilly,1986-09-30,C,L,2016-17,11,0,1,1,0.09,-6,3,0.0,0,5235.0,7:55,32,34,66,48.48,2,3,3,2,1,0,0,0,587.0,0:53,0,0,0,0.0,0:0,700000
8471816,Mark,Fayne,1987-05-15,D,R,2016-17,4,0,2,2,0.5,1,4,0.0,0,1900.0,7:55,0,0,0,0.0,1,2,0,2,-2,0,0,0,0.0,0:0,0,0,0,0.0,0:0,3625000
8471817,Ryan,Reaves,1987-01-20,RW,R,2016-17,80,7,6,13,0.16,4,58,12.07,104,42648.0,8:53,0,5,5,0.0,239,26,11,4,7,0,0,0,109.0,0:1,0,0,0,8.0,0:0,1125000
8471873,Anton,Stralman,1986-08-01,D,R,2016-17,73,5,17,22,0.3,1,130,3.85,20,100304.0,22:54,0,0,0,0.0,106,96,26,27,-1,1,6,7,7391.0,1:41,0,0,0,11470.0,2:37,4500000
8471887,Patric,Hornqvist,1987-01-01,RW,R,2016-17,70,21,23,44,0.63,16,223,9.42,28,66995.0,15:57,3,8,11,27.27,227,62,30,11,19,10,7,17,12641.0,3:0,0,0,0,67.0,0:0,4250000
8471956,Andrew,Desjardins,1986-07-27,LW,L,2016-17,46,0,1,1,0.02,-6,46,0.0,22,25948.0,9:24,39,30,69,56.52,73,17,9,10,-1,0,0,0,9.0,0:0,0,0,0,1801.0,0:39,800000
8471958,Dan,Girardi,1984-04-29,D,R,2016-17,63,4,11,15,0.24,8,56,7.14,16,72208.0,19:6,0,0,0,0.0,107,166,10,46,-36,0,0,0,158.0,0:2,1,1,2,8505.0,2:15,5500000
8471976,David,Desharnais,1986-09-14,C,L,2016-17,49,6,8,14,0.29,4,46,13.04,12,36628.0,12:27,170,162,332,51.2,5,15,21,12,9,0,2,2,2929.0,0:59,0,0,0,60.0,0:1,3500000
8471996,Bracken,Kearns,1981-05-12,C,L,2016-17,2,0,0,0,0.0,-1,3,0.0,2,1343.0,11:11,10,7,17,58.82,5,2,0,0,0,0,0,0,0.0,0:0,0,0,0,0.0,0:0,800000
8472382,Andy,Greene,1982-10-30,D,L,2016-17,66,4,9,13,0.2,-16,83,4.82,8,86898.0,21:56,0,0,0,0.0,50,125,26,36,-10,1,3,4,4892.0,1:14,1,0,1,12711.0,3:12,5000000
8472410,Stephen,Gionta,1983-10-09,RW,R,2016-17,26,1,5,6,0.23,9,17,5.88,2,17483.0,11:12,56,64,120,46.67,56,7,5,6,-1,0,0,0,167.0,0:6,0,0,0,2031.0,1:18,575000
8473412,Bryan,Little,1987-11-12,C,R,2016-17,59,21,26,47,0.8,-7,119,17.65,18,62152.0,17:33,610,487,1097,55.61,35,23,31,19,12,6,6,12,7945.0,2:14,0,0,0,4055.0,1:8,4700000
8473415,Alex,Biega,1988-04-04,D,R,2016-17,36,0,3,3,0.08,-4,37,0.0,18,28444.0,13:10,0,0,0,0.0,97,24,5,7,-2,0,0,0,477.0,0:13,0,0,0,1387.0,0:38,750000
8473419,Brad,Marchand,1988-05-11,LW,L,2016-17,80,39,46,85,1.06,18,226,17.26,81,93295.0,19:26,13,23,36,36.11,51,35,69,84,-15,9,15,24,12944.0,2:41,3,2,5,9107.0,1:53,4500000
8473422,Nick,Foligno,1987-10-31,LW,L,2016-17,79,26,25,51,0.65,-4,185,14.05,55,87336.0,18:25,41,48,89,46.07,157,50,44,35,9,11,10,21,12733.0,2:41,0,0,0,2797.0,0:35,5500000
8473432,Derek,Dorsett,1986-12-20,RW,R,2016-17,14,1,3,4,0.29,-6,24,4.17,33,8343.0,9:55,1,0,1,100.0,35,6,2,1,1,0,0,0,12.0,0:0,0,0,0,301.0,0:21,2650000
8473446,Erik,Johnson,1988-03-21,D,R,2016-17,46,2,15,17,0.37,-6,96,2.08,9,60945.0,22:4,0,0,0,0.0,87,98,18,23,-5,0,6,6,5798.0,2:6,0,0,0,7812.0,2:49,6000000
8473449,Kyle,Okposo,1988-04-16,RW,R,2016-17,65,19,26,45,0.69,-7,156,12.18,24,73983.0,18:58,54,45,99,54.55,53,25,26,36,-10,7,16,23,12504.0,3:12,0,0,0,492.0,0:7,6000000
8473453,Trevor,Lewis,1987-01-08,C,R,2016-17,82,12,12,24,0.29,-6,145,8.28,30,70224.0,14:16,44,66,110,40.0,174,30,18,12,6,1,1,2,972.0,0:11,0,0,0,6044.0,1:13,2000000
8473463,Leo,Komarov,1987-01-23,C,L,2016-17,82,14,18,32,0.39,6,114,12.28,31,84002.0,17:4,91,111,202,45.05,232,50,46,25,21,4,6,10,10118.0,2:3,1,1,2,10583.0,2:9,2950000
8473465,Jamie,McGinn,1988-08-05,LW,L,2016-17,72,9,8,17,0.24,-23,116,7.76,23,56906.0,13:10,1,2,3,33.33,116,18,5,27,-22,0,2,2,4228.0,0:58,0,0,0,15.0,0:0,3333333
8473466,Ryan,White,1988-03-17,C,R,2016-17,65,9,7,16,0.25,-16,60,15.0,84,41566.0,10:39,39,52,91,42.86,187,33,11,10,1,0,0,0,250.0,0:3,0,0,0,1101.0,0:16,1000000
8473468,Eric,Gryba,1988-04-14,D,R,2016-17,40,2,4,6,0.15,-5,45,4.44,65,38735.0,16:8,0,0,0,0.0,145,47,6,21,-15,0,0,0,48.0,0:1,0,0,0,3146.0,1:18,950000
8473473,Milan,Lucic,1988-06-07,LW,L,2016-17,82,23,27,50,0.61,-3,175,13.14,50,84435.0,17:9,4,3,7,57.14,202,20,26,49,-23,12,13,25,13437.0,2:43,0,0,0,40.0,0:0,6000000
8473485,Chris,Stewart,1987-10-30,RW,R,2016-17,79,13,8,21,0.27,3,82,15.85,94,49244.0,10:23,2,9,11,18.18,85,19,15,15,0,0,2,2,785.0,0:9,0,0,0,13.0,0:0,1150000
8473492,Matt,Beleskey,1988-06-07,LW,L,2016-17,49,3,5,8,0.16,-10,79,3.8,47,39001.0,13:15,29,41,70,41.43,98,18,7,12,-5,0,2,2,4252.0,1:26,0,0,0,1499.0,0:30,3800000
8473504,Cal,Clutterbuck,1987-11-18,RW,R,2016-17,66,5,15,20,0.3,2,115,4.35,28,55429.0,13:59,3,5,8,37.5,222,25,30,16,14,0,1,1,1707.0,0:25,0,0,0,8236.0,2:4,2750000
8473507,Jeff,Petry,1987-12-09,D,R,2016-17,80,8,20,28,0.35,3,172,4.65,22,106152.0,22:6,0,0,0,0.0,171,145,19,102,-83,2,5,7,8476.0,1:45,0,0,0,8664.0,1:48,5500000
8473512,Claude,Giroux,1988-01-12,C,R,2016-17,82,14,44,58,0.71,-15,199,7.04,38,94082.0,19:7,977,771,1748,55.89,68,28,38,35,3,5,26,31,18425.0,3:44,0,1,1,1253.0,0:15,8275000
8473533,Jordan,Staal,1988-09-10,C,L,2016-17,75,16,29,45,0.6,-1,164,9.76,38,83977.0,18:39,689,477,1166,59.09,139,29,55,42,13,4,4,8,10138.0,2:15,1,0,1,7066.0,1:34,6000000
8473534,Patrik,Berglund,1988-06-02,C,L,2016-17,82,23,11,34,0.41,-7,153,15.03,32,78668.0,15:59,584,585,1169,49.96,155,42,43,23,20,4,4,8,6983.0,1:25,0,0,0,6145.0,1:14,3700000
8473537,Viktor,Stalberg,1986-01-17,LW,L,2016-17,75,11,5,16,0.21,-9,101,10.89,41,54903.0,12:12,0,3,3,0.0,141,28,37,27,10,1,1,2,1634.0,0:21,2,0,2,6075.0,1:21,3000000
8473542,Tom,Sestito,1987-09-28,LW,L,2016-17,13,0,2,2,0.15,0,3,0.0,48,4315.0,5:31,0,0,0,0.0,19,2,0,2,-2,0,0,0,25.0,0:1,0,0,0,0.0,0:0,575000
8473544,Derick,Brassard,1987-09-22,C,L,2016-17,81,14,25,39,0.48,12,195,7.18,24,84461.0,17:22,612,613,1225,49.96,92,24,37,37,0,3,4,7,12392.0,2:32,0,0,0,336.0,0:4,5000000
8473546,Michael,Grabner,1987-10-05,RW,L,2016-17,76,27,13,40,0.53,22,162,16.67,10,64272.0,14:5,7,6,13,53.85,41,34,48,22,26,0,0,0,363.0,0:4,1,2,3,7704.0,1:41,1650000
8473548,Phil,Kessel,1987-10-02,RW,R,2016-17,82,23,47,70,0.85,3,229,10.04,20,88259.0,17:56,5,10,15,33.33,12,15,15,51,-36,8,22,30,17461.0,3:32,0,0,0,67.0,0:0,8000000
8473560,Korbinian,Holzer,1988-02-16,D,R,2016-17,32,2,5,7,0.22,0,14,14.29,23,25945.0,13:30,0,0,0,0.0,71,34,3,11,-8,0,0,0,64.0,0:2,0,0,0,1651.0,0:51,700000
8473563,Nicklas,Backstrom,1987-11-23,C,L,2016-17,82,23,63,86,1.05,17,162,14.2,38,89839.0,18:15,685,648,1333,51.39,45,33,61,54,7,8,27,35,15061.0,3:3,0,0,0,3416.0,0:41,6700000
8473564,Michael,Frolik,1988-02-17,RW,L,2016-17,82,17,27,44,0.54,13,202,8.42,58,84044.0,17:4,13,16,29,44.83,60,48,45,38,7,3,5,8,5856.0,1:11,2,1,3,10011.0,2:2,4300000
8473565,Brian,Strait,1988-01-04,D,L,2016-17,5,0,2,2,0.4,-1,3,0.0,0,4779.0,15:55,0,0,0,0.0,5,8,0,0,0,0,0,0,57.0,0:11,0,0,0,92.0,0:18,600000
8473571,Jamie,McBain,1988-02-25,D,R,2016-17,3,0,0,0,0.0,-1,3,0.0,0,3000.0,16:40,0,0,0,0.0,0,4,1,1,0,0,0,0,342.0,1:54,0,0,0,0.0,0:0,650000
8473573,Artem,Anisimov,1988-05-24,C,L,2016-17,64,22,23,45,0.7,9,105,20.95,30,68529.0,17:50,416,506,922,45.12,18,27,35,16,19,4,4,8,9100.0,2:22,0,0,0,3185.0,0:49,4550000
8473574,Shawn,Matthias,1988-02-19,LW,L,2016-17,45,8,4,12,0.27,0,51,15.69,13,36612.0,13:33,5,11,16,31.25,47,19,10,8,2,0,0,0,174.0,0:3,1,0,1,4046.0,1:29,2125000
8473579,Nikolay,Kulemin,1986-07-14,LW,L,2016-17,72,12,11,23,0.32,3,74,16.22,18,59691.0,13:49,14,13,27,51.85,78,45,30,17,13,1,1,2,668.0,0:9,1,1,2,8037.0,1:51,4187500
8473584,Andrew,MacDonald,1986-09-07,D,L,2016-17,73,2,16,18,0.25,-5,65,3.08,26,88074.0,20:6,0,0,0,0.0,39,151,8,50,-42,0,0,0,486.0,0:6,0,1,1,12480.0,2:50,5000000
8473588,Erik,Condra,1986-08-06,RW,R,2016-17,13,0,0,0,0.0,-4,8,0.0,4,7519.0,9:38,1,0,1,100.0,5,7,3,2,1,0,0,0,62.0,0:4,0,0,0,138.0,0:10,1250000
8473604,Jonathan,Toews,1988-04-29,C,L,2016-17,72,21,37,58,0.81,7,199,10.55,35,87066.0,20:9,852,700,1552,54.9,43,32,37,37,0,6,11,17,11596.0,2:41,0,0,0,5630.0,1:18,10500000
8473618,Mathieu,Perreault,1988-01-05,C,L,2016-17,65,13,32,45,0.69,-11,134,9.7,30,63525.0,16:17,97,92,189,51.32,97,26,33,20,13,3,12,15,10299.0,2:38,0,0,0,110.0,0:1,3000000
8473673,David,Schlemko,1987-05-07,D,L,2016-17,62,2,16,18,0.29,4,118,1.69,14,62297.0,16:44,0,0,0,0.0,35,112,28,42,-14,1,2,3,5658.0,1:31,0,0,0,1656.0,0:26,2100000
8473914,Mark,Letestu,1985-02-04,C,R,2016-17,78,16,19,35,0.45,-2,120,13.33,17,66630.0,14:14,452,444,896,50.45,71,34,24,24,0,11,3,14,10633.0,2:16,2,1,3,9984.0,2:8,1800000
8473933,Ben,Lovejoy,1984-02-20,D,R,2016-17,82,1,6,7,0.09,-7,84,1.19,39,102209.0,20:46,0,0,0,0.0,82,150,18,40,-22,0,0,0,541.0,0:6,0,0,0,16017.0,3:15,2666667
8473962,Teddy,Purcell,1985-09-08,LW,R,2016-17,12,0,2,2,0.17,0,10,0.0,0,9282.0,12:53,3,0,3,100.0,7,2,2,3,-1,0,0,0,614.0,0:51,0,0,0,19.0,0:1,1600000
8473986,Alex,Killorn,1989-09-14,LW,L,2016-17,81,19,17,36,0.44,-9,176,10.8,66,87494.0,18:0,4,8,12,33.33,99,25,33,43,-10,4,6,10,11744.0,2:24,1,1,2,7046.0,1:26,4450000
8473989,Luke,Gazdic,1989-07-25,LW,L,2016-17,11,0,0,0,0.0,-2,3,0.0,12,4707.0,7:7,0,0,0,0.0,16,6,1,0,1,0,0,0,31.0,0:2,0,0,0,0.0,0:0,700000
8473991,Karl,Alzner,1988-09-24,D,L,2016-17,82,3,10,13,0.16,23,81,3.7,28,97371.0,19:47,0,0,0,0.0,105,162,17,52,-35,0,0,0,204.0,0:2,0,0,0,15054.0,3:3,2800000
8473992,Justin,Falk,1988-10-11,D,L,2016-17,52,0,8,8,0.15,-3,33,0.0,29,42738.0,13:41,0,0,0,0.0,101,40,7,22,-15,0,0,0,49.0,0:0,0,0,0,2337.0,0:44,650000
8473994,Jamie,Benn,1989-07-18,LW,L,2016-17,77,26,43,69,0.9,-9,201,12.94,66,89507.0,19:22,212,200,412,51.46,89,47,55,55,0,12,14,26,14360.0,3:6,1,0,1,6732.0,1:27,5250000
8474000,Steven,Kampfer,1988-09-24,D,R,2016-17,11,1,1,2,0.18,-2,10,10.0,6,8750.0,13:15,0,0,0,0.0,24,10,2,3,-1,0,0,0,33.0,0:3,0,0,0,78.0,0:7,612500
8474008,Paul,Carey,1988-09-24,C,L,2016-17,6,0,0,0,0.0,-2,8,0.0,0,3773.0,10:28,0,0,0,0.0,5,1,5,4,1,0,0,0,5.0,0:0,0,0,0,201.0,0:33,575000
8474009,Nick,Bonino,1988-04-20,C,L,2016-17,80,18,19,37,0.46,-5,142,12.68,16,79931.0,16:39,582,631,1213,47.98,60,99,41,24,17,6,5,11,8314.0,1:43,1,0,1,10995.0,2:17,1900000
8474013,Ian,Cole,1989-02-21,D,L,2016-17,81,5,21,26,0.32,26,89,5.62,72,96325.0,19:49,0,0,0,0.0,164,194,32,50,-18,0,1,1,479.0,0:5,0,0,0,11703.0,2:24,2100000
8474027,Justin,Braun,1987-02-10,D,R,2016-17,81,4,9,13,0.16,1,95,4.21,28,97589.0,20:4,0,0,0,0.0,136,161,40,59,-19,0,0,0,630.0,0:7,0,2,2,10365.0,2:7,3800000
8474031,Kevin,Shattenkirk,1989-01-29,D,R,2016-17,80,13,43,56,0.7,-7,161,8.07,47,95715.0,19:56,0,0,0,0.0,88,95,36,40,-4,8,19,27,15383.0,3:12,0,0,0,1476.0,0:18,4250000
8474034,Patrick,Maroon,1988-04-23,LW,L,2016-17,81,27,15,42,0.52,13,178,15.17,95,81345.0,16:44,6,9,15,40.0,189,23,33,49,-16,3,3,6,9364.0,1:55,0,0,0,59.0,0:0,2000000
8474037,James,van Riemsdyk,1989-05-04,LW,L,2016-17,82,29,33,62,0.76,-2,238,12.18,37,78179.0,15:53,1,4,5,20.0,62,29,37,23,14,6,13,19,11815.0,2:24,0,0,0,254.0,0:3,4250000
8474038,Paul,Byron,1989-04-27,LW,L,2016-17,81,22,21,43,0.53,21,96,22.92,29,73228.0,15:4,10,5,15,66.67,119,34,40,22,18,0,4,4,2654.0,0:32,1,0,1,9632.0,1:58,1166667
8474040,Sam,Gagner,1989-08-10,C,R,2016-17,81,18,32,50,0.62,10,178,10.11,22,66654.0,13:42,202,223,425,47.53,22,16,17,27,-10,8,10,18,11793.0,2:25,0,0,0,52.0,0:0,650000
8474052,Chris,Terry,1989-04-07,LW,L,2016-17,14,2,2,4,0.29,-1,15,13.33,4,8306.0,9:53,1,1,2,50.0,10,1,5,8,-3,0,0,0,180.0,0:12,0,0,0,196.0,0:14,600000
8474053,Logan,Couture,1989-03-28,C,L,2016-17,73,25,27,52,0.71,11,174,14.37,12,77114.0,17:36,297,456,753,39.44,57,65,39,76,-37,11,4,15,13218.0,3:1,0,1,1,4809.0,1:5,6000000
8474056,P.K.,Subban,1989-05-13,D,R,2016-17,66,10,30,40,0.61,-8,142,7.04,44,96640.0,24:24,0,0,0,0.0,78,104,30,58,-28,3,13,16,10320.0,2:36,0,1,1,8277.0,2:5,9000000
8474062,Riley,Nash,1989-05-09,C,R,2016-17,81,7,10,17,0.21,-1,125,5.6,14,67094.0,13:48,276,286,562,49.11,67,36,48,18,30,0,0,0,266.0,0:3,1,2,3,9454.0,1:56,900000
8474066,Thomas,Hickey,1989-02-08,D,L,2016-17,76,4,16,20,0.26,-1,87,4.6,35,79885.0,17:31,0,0,0,0.0,89,103,16,43,-27,0,3,3,3065.0,0:40,0,0,0,8494.0,1:51,2200000
8474068,Kyle,Turris,1989-08-14,C,R,2016-17,78,27,28,55,0.71,-3,185,14.59,47,91261.0,19:30,650,575,1225,53.06,21,61,25,57,-32,6,11,17,13658.0,2:55,0,0,0,3366.0,0:43,3500000
8474074,Paul,Postma,1989-02-22,D,R,2016-17,65,1,13,14,0.22,3,50,2.0,15,42332.0,10:51,0,0,0,0.0,36,42,10,29,-19,0,0,0,118.0,0:1,0,0,0,128.0,0:1,887500
8474090,Brendan,Smith,1989-02-08,D,L,2016-17,51,3,6,9,0.18,1,62,4.84,63,58880.0,19:14,0,0,0,0.0,59,65,11,37,-26,1,2,3,2719.0,0:53,0,0,0,5732.0,1:52,2750000
8474091,Brandon,Sutter,1989-02-14,C,R,2016-17,81,17,17,34,0.42,-20,160,10.62,12,91382.0,18:48,788,664,1452,54.27,78,53,32,21,11,4,4,8,12552.0,2:34,0,0,0,9179.0,1:53,4375000
8474098,Colton,Sceviour,1989-04-20,C,R,2016-17,80,9,15,24,0.3,-16,172,5.23,25,70241.0,14:38,31,27,58,53.45,108,64,40,23,17,1,2,3,3998.0,0:49,3,1,4,9654.0,2:0,950000
8474100,Dwight,King,1989-07-05,LW,L,2016-17,80,9,7,16,0.2,-2,110,8.18,12,69152.0,14:24,4,12,16,25.0,120,28,15,18,-3,0,0,0,1114.0,0:13,0,0,0,6576.0,1:22,1950000
8474102,David,Perron,1988-05-28,LW,R,2016-17,82,18,28,46,0.56,-2,151,11.92,54,85106.0,17:17,32,34,66,48.48,87,28,48,21,27,3,10,13,10420.0,2:7,1,0,1,5623.0,1:8,3750000
8474125,Carl,Gunnarsson,1986-11-09,D,L,2016-17,56,0,6,6,0.11,-5,32,0.0,4,45681.0,13:35,0,0,0,0.0,42,68,2,8,-6,0,0,0,20.0,0:0,0,0,0,2723.0,0:48,2900000
8474134,Yannick,Weber,1988-09-23,D,R,2016-17,73,1,7,8,0.11,1,72,1.39,25,52209.0,11:55,0,0,0,0.0,72,53,9,27,-18,0,0,0,718.0,0:9,0,0,0,805.0,0:11,575000
8474141,Patrick,Kane,1988-11-19,RW,L,2016-17,82,34,55,89,1.09,11,292,11.64,32,105263.0,21:23,7,44,51,13.73,28,15,49,42,7,7,16,23,16742.0,3:24,0,0,0,374.0,0:4,10500000
8474145,Robert,Bortuzzo,1989-03-18,D,R,2016-17,38,1,3,4,0.11,11,45,2.22,15,32118.0,14:5,0,0,0,0.0,77,50,4,13,-9,0,0,0,83.0,0:2,0,0,0,1995.0,0:52,1050000
8474150,Mikael,Backlund,1989-03-17,C,L,2016-17,81,22,31,53,0.65,9,197,11.17,36,85565.0,17:36,711,768,1479,48.07,55,41,57,49,8,7,9,16,9941.0,2:2,0,3,3,10924.0,2:14,3575000
8474151,Ryan,McDonagh,1989-06-13,D,L,2016-17,77,6,36,42,0.55,20,153,3.92,37,112530.0,24:21,0,0,0,0.0,80,160,45,60,-15,1,14,15,14297.0,3:5,1,0,1,10924.0,2:21,4700000
8474157,Max,Pacioretty,1988-11-20,LW,L,2016-17,81,35,32,67,0.83,15,268,13.06,38,93198.0,19:10,27,23,50,54.0,63,35,44,47,-3,8,5,13,13214.0,2:43,1,1,2,4700.0,0:58,4500000
8474161,Jakub,Voracek,1989-08-15,RW,L,2016-17,82,20,41,61,0.74,-24,253,7.91,56,93911.0,19:5,3,11,14,21.43,30,22,24,56,-32,5,18,23,17699.0,3:35,0,0,0,94.0,0:1,8250000
8474162,Jake,Muzzin,1989-02-21,D,L,2016-17,82,9,19,28,0.34,-21,184,4.89,46,109688.0,22:17,0,0,0,0.0,162,122,15,70,-55,4,6,10,11965.0,2:25,0,0,0,10599.0,2:9,4000000
8474166,Alec,Martinez,1987-07-26,D,L,2016-17,82,9,30,39,0.48,-17,144,6.25,24,106475.0,21:38,0,1,1,0.0,137,167,5,51,-46,2,13,15,10661.0,2:10,1,0,1,10973.0,2:13,4000000
8474176,Carl,Hagelin,1988-08-23,LW,L,2016-17,61,6,16,22,0.36,10,128,4.69,16,56693.0,15:29,3,3,6,50.0,66,24,19,21,-2,0,0,0,366.0,0:6,0,1,1,8278.0,2:15,4000000
8474189,Lars,Eller,1989-05-08,C,L,2016-17,81,12,13,25,0.31,15,115,10.43,36,67558.0,13:54,416,467,883,47.11,71,30,31,32,-1,0,1,1,874.0,0:10,1,0,1,10530.0,2:10,3500000
8474190,Wayne,Simmonds,1988-08-26,RW,R,2016-17,82,31,23,54,0.66,-18,224,13.84,122,93343.0,18:58,8,9,17,47.06,162,60,38,39,-1,16,9,25,18272.0,3:42,2,0,2,7447.0,1:30,3975000
8474207,Nick,Holden,1987-05-15,D,L,2016-17,80,11,23,34,0.42,13,84,13.1,35,98941.0,20:36,0,1,1,0.0,164,88,23,61,-38,3,1,4,2927.0,0:36,0,1,1,8172.0,1:42,1650000
8474218,Jason,Demers,1988-06-09,D,R,2016-17,81,9,19,28,0.35,-14,98,9.18,53,95309.0,19:36,0,1,1,0.0,106,90,19,31,-12,0,5,5,7868.0,1:37,0,2,2,8536.0,1:45,4500000
8474230,Micheal,Haley,1986-03-30,C,L,2016-17,58,2,10,12,0.21,6,37,5.41,128,31939.0,9:10,66,83,149,44.3,129,23,18,19,-1,0,0,0,103.0,0:1,0,0,0,66.0,0:1,625000
8474250,Zack,Smith,1988-04-05,LW,L,2016-17,74,16,16,32,0.43,6,137,11.68,61,72721.0,16:22,317,292,609,52.05,140,38,31,35,-4,1,0,1,6166.0,1:23,4,0,4,8713.0,1:57,1887500
8474291,Jay,Beagle,1985-10-16,C,R,2016-17,81,13,17,30,0.37,20,100,13.0,22,66251.0,13:37,624,483,1107,56.37,55,44,11,26,-15,0,0,0,448.0,0:5,1,2,3,13431.0,2:45,1750000
8474520,Jason,Garrison,1984-11-13,D,L,2016-17,70,1,8,9,0.13,-8,96,1.04,14,77969.0,18:33,0,0,0,0.0,93,91,8,33,-25,0,0,0,696.0,0:9,0,0,0,9162.0,2:10,4600000
8474563,Drew,Doughty,1989-12-08,D,R,2016-17,82,12,32,44,0.54,8,181,6.63,46,133550.0,27:8,1,0,1,100.0,129,109,24,86,-62,5,14,19,16179.0,3:17,0,1,1,12643.0,2:34,7000000
8474564,Steven,Stamkos,1990-02-07,C,R,2016-17,17,9,11,20,1.18,3,58,15.52,14,18234.0,17:52,106,92,198,53.54,21,3,15,6,9,3,4,7,3473.0,3:24,0,0,0,784.0,0:46,8500000
8474565,Alex,Pietrangelo,1990-01-18,D,R,2016-17,80,14,34,48,0.6,3,181,7.73,24,121353.0,25:16,0,1,1,0.0,38,158,53,27,26,6,13,19,11767.0,2:27,0,0,0,14521.0,3:1,6500000
8474567,Zach,Bogosian,1990-07-15,D,R,2016-17,56,2,9,11,0.2,-17,73,2.74,46,67493.0,20:5,0,0,0,0.0,59,97,11,31,-20,0,1,1,403.0,0:7,0,0,0,5854.0,1:44,5142857
8474568,Luke,Schenn,1989-11-02,D,R,2016-17,78,1,7,8,0.1,-9,94,1.06,85,84469.0,18:2,0,0,0,0.0,286,134,11,31,-20,0,0,0,63.0,0:0,0,0,0,10478.0,2:14,1250000
8474569,Colin,Wilson,1989-10-20,C,L,2016-17,70,12,23,35,0.5,7,113,10.62,18,62821.0,14:57,16,23,39,41.03,50,23,23,25,-2,6,1,7,8146.0,1:56,0,0,0,75.0,0:1,3937500
8474571,Mikkel,Boedker,1989-12-16,LW,L,2016-17,81,10,16,26,0.32,0,122,8.2,10,69738.0,14:20,5,13,18,27.78,71,35,31,37,-6,0,1,1,7476.0,1:32,1,0,1,4088.0,0:50,4000000
8474573,Josh,Bailey,1989-10-02,RW,L,2016-17,82,13,43,56,0.68,5,173,7.51,12,90388.0,18:22,8,7,15,53.33,37,53,54,61,-7,3,9,12,13955.0,2:50,0,0,0,2159.0,0:26,3300000
8474574,Tyler,Myers,1990-02-01,D,R,2016-17,11,2,3,5,0.45,5,16,12.5,13,14657.0,22:12,0,0,0,0.0,12,21,6,10,-4,0,0,0,1119.0,1:41,0,1,1,1947.0,2:57,5500000
8474577,Joe,Colborne,1990-01-30,C,L,2016-17,62,4,4,8,0.13,-21,48,8.33,34,39800.0,10:41,45,72,117,38.46,86,14,10,18,-8,2,1,3,2966.0,0:47,0,0,0,1757.0,0:28,2500000
8474578,Erik,Karlsson,1990-05-31,D,R,2016-17,77,17,54,71,0.92,10,218,7.8,28,123989.0,26:50,0,0,0,0.0,67,201,59,106,-47,4,23,27,17019.0,3:41,0,2,2,9937.0,2:9,6500000
8474579,Luca,Sbisa,1990-01-30,D,L,2016-17,82,2,11,13,0.16,-1,75,2.67,40,93364.0,18:58,0,0,0,0.0,130,122,19,50,-31,0,0,0,265.0,0:3,0,0,0,10863.0,2:12,3600000
8474581,Jake,Gardiner,1990-07-04,D,L,2016-17,82,9,34,43,0.52,24,127,7.09,34,105945.0,21:32,0,0,0,0.0,69,83,44,79,-35,2,11,13,12498.0,2:32,0,0,0,1556.0,0:18,4050000
8474584,Michael,Del Zotto,1990-06-24,D,L,2016-17,51,6,12,18,0.35,-5,92,6.52,28,59682.0,19:30,0,1,1,0.0,173,85,9,30,-21,0,1,1,2926.0,0:57,0,1,1,3916.0,1:16,3875000
8474586,Jordan,Eberle,1990-05-15,C,R,2016-17,82,20,31,51,0.62,3,208,9.62,16,82497.0,16:46,10,10,20,50.0,26,37,38,44,-6,4,10,14,11025.0,2:14,0,0,0,71.0,0:0,6000000
8474589,Tyler,Ennis,1989-10-06,LW,L,2016-17,51,5,8,13,0.25,-10,89,5.62,12,39278.0,12:50,3,13,16,18.75,45,23,19,17,2,0,3,3,4145.0,1:21,0,0,0,0.0,0:0,4600000
8474590,John,Carlson,1990-01-10,D,R,2016-17,72,9,28,37,0.51,7,180,5.0,10,98106.0,22:42,0,0,0,0.0,58,127,51,88,-37,3,13,16,11425.0,2:38,0,1,1,12863.0,2:58,3966667
8474597,Cody,Goloubef,1989-11-30,D,R,2016-17,33,0,5,5,0.15,-11,35,0.0,25,33639.0,16:59,0,0,0,0.0,30,33,5,7,-2,0,0,0,44.0,0:1,0,0,0,3495.0,1:45,750000
8474600,Roman,Josi,1990-06-01,D,L,2016-17,72,12,37,49,0.68,7,217,5.53,18,108323.0,25:4,0,0,0,0.0,54,119,16,41,-25,7,11,18,13065.0,3:1,0,1,1,9922.0,2:17,4000000
8474602,Justin,Schultz,1990-07-06,D,R,2016-17,78,12,39,51,0.65,27,154,7.79,34,95699.0,20:26,0,0,0,0.0,67,116,22,37,-15,3,17,20,12946.0,2:45,0,0,0,322.0,0:4,1400000
8474605,Patrick,Wiercioch,1990-09-12,D,L,2016-17,57,4,8,12,0.21,-18,63,6.35,23,56999.0,16:39,0,0,0,0.0,52,57,6,15,-9,0,0,0,3164.0,0:55,0,0,0,4840.0,1:24,800000
8474610,Zac,Dalpe,1989-11-01,C,R,2016-17,9,1,2,3,0.33,0,8,12.5,9,4620.0,8:33,27,32,59,45.76,5,5,3,0,3,0,0,0,6.0,0:0,0,0,0,0.0,0:0,600000
8474611,Cameron,Gaunce,1990-03-19,D,L,2016-17,12,1,3,4,0.33,1,8,12.5,13,9013.0,12:31,0,0,0,0.0,23,10,2,5,-3,0,0,0,0.0,0:0,0,0,0,743.0,1:1,575000
8474612,Travis,Hamonic,1990-08-16,D,R,2016-17,49,3,11,14,0.29,-21,74,4.05,60,60139.0,20:27,0,0,0,0.0,58,108,14,39,-25,0,1,1,1642.0,0:33,0,0,0,6791.0,2:18,3857143
8474613,Derek,Stepan,1990-06-18,C,R,2016-17,81,17,38,55,0.68,19,209,8.13,16,90437.0,18:36,716,806,1522,47.04,26,45,51,56,-5,4,14,18,12342.0,2:32,1,0,1,6682.0,1:22,6500000
8474618,Marco,Scandella,1990-02-23,D,L,2016-17,71,4,9,13,0.18,-2,88,4.55,25,78122.0,18:20,0,0,0,0.0,50,85,28,36,-8,0,0,0,1182.0,0:16,0,0,0,7137.0,1:40,4000000
8474625,Jimmy,Hayes,1989-11-21,RW,R,2016-17,58,2,3,5,0.09,-3,74,2.7,29,32121.0,9:13,14,41,55,25.45,74,10,14,12,2,0,0,0,1097.0,0:18,0,0,0,13.0,0:0,2300000
8474627,Jori,Lehtera,1987-12-23,C,L,2016-17,64,7,15,22,0.34,-6,67,10.45,34,58273.0,15:10,409,423,832,49.16,64,29,21,14,7,0,3,3,5243.0,1:21,0,0,0,1653.0,0:25,4700000
8474628,Michael,Stone,1990-06-07,D,R,2016-17,64,3,12,15,0.23,0,81,3.7,32,76099.0,19:49,1,0,1,100.0,125,143,5,26,-21,1,4,5,4980.0,1:17,0,0,0,6977.0,1:49,4000000
8474641,Adam,Henrique,1990-02-06,C,L,2016-17,82,20,20,40,0.49,-20,142,14.08,38,89407.0,18:10,585,629,1214,48.19,88,68,45,28,17,6,4,10,12100.0,2:27,2,1,3,11147.0,2:15,4000000
8474642,Lance,Bouma,1990-03-25,LW,L,2016-17,61,3,4,7,0.11,-2,53,5.66,35,41528.0,11:20,4,8,12,33.33,127,44,17,9,8,0,0,0,172.0,0:2,0,0,0,5840.0,1:35,2200000
8474660,David,Warsofsky,1990-05-30,D,L,2016-17,7,0,1,1,0.14,-3,14,0.0,6,6608.0,15:44,0,0,0,0.0,3,12,2,3,-1,0,0,0,384.0,0:54,0,0,0,343.0,0:49,575000
8474668,Dale,Weise,1988-08-05,RW,R,2016-17,64,8,7,15,0.23,1,94,8.51,39,49466.0,12:52,3,0,3,100.0,135,24,13,14,-1,1,1,2,3734.0,0:58,0,0,0,31.0,0:0,2350000
8474673,TJ,Brodie,1990-06-07,D,L,2016-17,82,6,30,36,0.44,-16,78,7.69,24,116019.0,23:34,0,0,0,0.0,30,115,57,76,-19,1,11,12,13623.0,2:46,1,1,2,11481.0,2:20,4650400
8474679,Gustav,Nyquist,1989-09-01,RW,L,2016-17,76,12,36,48,0.63,0,165,7.27,18,79502.0,17:26,4,1,5,80.0,54,20,32,35,-3,2,7,9,12847.0,2:49,0,0,0,134.0,0:1,4750000
8474683,Derek,Grant,1990-04-20,C,L,2016-17,46,0,4,4,0.09,-5,40,0.0,24,26938.0,9:45,201,183,384,52.34,27,29,10,9,1,0,0,0,1185.0,0:25,0,0,0,6042.0,2:11,650000
8474685,Matt,Calvert,1989-12-24,LW,L,2016-17,65,10,5,15,0.23,-4,92,10.87,48,52054.0,13:20,2,14,16,12.5,61,34,23,15,8,0,0,0,537.0,0:8,3,1,4,6614.0,1:41,2200000
8474688,Greg,Pateryn,1990-06-20,D,R,2016-17,36,1,8,9,0.25,-1,42,2.38,10,33312.0,15:25,0,0,0,0.0,69,66,4,22,-18,0,0,0,68.0,0:1,0,0,0,1482.0,0:41,800000
8474697,Mark,Borowiecki,1989-07-12,D,L,2016-17,70,1,2,3,0.04,-3,50,2.0,154,58845.0,14:0,1,0,1,100.0,364,90,6,18,-12,0,0,0,71.0,0:1,0,0,0,2997.0,0:42,1100000
8474707,Philip,Larsen,1989-12-07,D,R,2016-17,26,1,5,6,0.23,-8,32,3.12,4,25675.0,16:27,0,0,0,0.0,12,22,4,14,-10,0,2,2,3517.0,2:15,0,0,0,49.0,0:1,1025000
8474709,Matt,Martin,1989-05-08,LW,L,2016-17,82,5,4,9,0.11,0,66,7.58,123,43776.0,8:53,0,11,11,0.0,300,26,16,13,3,0,0,0,105.0,0:1,0,0,0,1612.0,0:19,2500000
8474715,Cam,Atkinson,1989-06-05,RW,R,2016-17,82,35,27,62,0.76,13,240,14.58,22,88972.0,18:5,2,1,3,66.67,33,34,36,21,15,10,11,21,12473.0,2:32,3,0,3,7663.0,1:33,3500000
8474716,Jared,Spurgeon,1989-11-29,D,R,2016-17,76,10,28,38,0.5,33,144,6.94,20,109591.0,24:1,0,0,0,0.0,49,140,23,22,1,1,4,5,10217.0,2:14,0,1,1,9880.0,2:10,5187500
8474717,Mark,Barberio,1990-03-23,D,L,2016-17,60,2,11,13,0.22,-5,80,2.5,14,65740.0,18:15,0,0,0,0.0,20,55,16,33,-17,1,3,4,5880.0,1:38,0,0,0,1811.0,0:30,750000
8474722,Luke,Witkowski,1990-04-14,RW,R,2016-17,34,0,4,4,0.12,-1,24,0.0,39,20136.0,9:52,0,0,0,0.0,81,21,3,8,-5,0,0,0,189.0,0:5,0,0,0,65.0,0:1,575000
8474727,Ben,Smith,1988-07-11,RW,R,2016-17,40,2,2,4,0.1,-7,30,6.67,4,27519.0,11:27,241,227,468,51.5,29,41,9,5,4,0,0,0,23.0,0:0,0,0,0,5242.0,2:11,675000
8474739,Tommy,Wingels,1988-04-12,C,R,2016-17,73,7,5,12,0.16,-11,81,8.64,27,45998.0,10:30,111,149,260,42.69,126,47,13,15,-2,0,0,0,283.0,0:3,0,0,0,3111.0,0:42,2475000
8474743,Zach,Redmond,1988-07-26,D,R,2016-17,16,0,5,5,0.31,6,12,0.0,2,11818.0,12:18,0,0,0,0.0,25,13,5,6,-1,0,0,0,8.0,0:0,0,0,0,82.0,0:5,612500
8474749,Matt,Bartkowski,1988-06-04,D,L,2016-17,24,1,1,2,0.08,-4,16,6.25,26,22158.0,15:23,0,0,0,0.0,46,12,3,13,-10,0,0,0,45.0,0:1,0,0,0,638.0,0:26,612500
8474774,Dalton,Prout,1990-03-13,D,R,2016-17,29,0,6,6,0.21,-1,13,0.0,44,24302.0,13:58,0,0,0,0.0,44,24,3,12,-9,0,0,0,23.0,0:0,0,0,0,1549.0,0:53,1575000
8474818,Jordie,Benn,1987-07-26,D,L,2016-17,71,4,13,17,0.24,-4,68,5.88,28,77900.0,18:17,0,0,0,0.0,64,144,14,49,-35,0,2,2,4201.0,0:59,0,1,1,10096.0,2:22,1100000
8474849,Antoine,Roussel,1989-11-21,LW,L,2016-17,60,12,15,27,0.45,1,82,14.63,115,55866.0,15:31,7,9,16,43.75,69,45,16,37,-21,0,3,3,4147.0,1:9,0,0,0,7139.0,1:58,2000000
8474870,Tyler,Johnson,1990-07-29,C,R,2016-17,66,19,26,45,0.68,-5,130,14.62,28,74534.0,18:49,583,539,1122,51.96,46,30,26,32,-6,6,11,17,11339.0,2:51,0,0,0,8121.0,2:3,3333333
8474873,Brian,Lashoff,1990-07-16,D,L,2016-17,5,0,0,0,0.0,-3,1,0.0,0,3754.0,12:30,0,0,0,0.0,8,4,0,1,-1,0,0,0,0.0,0:0,0,0,0,220.0,0:44,650000
8474884,Mike,Hoffman,1989-11-24,LW,L,2016-17,74,26,35,61,0.82,17,224,11.61,51,78113.0,17:35,12,9,21,57.14,41,21,45,54,-9,13,13,26,14137.0,3:11,0,0,0,55.0,0:0,5187500
8475098,Tyler,Bozak,1986-03-19,C,R,2016-17,78,18,37,55,0.71,-1,145,12.41,30,76890.0,16:25,774,592,1366,56.66,45,26,52,48,4,7,11,18,11080.0,2:22,0,0,0,403.0,0:5,4200000
8475147,Jordan,Schroeder,1990-09-29,LW,R,2016-17,37,6,7,13,0.35,5,37,16.22,0,21710.0,9:46,19,21,40,47.5,29,15,11,5,6,0,0,0,36.0,0:0,0,0,0,3.0,0:0,650000
8475149,Marcus,Johansson,1990-10-06,LW,L,2016-17,82,24,34,58,0.71,25,129,18.6,10,83610.0,16:59,13,15,28,46.43,32,22,40,48,-8,5,14,19,13882.0,2:49,0,0,0,157.0,0:1,4583333
8475151,Kyle,Palmieri,1991-02-01,RW,R,2016-17,80,26,27,53,0.66,2,192,13.54,46,83275.0,17:20,12,17,29,41.38,124,36,29,34,-5,8,11,19,12654.0,2:38,1,0,1,4547.0,0:56,4650000
8475155,Simon,Despres,1991-07-27,D,L,2016-17,1,0,0,0,0.0,0,1,0.0,0,968.0,16:8,0,0,0,0.0,1,1,0,0,0,0,0,0,231.0,3:51,0,0,0,169.0,2:49,3700000
8475158,Ryan,O'Reilly,1991-02-07,C,L,2016-17,72,20,35,55,0.76,-1,189,10.58,10,92700.0,21:27,1039,752,1791,58.01,21,45,58,27,31,8,16,24,12522.0,2:53,1,1,2,10059.0,2:19,7500000
8475160,Kyle,Clifford,1991-01-13,LW,L,2016-17,73,6,6,12,0.16,-2,122,4.92,92,46968.0,10:43,2,3,5,40.0,146,7,17,7,10,0,0,0,438.0,0:6,0,0,0,124.0,0:1,1600000
8475163,Alex,Chiasson,1990-10-01,RW,R,2016-17,81,12,12,24,0.3,-6,104,11.54,46,65069.0,13:23,7,22,29,24.14,74,18,32,22,10,0,2,2,3118.0,0:38,1,0,1,4518.0,0:55,800000
8475164,Jakob,Silfverberg,1990-10-13,RW,R,2016-17,79,23,26,49,0.62,10,227,10.13,20,87616.0,18:29,1,6,7,14.29,47,46,46,38,8,5,4,9,9312.0,1:57,1,0,1,7741.0,1:37,3750000
8475165,Anton,Lander,1991-04-24,C,L,2016-17,22,1,3,4,0.18,2,12,8.33,6,12902.0,9:46,79,62,141,56.03,28,7,8,4,4,0,0,0,113.0,0:5,0,0,0,2496.0,1:53,987500
8475166,John,Tavares,1990-09-20,C,L,2016-17,77,28,38,66,0.86,4,260,10.77,38,94335.0,20:25,824,804,1628,50.61,42,20,63,81,-18,7,11,18,14760.0,3:11,1,1,2,4414.0,0:57,5500000
8475167,Victor,Hedman,1990-12-18,D,L,2016-17,79,16,56,72,0.91,3,166,9.64,47,116175.0,24:30,0,0,0,0.0,93,132,39,73,-34,4,29,33,14277.0,3:0,0,0,0,9748.0,2:3,4000000
8475168,Matt,Duchene,1991-01-16,C,L,2016-17,77,18,23,41,0.53,-34,160,11.25,12,84565.0,18:18,687,411,1098,62.57,42,41,60,46,14,3,6,9,11601.0,2:30,1,0,1,4424.0,0:57,6000000
8475169,Evander,Kane,1991-08-02,LW,L,2016-17,70,28,15,43,0.61,-17,260,10.77,113,80648.0,19:12,55,67,122,45.08,109,29,34,33,1,3,5,8,7481.0,1:46,0,0,0,5488.0,1:18,5250000
8475170,Brayden,Schenn,1991-08-22,C,L,2016-17,79,25,30,55,0.7,-13,178,14.04,38,84404.0,17:48,232,262,494,46.96,189,42,18,36,-18,17,11,28,17769.0,3:44,0,0,0,59.0,0:0,5125000
8475171,Oliver,Ekman-Larsson,1991-07-17,D,L,2016-17,79,12,27,39,0.49,-25,145,8.28,48,116677.0,24:36,0,0,0,0.0,112,85,18,48,-30,8,11,19,17491.0,3:41,0,0,0,7593.0,1:36,5500000
8475172,Nazem,Kadri,1990-10-06,C,L,2016-17,82,32,29,61,0.74,-7,236,13.56,95,81570.0,16:34,544,590,1134,47.97,124,31,58,59,-1,12,5,17,10751.0,2:11,0,0,0,169.0,0:2,4500000
8475175,Magnus,Paajarvi,1991-04-12,LW,L,2016-17,32,8,5,13,0.41,9,51,15.69,6,23339.0,12:9,1,2,3,33.33,29,16,11,0,11,1,0,1,500.0,0:15,0,0,0,1302.0,0:40,700000
8475176,Ryan,Ellis,1991-01-03,D,R,2016-17,71,16,22,38,0.54,17,140,11.43,29,102052.0,23:57,0,0,0,0.0,64,137,37,41,-4,4,7,11,9327.0,2:11,1,2,3,11078.0,2:36,2500000
8475177,Calvin,de Haan,1991-05-09,D,L,2016-17,82,5,20,25,0.3,15,116,4.31,36,97653.0,19:50,0,0,0,0.0,139,190,24,53,-29,1,1,2,3069.0,0:37,0,0,0,9351.0,1:54,1966667
8475178,Zack,Kassian,1991-01-24,RW,R,2016-17,79,7,17,24,0.3,4,110,6.36,101,58315.0,12:18,4,7,11,36.36,201,16,21,39,-18,0,0,0,443.0,0:5,0,0,0,5220.0,1:6,1500000
8475179,Dmitry,Kulikov,1990-10-29,D,L,2016-17,47,2,3,5,0.11,-26,42,4.76,26,61766.0,21:54,0,0,0,0.0,60,72,18,32,-14,1,2,3,2475.0,0:52,0,0,0,4528.0,1:36,4333333
8475180,Peter,Holland,1991-01-14,C,L,2016-17,48,5,7,12,0.25,-16,79,6.33,22,36720.0,12:45,228,274,502,45.42,37,9,21,16,5,1,0,1,3309.0,1:8,0,0,0,389.0,0:8,1300000
8475181,Nick,Leddy,1991-03-20,D,L,2016-17,81,11,35,46,0.57,-3,137,8.03,12,110410.0,22:43,0,0,0,0.0,77,109,26,48,-22,3,12,15,15300.0,3:8,0,0,0,3810.0,0:47,5500000
8475184,Chris,Kreider,1991-04-30,LW,L,2016-17,75,28,25,53,0.71,6,186,15.05,58,76522.0,17:0,5,4,9,55.56,132,30,17,33,-16,6,7,13,11685.0,2:35,0,0,0,117.0,0:1,4625000
8475185,Jacob,Josefson,1991-03-02,C,L,2016-17,38,1,9,10,0.26,-1,44,2.27,16,27924.0,12:14,162,151,313,51.76,31,12,7,9,-2,0,1,1,2106.0,0:55,0,0,0,1297.0,0:34,1100000
8475186,John,Moore,1990-11-19,D,L,2016-17,63,12,10,22,0.35,-7,102,11.76,39,71731.0,18:58,0,0,0,0.0,68,61,7,41,-34,1,2,3,4493.0,1:11,0,0,0,6897.0,1:49,1666667
8475188,Brayden,McNabb,1991-01-21,D,L,2016-17,49,2,2,4,0.08,1,47,4.26,54,44292.0,15:3,0,0,0,0.0,110,54,10,32,-22,0,0,0,259.0,0:5,0,0,0,1666.0,0:34,1700000
8475191,Reilly,Smith,1991-04-01,RW,L,2016-17,80,15,22,37,0.46,-13,160,9.38,17,88096.0,18:21,3,3,6,50.0,75,34,49,39,10,6,5,11,11584.0,2:24,1,0,1,8246.0,1:43,3425000
8475192,Taylor,Beck,1991-05-13,LW,R,2016-17,5,0,0,0,0.0,-3,5,0.0,4,2643.0,8:48,0,1,1,0.0,5,0,1,2,-1,0,0,0,87.0,0:17,0,0,0,0.0,0:0,650000
8475193,Tomas,Tatar,1990-12-01,LW,L,2016-17,82,25,21,46,0.56,-8,166,15.06,26,85004.0,17:16,8,5,13,61.54,92,24,34,38,-4,5,3,8,11670.0,2:22,0,0,0,231.0,0:2,2750000
8475197,Tyson,Barrie,1991-07-26,D,R,2016-17,74,7,31,38,0.51,-34,182,3.85,18,103486.0,23:18,0,0,0,0.0,32,75,22,51,-29,1,9,10,13632.0,3:4,0,0,0,2414.0,0:32,5500000
8475199,Eric,Gelinas,1991-05-08,D,L,2016-17,27,0,1,1,0.04,-4,29,0.0,12,18764.0,11:34,0,1,1,0.0,32,16,3,6,-3,0,0,0,134.0,0:4,0,0,0,215.0,0:7,1575000
8475200,Dmitry,Orlov,1991-07-23,D,L,2016-17,82,6,27,33,0.4,30,125,4.8,51,96107.0,19:32,0,0,0,0.0,122,94,34,50,-16,1,5,6,5605.0,1:8,0,0,0,1188.0,0:14,2570000
8475204,Brandon,Pirri,1991-04-10,RW,L,2016-17,60,8,10,18,0.3,-8,96,8.33,25,44198.0,12:16,140,103,243,57.61,41,20,22,26,-4,5,4,9,9216.0,2:33,0,0,0,32.0,0:0,1100000
8475208,Brian,Dumoulin,1991-09-06,D,L,2016-17,70,1,14,15,0.21,0,78,1.28,14,86294.0,20:32,0,0,0,0.0,113,99,25,37,-12,0,4,4,2172.0,0:31,0,0,0,7690.0,1:49,800000
8475209,Richard,Panik,1991-02-07,RW,L,2016-17,82,22,22,44,0.54,14,155,14.19,58,72490.0,14:44,2,5,7,28.57,147,45,30,23,7,4,5,9,8117.0,1:38,0,0,0,21.0,0:0,875000
8475210,Anton,Rodin,1990-11-21,RW,L,2016-17,3,0,1,1,0.33,1,2,0.0,0,1604.0,8:54,0,0,0,0.0,0,1,2,1,1,0,0,0,88.0,0:29,0,0,0,0.0,0:0,950000
8475213,Drew,Shore,1991-01-29,C,R,2016-17,14,0,2,2,0.14,-3,11,0.0,4,10051.0,11:57,38,33,71,53.52,22,3,4,5,-1,0,0,0,77.0,0:5,0,0,0,673.0,0:48,600000
8475218,Mattias,Ekholm,1990-05-24,D,L,2016-17,82,3,20,23,0.28,4,120,2.5,34,115415.0,23:27,0,0,0,0.0,61,108,38,66,-28,0,3,3,7020.0,1:25,0,1,1,11131.0,2:15,3750000
8475220,Marcus,Foligno,1991-08-10,LW,L,2016-17,80,13,10,23,0.29,-1,97,13.4,73,74264.0,15:28,1,4,5,20.0,279,57,33,35,-2,0,0,0,743.0,0:9,1,0,1,5565.0,1:9,2250000
8475222,Sami,Vatanen,1991-06-03,D,R,2016-17,71,3,21,24,0.34,3,117,2.56,30,92289.0,21:39,0,0,0,0.0,75,128,15,39,-24,2,12,14,12074.0,2:50,0,0,0,9202.0,2:9,4875000
8475223,Linden,Vey,1991-07-17,RW,R,2016-17,4,0,0,0,0.0,-2,1,0.0,0,2644.0,11:1,9,15,24,37.5,1,0,0,2,-2,0,0,0,447.0,1:51,0,0,0,0.0,0:0,700000
8475225,Craig,Smith,1989-09-05,RW,R,2016-17,78,12,17,29,0.37,7,155,7.74,30,64692.0,13:49,51,60,111,45.95,93,16,34,35,-1,2,1,3,5165.0,1:6,0,0,0,76.0,0:0,4250000
8475227,Chris,Wideman,1990-01-07,D,R,2016-17,76,5,12,17,0.22,7,123,4.07,46,63657.0,13:57,0,0,0,0.0,68,68,14,35,-21,1,4,5,6900.0,1:30,0,0,0,325.0,0:4,800000
8475231,Casey,Cizikas,1991-02-27,C,L,2016-17,59,8,17,25,0.42,9,82,9.76,30,49230.0,13:54,420,426,846,49.65,144,58,36,24,12,0,1,1,525.0,0:8,0,0,0,7613.0,2:9,3350000
8475233,David,Savard,1990-10-22,D,R,2016-17,74,6,17,23,0.31,33,135,4.44,44,96940.0,21:50,0,0,0,0.0,127,126,22,44,-22,0,0,0,926.0,0:12,0,2,2,10900.0,2:27,4250000
8475235,Nicolas,Deslauriers,1991-02-22,LW,L,2016-17,42,0,2,2,0.05,-6,26,0.0,38,18688.0,7:24,0,3,3,0.0,109,5,2,3,-1,0,0,0,80.0,0:1,0,0,0,78.0,0:1,775000
8475236,Cody,Eakin,1991-05-24,C,L,2016-17,60,3,9,12,0.2,-7,82,3.66,49,60535.0,16:48,524,477,1001,52.35,65,39,24,33,-9,0,2,2,4162.0,1:9,0,0,0,6158.0,1:42,3850000
8475246,Kevin,Connauton,1990-02-23,D,L,2016-17,24,0,1,1,0.04,-1,21,0.0,24,18910.0,13:7,0,0,0,0.0,48,22,4,5,-1,0,0,0,321.0,0:13,0,0,0,1185.0,0:49,1000000
8475250,Andrej,Nestrasil,1991-02-22,C,L,2016-17,19,1,4,5,0.26,-3,27,3.7,2,12430.0,10:54,3,7,10,30.0,10,6,11,8,3,0,0,0,592.0,0:31,0,0,0,0.0,0:0,912500
8475254,Gabriel,Dumont,1990-10-06,C,R,2016-17,39,2,2,4,0.1,1,34,5.88,29,22627.0,9:40,133,109,242,54.96,83,19,6,5,1,0,0,0,157.0,0:4,0,0,0,773.0,0:19,575000
8475263,Wade,Megan,1990-07-22,C,L,2016-17,3,1,0,1,0.33,1,6,16.67,0,1584.0,8:48,13,14,27,48.15,2,0,0,0,0,0,0,0,7.0,0:2,0,0,0,80.0,0:26,575000
8475268,Gabriel,Bourque,1990-09-23,LW,L,2016-17,6,0,0,0,0.0,0,4,0.0,0,4032.0,11:12,0,1,1,0.0,17,6,1,0,1,0,0,0,0.0,0:0,0,0,0,794.0,2:12,800000
8475274,Seth,Helgeson,1990-10-08,D,L,2016-17,9,1,0,1,0.11,2,3,33.33,15,7273.0,13:28,0,0,0,0.0,16,11,0,0,0,0,0,0,0.0,0:0,0,0,0,550.0,1:1,587500
8475278,Byron,Froese,1991-03-12,C,R,2016-17,6,0,0,0,0.0,-3,6,0.0,5,3798.0,10:33,26,30,56,46.43,3,4,3,2,1,0,0,0,214.0,0:35,0,0,0,77.0,0:12,575000
8475279,Ben,Chiarot,1991-05-09,D,L,2016-17,59,2,10,12,0.2,2,49,4.08,33,54237.0,15:19,0,0,0,0.0,78,94,13,46,-33,0,0,0,101.0,0:1,0,0,0,6985.0,1:58,850000
8475287,Erik,Haula,1991-03-23,LW,L,2016-17,72,15,11,26,0.36,5,134,11.19,28,59673.0,13:48,404,346,750,53.87,39,38,24,18,6,1,0,1,871.0,0:12,0,0,0,4630.0,1:4,1000000
8475296,Mitch,Callahan,1991-08-17,RW,R,2016-17,4,0,0,0,0.0,0,2,0.0,0,1635.0,6:48,0,0,0,0.0,3,2,1,0,1,0,0,0,0.0,0:0,0,0,0,0.0,0:0,600000
8475310,Curtis,McKenzie,1991-02-22,LW,L,2016-17,53,6,10,16,0.3,5,66,9.09,72,34509.0,10:51,3,3,6,50.0,103,31,12,10,2,0,0,0,211.0,0:3,0,0,0,3131.0,0:59,675000
8475314,Anders,Lee,1990-07-03,LW,L,2016-17,81,34,18,52,0.64,9,191,17.8,56,75759.0,15:35,7,11,18,38.89,172,34,22,26,-4,9,5,14,11955.0,2:27,0,0,0,109.0,0:1,3750000
8475321,Phil,Varone,1990-12-04,C,L,2016-17,7,0,0,0,0.0,-3,1,0.0,2,3351.0,7:58,15,12,27,55.56,3,1,3,4,-1,0,0,0,299.0,0:42,0,0,0,0.0,0:0,700000
8475323,Marcus,Kruger,1990-05-27,C,L,2016-17,70,5,12,17,0.24,7,83,6.02,34,58886.0,14:1,357,370,727,49.11,31,62,24,10,14,0,0,0,361.0,0:5,0,0,0,9340.0,2:13,3083333
8475324,Nick,Jensen,1990-09-21,D,R,2016-17,49,4,9,13,0.27,-7,59,6.78,12,52202.0,17:45,0,0,0,0.0,55,56,10,37,-27,0,0,0,196.0,0:4,0,1,1,4500.0,1:31,587500
8475325,Jordan,Nolan,1989-06-23,C,L,2016-17,46,4,4,8,0.17,-3,39,10.26,44,29962.0,10:51,2,4,6,33.33,62,7,5,10,-5,0,0,0,491.0,0:10,0,0,0,43.0,0:0,950000
8475343,Nic,Dowd,1990-05-27,C,R,2016-17,70,6,16,22,0.31,-15,78,7.69,25,52314.0,12:27,338,369,707,47.81,145,35,19,22,-3,1,7,8,6570.0,1:33,0,0,0,251.0,0:3,640000
8475413,Justin,Dowling,1990-10-01,C,L,2016-17,9,0,2,2,0.22,0,11,0.0,2,5654.0,10:28,38,31,69,55.07,1,0,3,1,2,0,1,1,53.0,0:5,0,0,0,61.0,0:6,625000
8475430,Brandon,Manning,1990-06-04,D,L,2016-17,65,3,9,12,0.18,-12,84,3.57,83,70419.0,18:3,0,1,1,0.0,121,79,9,38,-29,0,0,0,638.0,0:9,1,0,1,6361.0,1:37,975000
8475455,Brenden,Dillon,1990-11-13,D,L,2016-17,81,2,8,10,0.12,-2,86,2.33,60,80031.0,16:28,0,0,0,0.0,174,81,11,34,-23,0,0,0,474.0,0:5,0,0,0,3897.0,0:48,3270000
8475462,Radko,Gudas,1990-06-05,D,R,2016-17,67,6,17,23,0.34,8,113,5.31,93,77555.0,19:17,0,0,0,0.0,280,124,18,40,-22,0,1,1,274.0,0:4,0,0,0,7666.0,1:54,3350000
8475597,Shane,Harper,1989-02-01,RW,R,2016-17,14,2,1,3,0.21,-1,13,15.38,18,8652.0,10:18,0,0,0,0.0,19,0,4,3,1,0,0,0,17.0,0:1,0,0,0,12.0,0:0,650000
8475613,Nate,Prosser,1986-05-07,D,R,2016-17,39,2,5,7,0.18,0,20,10.0,12,29789.0,12:43,0,0,0,0.0,30,64,3,10,-7,0,1,1,24.0,0:0,0,0,0,1382.0,0:35,625000
8475625,Matt,Irwin,1987-11-29,D,L,2016-17,74,3,11,14,0.19,15,98,3.06,26,72228.0,16:16,0,0,0,0.0,115,121,18,39,-21,0,0,0,125.0,0:1,0,2,2,5453.0,1:13,575000
8475690,Christopher,Tanev,1989-12-20,D,R,2016-17,53,2,8,10,0.19,3,39,5.13,14,64697.0,20:20,0,0,0,0.0,19,91,15,25,-10,0,0,0,1442.0,0:27,0,0,0,9190.0,2:53,4450000
8475692,Mats,Zuccarello,1987-09-01,RW,L,2016-17,80,15,44,59,0.74,15,189,7.94,26,90378.0,18:49,6,7,13,46.15,85,52,70,54,16,5,9,14,13106.0,2:43,0,0,0,2162.0,0:27,4500000
8475714,Calle,Jarnkrok,1991-09-25,C,R,2016-17,81,15,16,31,0.38,-1,134,11.19,25,76428.0,15:43,452,463,915,49.4,49,29,23,22,1,2,2,4,3980.0,0:49,1,2,3,8624.0,1:46,2000000
8475715,Oscar,Lindberg,1991-10-29,C,L,2016-17,65,8,12,20,0.31,2,86,9.3,32,42235.0,10:49,299,276,575,52.0,94,36,10,12,-2,0,1,1,368.0,0:5,0,0,0,529.0,0:8,650000
8475716,Martin,Marincin,1992-02-18,D,L,2016-17,25,1,6,7,0.28,3,22,4.55,16,27071.0,18:2,0,0,0,0.0,25,27,7,15,-8,0,0,0,84.0,0:3,0,1,1,4230.0,2:49,1250000
8475722,Jason,Zucker,1992-01-16,LW,L,2016-17,79,22,25,47,0.59,34,172,12.79,30,72455.0,15:17,1,4,5,20.0,73,42,44,23,21,1,0,1,1182.0,0:14,0,0,0,2905.0,0:36,2000000
8475726,Tyler,Toffoli,1992-04-24,C,R,2016-17,63,16,18,34,0.54,6,165,9.7,22,62694.0,16:35,2,3,5,40.0,54,4,19,31,-12,4,3,7,8607.0,2:16,0,1,1,3981.0,1:3,3250000
8475727,Ryan,Spooner,1992-01-30,C,L,2016-17,78,11,28,39,0.5,-8,145,7.59,14,65964.0,14:5,79,124,203,38.92,24,17,36,50,-14,3,15,18,12294.0,2:37,0,1,1,1063.0,0:13,950000
8475728,Johan,Larsson,1992-07-25,C,L,2016-17,36,6,5,11,0.31,-7,49,12.24,20,36401.0,16:51,261,272,533,48.97,33,23,13,16,-3,1,0,1,1014.0,0:28,0,0,0,2653.0,1:13,950000
8475730,Stephen,Johns,1992-04-18,D,R,2016-17,61,4,6,10,0.16,-10,91,4.4,36,66815.0,18:15,0,0,0,0.0,159,130,20,45,-25,0,1,1,1001.0,0:16,0,0,0,7449.0,2:2,725000
8475735,Greg,McKegg,1992-06-17,C,L,2016-17,46,3,4,7,0.15,-3,36,8.33,22,27331.0,9:54,90,90,180,50.0,48,16,7,6,1,0,0,0,448.0,0:9,0,0,0,1274.0,0:27,700000
8475738,Jordan,Weal,1992-04-15,C,R,2016-17,23,8,4,12,0.52,5,49,16.33,10,19749.0,14:18,14,14,28,50.0,7,8,14,6,8,1,0,1,2167.0,1:34,0,0,0,19.0,0:0,650000
8475739,Michael,Bournival,1992-05-31,LW,L,2016-17,19,2,1,3,0.16,-3,25,8.0,2,11568.0,10:8,1,2,3,33.33,31,8,6,3,3,0,0,0,136.0,0:7,0,0,0,0.0,0:0,575000
8475744,Evgeny,Kuznetsov,1992-05-19,C,L,2016-17,82,19,40,59,0.72,18,170,11.18,46,83410.0,16:57,456,581,1037,43.97,57,18,43,59,-16,3,11,14,9855.0,2:0,0,0,0,128.0,0:1,3000000
8475745,Charlie,Coyle,1992-03-02,C,R,2016-17,82,18,38,56,0.68,13,159,11.32,36,82174.0,16:42,114,134,248,45.97,101,63,30,34,-4,4,5,9,10502.0,2:8,0,0,0,1766.0,0:21,3200000
8475747,Patrik,Nemeth,1992-02-08,D,L,2016-17,40,0,3,3,0.08,-4,46,0.0,14,37869.0,15:46,0,0,0,0.0,45,47,10,18,-8,0,0,0,98.0,0:2,0,0,0,2450.0,1:1,900000
8475750,Jon,Merrill,1992-02-03,D,L,2016-17,51,1,5,6,0.12,-9,48,2.08,24,56813.0,18:33,0,0,0,0.0,39,68,16,22,-6,0,0,0,921.0,0:18,0,0,0,4581.0,1:29,1137500
8475752,Tyler,Pitlick,1991-11-01,C,R,2016-17,31,8,3,11,0.35,0,54,14.81,6,18459.0,9:55,8,7,15,53.33,70,13,3,8,-5,0,0,0,160.0,0:5,0,0,0,262.0,0:8,725000
8475753,Justin,Faulk,1992-03-20,D,R,2016-17,75,17,20,37,0.49,-18,225,7.56,32,104133.0,23:8,0,0,0,0.0,117,84,53,45,8,4,9,13,12257.0,2:43,0,0,0,3180.0,0:42,4833333
8475754,Brock,Nelson,1991-10-15,C,L,2016-17,81,20,25,45,0.56,-6,173,11.56,36,76050.0,15:38,346,445,791,43.74,50,48,43,43,0,1,5,6,9090.0,1:52,0,1,1,2942.0,0:36,2500000
8475755,Alex,Petrovic,1992-03-03,D,R,2016-17,49,1,13,14,0.29,-1,55,1.82,79,53361.0,18:9,0,0,0,0.0,106,55,16,27,-11,0,0,0,326.0,0:6,0,0,0,3865.0,1:18,1050000
8475758,Devante,Smith-Pelly,1992-06-14,RW,R,2016-17,53,4,5,9,0.17,-19,76,5.26,12,42950.0,13:30,29,42,71,40.85,94,32,17,14,3,0,2,2,3576.0,1:7,0,0,0,3908.0,1:13,1300000
8475760,Nick,Bjugstad,1992-07-17,C,R,2016-17,54,7,7,14,0.26,-19,91,7.69,22,42615.0,13:9,186,205,391,47.57,72,9,21,17,4,1,2,3,4592.0,1:25,0,0,0,112.0,0:2,4100000
8475761,Beau,Bennett,1991-11-27,RW,R,2016-17,65,8,11,19,0.29,-3,101,7.92,20,52876.0,13:33,3,13,16,18.75,77,13,19,16,3,1,1,2,6567.0,1:41,0,0,0,69.0,0:1,725000
8475762,Derek,Forbort,1992-03-04,D,L,2016-17,82,2,16,18,0.22,8,100,2.0,54,98971.0,20:6,1,0,1,100.0,180,159,9,73,-64,0,0,0,745.0,0:9,0,1,1,10752.0,2:11,650000
8475763,Kevin,Hayes,1992-05-08,C,L,2016-17,76,17,32,49,0.64,10,143,11.89,18,75508.0,16:33,442,526,968,45.66,40,30,54,66,-12,1,6,7,6661.0,1:27,1,6,7,6511.0,1:25,2600000
8475764,Cam,Fowler,1991-12-05,D,L,2016-17,80,11,28,39,0.49,7,186,5.91,20,119271.0,24:50,0,0,0,0.0,29,134,30,68,-38,5,10,15,14888.0,3:6,1,1,2,13232.0,2:45,4000000
8475765,Vladimir,Tarasenko,1991-12-13,RW,L,2016-17,82,39,36,75,0.91,-1,286,13.64,12,90872.0,18:28,5,5,10,50.0,50,31,29,31,-2,9,13,22,14683.0,2:59,0,0,0,900.0,0:10,7500000
8475766,Austin,Watson,1992-01-13,LW,R,2016-17,77,5,12,17,0.22,14,90,5.56,99,57408.0,12:25,17,25,42,40.48,143,66,24,14,10,0,0,0,604.0,0:7,0,1,1,7954.0,1:43,575000
8475768,Jaden,Schwartz,1992-06-25,LW,L,2016-17,78,19,36,55,0.71,14,179,10.61,18,88482.0,18:54,67,73,140,47.86,71,43,59,29,30,3,6,9,12325.0,2:38,0,0,0,5107.0,1:5,5350000
8475769,Quinton,Howden,1992-01-21,C,L,2016-17,5,0,0,0,0.0,1,5,0.0,0,2597.0,8:39,0,2,2,0.0,4,0,1,0,1,0,0,0,57.0,0:11,0,0,0,0.0,0:0,650000
8475772,Riley,Sheahan,1991-12-07,C,L,2016-17,80,2,11,13,0.16,-29,109,1.83,14,67064.0,13:58,236,230,466,50.64,81,38,20,22,-2,1,2,3,5378.0,1:7,0,0,0,4189.0,0:52,2075000
8475774,Petter,Granberg,1992-08-27,D,R,2016-17,10,0,0,0,0.0,0,4,0.0,10,5776.0,9:37,0,0,0,0.0,17,9,0,1,-1,0,0,0,0.0,0:0,0,0,0,206.0,0:20,612500
8475780,Chris,Wagner,1991-05-27,RW,R,2016-17,43,6,1,7,0.16,2,40,15.0,6,24142.0,9:21,62,86,148,41.89,112,24,4,13,-9,0,0,0,179.0,0:4,0,0,0,3610.0,1:23,637500
8475784,Jeff,Skinner,1992-05-16,LW,L,2016-17,79,37,26,63,0.8,-3,281,13.17,28,84081.0,17:44,10,17,27,37.04,33,28,65,65,0,7,8,15,10776.0,2:16,0,0,0,37.0,0:0,5725000
8475786,Zach,Hyman,1992-06-09,C,R,2016-17,82,10,18,28,0.34,2,156,6.41,30,82149.0,16:41,11,18,29,37.93,109,43,42,25,17,0,0,0,830.0,0:10,4,0,4,13722.0,2:47,900000
8475788,Alexander,Burmistrov,1991-10-21,C,L,2016-17,49,5,11,16,0.33,-7,45,11.11,12,39266.0,13:21,178,259,437,40.73,60,19,12,14,-2,4,1,5,3400.0,1:9,0,1,1,2598.0,0:53,1550000
8475790,Erik,Gudbranson,1992-01-07,D,R,2016-17,30,1,5,6,0.2,-14,40,2.5,18,36603.0,20:20,0,0,0,0.0,66,44,4,23,-19,0,0,0,389.0,0:12,0,0,0,4787.0,2:39,3500000
8475791,Taylor,Hall,1991-11-14,LW,L,2016-17,72,20,33,53,0.74,-9,238,8.4,32,83510.0,19:19,8,10,18,44.44,59,31,43,44,-1,7,8,15,11934.0,2:45,0,0,0,1215.0,0:16,6000000
8475792,Brett,Connolly,1992-05-02,RW,R,2016-17,66,15,8,23,0.35,20,81,18.52,40,42331.0,10:41,4,10,14,28.57,89,12,16,13,3,1,0,1,1781.0,0:26,0,0,0,63.0,0:0,850000
8475793,Ryan,Johansen,1992-07-31,C,R,2016-17,82,14,47,61,0.74,1,154,9.09,60,92671.0,18:50,803,669,1472,54.55,77,28,38,51,-13,4,19,23,14390.0,2:55,1,0,1,3879.0,0:47,4000000
8475794,Tyler,Seguin,1992-01-31,C,R,2016-17,82,26,46,72,0.88,-15,301,8.64,22,90826.0,18:27,401,385,786,51.02,60,26,37,39,-2,11,18,29,15592.0,3:10,0,0,0,129.0,0:1,5750000
8475795,Dylan,McIlrath,1992-04-20,D,R,2016-17,6,1,0,1,0.17,-2,3,33.33,14,3426.0,9:31,0,0,0,0.0,15,4,1,3,-2,0,0,0,0.0,0:0,0,0,0,66.0,0:11,800000
8475796,Mark,Pysyk,1992-01-11,D,R,2016-17,82,4,13,17,0.21,0,86,4.65,10,91319.0,18:33,0,1,1,0.0,72,99,31,36,-5,0,0,0,431.0,0:5,0,0,0,13946.0,2:50,1125000
8475798,Mikael,Granlund,1992-02-26,RW,L,2016-17,81,26,43,69,0.85,23,177,14.69,12,91487.0,18:49,16,17,33,48.48,50,50,43,33,10,7,13,20,10626.0,2:11,3,1,4,7300.0,1:30,3000000
8475799,Nino,Niederreiter,1992-09-08,RW,L,2016-17,82,25,32,57,0.7,17,186,13.44,53,74153.0,15:4,0,1,1,0.0,120,20,32,27,5,8,6,14,9868.0,2:0,0,0,0,9.0,0:0,2666667
8475800,Teemu,Pulkkinen,1992-01-02,LW,R,2016-17,13,2,0,2,0.15,-2,10,20.0,6,7411.0,9:30,0,1,1,0.0,4,3,2,6,-4,0,0,0,534.0,0:41,0,0,0,0.0,0:0,812500
8475807,Joakim,Nordstrom,1992-02-25,LW,L,2016-17,82,7,5,12,0.15,-12,104,6.73,17,62576.0,12:43,9,20,29,31.03,148,41,27,21,6,0,0,0,346.0,0:4,1,0,1,8032.0,1:37,1275000
8475808,Michael,Chaput,1992-04-09,C,L,2016-17,68,4,5,9,0.13,-12,64,6.25,29,44970.0,11:1,203,182,385,52.73,68,29,13,14,-1,0,0,0,357.0,0:5,0,0,0,1968.0,0:28,600000
8475810,Bryan,Rust,1992-05-11,RW,R,2016-17,57,15,13,28,0.49,4,110,13.64,8,46636.0,13:38,2,3,5,40.0,101,29,18,16,2,0,0,0,711.0,0:12,0,1,1,2497.0,0:43,640000
8475815,Julian,Melchiori,1991-12-06,D,L,2016-17,18,0,2,2,0.11,0,15,0.0,8,19837.0,18:22,0,0,0,0.0,30,31,4,18,-14,0,0,0,22.0,0:1,0,0,0,857.0,0:47,625000
8475820,Joonas,Donskoi,1992-04-13,RW,R,2016-17,61,6,11,17,0.28,-5,95,6.32,10,50548.0,13:48,8,8,16,50.0,27,27,31,35,-4,1,3,4,5142.0,1:24,0,0,0,49.0,0:0,925000
8475832,Tom,Kuhnhackl,1992-01-21,RW,L,2016-17,57,4,12,16,0.28,8,49,8.16,18,36425.0,10:39,2,2,4,50.0,112,42,6,5,1,0,0,0,131.0,0:2,1,1,2,6094.0,1:46,625000
8475834,Marcus,Sorensen,1992-04-07,LW,L,2016-17,19,1,3,4,0.21,-1,27,3.7,4,12328.0,10:48,3,1,4,75.0,15,6,9,11,-2,0,0,0,122.0,0:6,0,0,0,725.0,0:38,925000
8475841,Tim,Heed,1991-01-27,D,R,2016-17,1,0,0,0,0.0,0,1,0.0,0,989.0,16:29,0,0,0,0.0,0,2,1,0,1,0,0,0,51.0,0:51,0,0,0,0.0,0:0,775000
8475844,Kenny,Agostino,1992-04-30,LW,L,2016-17,7,1,2,3,0.43,0,17,5.88,2,5366.0,12:46,0,0,0,0.0,9,3,1,4,-3,0,1,1,536.0,1:16,0,0,0,0.0,0:0,625000
8475848,Brendan,Gallagher,1992-05-06,RW,R,2016-17,64,10,19,29,0.45,7,187,5.35,39,57965.0,15:5,30,44,74,40.54,69,15,33,25,8,1,2,3,7877.0,2:3,0,0,0,135.0,0:2,3750000
8475855,Jesper,Fast,1991-12-02,RW,R,2016-17,68,6,15,21,0.31,6,56,10.71,16,56290.0,13:47,17,27,44,38.64,99,44,29,21,8,0,0,0,408.0,0:6,0,0,0,6427.0,1:34,950000
8475857,Kevin,Gravel,1992-03-06,D,L,2016-17,49,1,6,7,0.14,3,52,1.92,6,41602.0,14:9,0,0,0,0.0,73,65,2,24,-22,1,1,2,2832.0,0:57,0,0,0,1512.0,0:30,667500
8475868,Anthony,Bitetto,1990-07-15,D,L,2016-17,29,0,7,7,0.24,-1,17,0.0,25,20538.0,11:48,0,0,0,0.0,43,24,1,8,-7,0,0,0,341.0,0:11,0,0,0,475.0,0:16,612500
8475869,Brandon,Davidson,1991-08-21,D,L,2016-17,38,0,3,3,0.08,-2,42,0.0,20,35841.0,15:43,0,0,0,0.0,42,61,7,20,-13,0,0,0,92.0,0:2,0,0,0,1984.0,0:52,1425000
8475878,Freddie,Hamilton,1992-01-01,C,R,2016-17,26,2,0,2,0.08,-3,30,6.67,8,15258.0,9:46,75,51,126,59.52,46,1,3,2,1,0,0,0,0.0,0:0,0,0,0,539.0,0:20,612500
8475906,John,Klingberg,1992-08-14,D,R,2016-17,80,13,36,49,0.61,2,124,10.48,34,112108.0,23:21,1,0,1,100.0,42,117,40,99,-59,4,13,17,15262.0,3:10,0,0,0,1057.0,0:13,4250000
8475907,Micheal,Ferland,1992-04-20,LW,L,2016-17,76,15,10,25,0.33,-1,106,14.15,50,52736.0,11:33,3,4,7,42.86,149,26,36,38,-2,2,2,4,2127.0,0:27,0,0,0,162.0,0:2,825000
8475913,Mark,Stone,1992-05-13,RW,R,2016-17,71,22,32,54,0.76,12,134,16.42,25,79072.0,18:33,10,15,25,40.0,43,53,96,47,49,6,8,14,13101.0,3:4,0,0,0,234.0,0:3,3500000
8475949,Marek,Hrivik,1991-08-28,LW,R,2016-17,16,0,2,2,0.12,-3,15,0.0,2,10003.0,10:25,32,48,80,40.0,19,5,5,2,3,0,1,1,61.0,0:3,0,0,0,290.0,0:18,600000
8475958,Michael,Sgarbossa,1992-07-25,C,L,2016-17,38,2,7,9,0.24,-5,33,6.06,9,25430.0,11:9,138,176,314,43.95,39,16,6,14,-8,1,1,2,1504.0,0:39,0,0,0,339.0,0:8,600000
8475982,Erik,Burgdoerfer,1988-12-11,D,R,2016-17,2,0,0,0,0.0,-1,2,0.0,0,1340.0,11:10,0,0,0,0.0,5,0,0,1,-1,0,0,0,0.0,0:0,0,0,0,0.0,0:0,575000
8476043,Ben,Street,1987-02-13,C,L,2016-17,6,0,1,1,0.17,1,8,0.0,0,2970.0,8:15,0,0,0,0.0,3,0,0,2,-2,0,0,0,0.0,0:0,0,0,0,0.0,0:0,600000
8476116,Ryan,Garbutt,1985-08-12,C,L,2016-17,27,2,1,3,0.11,-3,26,7.69,20,14837.0,9:9,7,4,11,63.64,53,12,3,3,0,0,0,0,113.0,0:4,0,1,1,1891.0,1:10,1800000
8476158,Harry,Zolnierczyk,1987-09-01,LW,L,2016-17,24,2,2,4,0.17,-2,19,10.53,10,12776.0,8:52,8,11,19,42.11,25,11,7,1,6,0,0,0,13.0,0:0,0,0,0,65.0,0:2,575000
8476162,Steve,Oleksy,1986-02-04,D,R,2016-17,11,0,1,1,0.09,2,11,0.0,24,9040.0,13:41,0,0,0,0.0,20,19,1,1,0,0,0,0,3.0,0:0,0,0,0,756.0,1:8,575000
8476166,Taylor,Fedun,1988-06-04,D,R,2016-17,27,0,7,7,0.26,3,24,0.0,16,21649.0,13:21,0,0,0,0.0,7,20,5,9,-4,0,3,3,1950.0,1:12,0,0,0,9.0,0:0,600000
8476177,Matt,Read,1986-06-14,RW,R,2016-17,63,10,9,19,0.3,3,92,10.87,8,52146.0,13:47,5,10,15,33.33,95,32,21,18,3,2,0,2,2474.0,0:39,1,0,1,3377.0,0:53,3625000
8476191,Kevan,Miller,1987-11-15,D,R,2016-17,58,3,10,13,0.22,1,49,6.12,50,61927.0,17:47,0,0,0,0.0,121,76,7,21,-14,0,0,0,194.0,0:3,0,1,1,7001.0,2:0,2500000
8476195,Cory,Conacher,1989-12-14,C,L,2016-17,11,1,3,4,0.36,0,16,6.25,4,7631.0,11:33,1,1,2,50.0,1,0,6,8,-2,1,0,1,1219.0,1:50,0,0,0,0.0,0:0,575000
8476200,Paul,Thompson,1988-11-30,RW,R,2016-17,21,0,3,3,0.14,-4,19,0.0,22,9954.0,7:54,0,1,1,0.0,48,16,4,2,2,0,0,0,11.0,0:0,0,0,0,10.0,0:0,575000
8476219,Patrick,Cannone,1986-08-09,C,R,2016-17,3,0,0,0,0.0,0,2,0.0,0,1419.0,7:53,11,10,21,52.38,2,1,1,2,-1,0,0,0,0.0,0:0,0,0,0,0.0,0:0,600000
8476279,Jyrki,Jokipakka,1991-08-20,D,L,2016-17,41,1,5,6,0.15,-4,29,3.45,12,35507.0,14:26,0,0,0,0.0,31,32,6,25,-19,0,0,0,231.0,0:5,0,0,0,440.0,0:10,900000
8476285,Matthew,Peca,1993-04-27,C,L,2016-17,10,1,1,2,0.2,-3,9,11.11,2,6867.0,11:26,32,40,72,44.44,9,2,0,2,-2,0,0,0,551.0,0:55,0,0,0,6.0,0:0,796250
8476288,Ryan,Dzingel,1992-03-09,LW,L,2016-17,81,14,18,32,0.4,7,123,11.38,30,69926.0,14:23,9,21,30,30.0,71,21,23,25,-2,1,2,3,6493.0,1:20,1,0,1,882.0,0:10,750000
8476289,Alexey,Marchenko,1992-01-02,D,R,2016-17,41,1,7,8,0.2,7,36,2.78,12,41700.0,16:57,0,0,0,0.0,22,59,5,22,-17,0,0,0,183.0,0:4,0,1,1,4340.0,1:45,1450000
8476292,Ondrej,Palat,1991-03-28,LW,L,2016-17,75,17,35,52,0.69,8,162,10.49,39,86028.0,19:7,9,25,34,26.47,141,66,60,46,14,5,10,15,12485.0,2:46,0,0,0,7691.0,1:42,3333333
8476293,Scott,Wilson,1992-04-24,C,L,2016-17,78,8,18,26,0.33,0,127,6.3,32,51220.0,10:56,3,0,3,100.0,167,31,20,11,9,0,0,0,1674.0,0:21,0,0,0,157.0,0:2,625000
8476300,Nikita,Nesterov,1993-03-28,D,L,2016-17,48,4,13,17,0.35,0,63,6.35,24,46901.0,16:17,0,0,0,0.0,84,21,6,24,-18,1,1,2,3307.0,1:8,0,0,0,127.0,0:2,725000
8476302,Frank,Corrado,1993-03-26,D,R,2016-17,4,0,0,0,0.0,-1,3,0.0,8,2585.0,10:46,0,0,0,0.0,4,2,0,2,-2,0,0,0,17.0,0:4,0,0,0,128.0,0:32,600000
8476303,Rob,O'Gara,1993-07-06,D,L,2016-17,3,0,0,0,0.0,1,2,0.0,0,2882.0,16:0,0,0,0,0.0,3,7,0,2,-2,0,0,0,0.0,0:0,0,0,0,395.0,2:11,925000
8476310,Lukas,Sedlak,1993-02-25,C,L,2016-17,62,7,6,13,0.21,10,57,12.28,25,36170.0,9:43,232,211,443,52.37,66,28,15,10,5,0,0,0,133.0,0:2,1,0,1,2136.0,0:34,600000
8476312,Josh,Manson,1991-10-07,D,R,2016-17,82,5,12,17,0.21,14,88,5.68,82,91639.0,18:37,0,0,0,0.0,227,79,23,57,-34,0,0,0,369.0,0:4,1,1,2,11527.0,2:20,825000
8476323,Max,McCormick,1992-05-01,LW,L,2016-17,7,0,0,0,0.0,-3,7,0.0,0,2839.0,6:45,15,9,24,62.5,13,1,2,0,2,0,0,0,5.0,0:0,0,0,0,0.0,0:0,650000
8476326,Josh,Archibald,1992-10-06,RW,R,2016-17,10,3,0,3,0.3,3,11,27.27,4,6519.0,10:51,0,1,1,0.0,28,2,0,2,-2,0,0,0,12.0,0:1,1,0,1,304.0,0:30,659167
8476331,Dylan,DeMelo,1993-05-01,D,R,2016-17,25,1,7,8,0.32,2,32,3.12,14,23839.0,15:53,0,0,0,0.0,36,32,4,12,-8,0,0,0,1985.0,1:19,0,0,0,505.0,0:20,650000
8476336,Iiro,Pakarinen,1991-08-25,RW,R,2016-17,14,2,2,4,0.29,2,15,13.33,2,7496.0,8:55,0,1,1,0.0,30,6,4,2,2,0,0,0,107.0,0:7,0,0,0,230.0,0:16,725000
8476344,Tyler,Graovac,1993-04-27,C,L,2016-17,52,7,2,9,0.17,7,48,14.58,10,30703.0,9:50,163,180,343,47.52,52,15,16,4,12,0,0,0,123.0,0:2,0,0,0,8.0,0:0,625000
8476346,Johnny,Gaudreau,1993-08-13,LW,L,2016-17,72,18,43,61,0.85,-7,182,9.89,4,79882.0,18:29,0,0,0,0.0,9,14,44,86,-42,4,12,16,13865.0,3:12,0,0,0,85.0,0:1,6750000
8476356,Tobias,Rieder,1993-01-10,C,L,2016-17,80,16,18,34,0.42,-8,155,10.32,6,83103.0,17:18,4,9,13,30.77,24,38,34,15,19,2,4,6,5733.0,1:11,1,1,2,11324.0,2:21,2225000
8476368,Fredrik,Claesson,1992-11-24,D,L,2016-17,33,3,8,11,0.33,5,25,12.0,4,26016.0,13:8,0,0,0,0.0,55,24,4,15,-11,0,0,0,464.0,0:14,0,1,1,843.0,0:25,700000
8476370,Blake,Pietila,1993-02-20,LW,L,2016-17,10,0,1,1,0.1,-5,9,0.0,4,7822.0,13:2,23,22,45,51.11,16,5,4,1,3,0,0,0,16.0,0:1,0,0,0,741.0,1:14,662500
8476374,Sean,Kuraly,1993-01-20,C,L,2016-17,8,0,1,1,0.12,-1,11,0.0,2,4416.0,9:12,1,2,3,33.33,9,1,2,0,2,0,0,0,10.0,0:1,0,0,0,59.0,0:7,808750
8476381,Andrew,Shaw,1991-07-20,RW,R,2016-17,68,12,17,29,0.43,4,127,9.45,110,62023.0,15:12,239,199,438,54.57,147,38,28,29,-1,1,6,7,8547.0,2:5,0,0,0,496.0,0:7,3900000
8476386,Shane,Prince,1992-11-16,LW,L,2016-17,50,5,13,18,0.36,-9,71,7.04,18,38912.0,12:58,4,3,7,57.14,36,12,23,19,4,1,2,3,3652.0,1:13,0,0,0,93.0,0:1,850000
8476389,Vincent,Trocheck,1993-07-11,C,R,2016-17,82,23,31,54,0.66,-13,230,10.0,43,102473.0,20:49,835,829,1664,50.18,164,51,63,69,-6,2,10,12,13447.0,2:43,0,1,1,9440.0,1:55,4750000
8476390,Joseph,Cramarossa,1992-10-26,C,L,2016-17,59,4,6,10,0.17,0,36,11.11,60,35208.0,9:56,6,1,7,85.71,133,23,8,15,-7,0,0,0,252.0,0:4,0,2,2,2368.0,0:40,724500
8476391,TJ,Tynan,1992-02-25,C,R,2016-17,3,0,0,0,0.0,-1,3,0.0,0,1347.0,7:29,0,0,0,0.0,1,1,0,0,0,0,0,0,0.0,0:0,0,0,0,0.0,0:0,600000
8476392,Adam,Lowry,1993-03-29,C,L,2016-17,82,15,14,29,0.35,1,122,12.3,52,78962.0,16:2,658,637,1295,50.81,217,56,29,24,5,5,4,9,8519.0,1:43,0,1,1,11024.0,2:14,1125000
8476393,Nick,Cousins,1993-07-20,C,L,2016-17,60,6,10,16,0.27,-6,99,6.06,31,43204.0,12:0,89,128,217,41.01,61,24,15,14,1,1,1,2,4244.0,1:10,0,0,0,89.0,0:1,840000
8476399,Blake,Coleman,1991-11-28,C,L,2016-17,23,1,1,2,0.09,-7,29,3.45,27,17728.0,12:50,96,130,226,42.48,51,15,12,12,0,0,0,0,87.0,0:3,0,0,0,1443.0,1:2,680000
8476400,Logan,Shaw,1992-10-05,RW,R,2016-17,55,3,7,10,0.18,3,59,5.08,10,32040.0,9:42,55,90,145,37.93,62,18,10,7,3,0,0,0,147.0,0:2,1,1,2,4835.0,1:27,660000
8476403,Klas,Dahlbeck,1991-07-06,D,L,2016-17,43,2,4,6,0.14,-12,37,5.41,30,35832.0,13:53,0,0,0,0.0,77,38,11,15,-4,0,0,0,51.0,0:1,0,0,0,1034.0,0:24,750000
8476404,Andy,Andreoff,1991-05-17,LW,L,2016-17,36,0,2,2,0.06,-2,38,0.0,70,22888.0,10:35,41,28,69,59.42,70,7,5,10,-5,0,0,0,166.0,0:4,0,0,0,364.0,0:10,587500
8476406,Nick,Shore,1992-09-26,C,R,2016-17,70,6,11,17,0.24,-2,79,7.59,20,53712.0,12:47,362,359,721,50.21,58,22,11,19,-8,0,0,0,1261.0,0:18,1,0,1,5457.0,1:17,600000
8476409,Alan,Quine,1993-02-25,C,L,2016-17,61,5,13,18,0.3,-2,82,6.1,8,45826.0,12:31,264,286,550,48.0,77,29,17,18,-1,2,1,3,4053.0,1:6,0,0,0,1326.0,0:21,612500
8476410,Josh,Leivo,1993-05-26,LW,R,2016-17,13,2,8,10,0.77,2,27,7.41,4,9808.0,12:34,1,1,2,50.0,5,4,11,2,9,1,2,3,1496.0,1:55,0,0,0,0.0,0:0,612500
8476414,Alexandre,Grenier,1991-09-05,RW,R,2016-17,3,0,0,0,0.0,-1,1,0.0,0,1167.0,6:29,2,0,2,100.0,3,0,0,0,0,0,0,0,0.0,0:0,0,0,0,0.0,0:0,600000
8476415,Kyle,Rau,1992-10-24,C,L,2016-17,24,2,1,3,0.12,-3,21,9.52,4,13824.0,9:36,2,1,3,66.67,24,3,7,2,5,0,0,0,305.0,0:12,0,0,0,0.0,0:0,858750
8476416,Dillon,Simpson,1993-02-10,D,L,2016-17,3,0,0,0,0.0,0,2,0.0,2,1959.0,10:53,0,0,0,0.0,3,2,0,1,-1,0,0,0,0.0,0:0,0,0,0,0.0,0:0,836667
8476418,Robbie,Russo,1993-02-15,D,R,2016-17,19,0,0,0,0.0,2,18,0.0,2,18319.0,16:4,0,0,0,0.0,24,13,0,13,-13,0,0,0,151.0,0:7,0,0,0,1290.0,1:7,680000
8476419,Jean-Gabriel,Pageau,1992-11-11,C,R,2016-17,82,12,21,33,0.4,13,169,7.1,24,79363.0,16:7,558,460,1018,54.81,161,79,25,27,-2,0,0,0,1718.0,0:20,0,2,2,10712.0,2:10,900000
8476422,Mike,Reilly,1993-07-13,D,L,2016-17,17,1,0,1,0.06,1,19,5.26,2,12629.0,12:22,0,0,0,0.0,2,8,0,6,-6,0,0,0,1228.0,1:12,0,0,0,23.0,0:1,925000
8476423,Reid,Boucher,1993-09-08,C,L,2016-17,39,6,4,10,0.26,-6,70,8.57,8,27909.0,11:55,0,1,1,0.0,20,14,18,8,10,1,0,1,3589.0,1:32,0,0,0,111.0,0:2,715000
8476425,Joseph,LaBate,1993-04-16,C,L,2016-17,13,0,0,0,0.0,-2,5,0.0,21,5276.0,6:45,1,0,1,100.0,23,2,3,1,2,0,0,0,12.0,0:0,0,0,0,0.0,0:0,680000
8476427,Ty,Rattie,1993-02-05,RW,R,2016-17,9,0,2,2,0.22,-2,10,0.0,0,5799.0,10:44,0,0,0,0.0,10,4,4,0,4,0,0,0,55.0,0:6,0,0,0,4.0,0:0,650000
8476428,Rocco,Grimaldi,1993-02-08,C,R,2016-17,4,0,1,1,0.25,-3,11,0.0,2,2640.0,11:0,0,0,0,0.0,1,4,3,0,3,0,0,0,0.0,0:0,0,0,0,0.0,0:0,925000
8476429,Scott,Mayfield,1992-10-14,D,R,2016-17,25,2,7,9,0.36,-1,39,5.13,35,21210.0,14:8,0,0,0,0.0,37,36,8,11,-3,0,0,0,19.0,0:0,0,0,0,31.0,0:1,625000
8476430,Tomas,Jurco,1992-12-28,LW,L,2016-17,29,1,0,1,0.03,-12,35,2.86,4,18504.0,10:38,0,1,1,0.0,21,9,3,7,-4,0,0,0,542.0,0:18,0,0,0,113.0,0:3,900000
8476431,Adam,Clendening,1992-10-26,D,R,2016-17,31,2,9,11,0.35,3,38,5.26,17,29406.0,15:48,0,0,0,0.0,22,27,7,20,-13,1,1,2,2743.0,1:28,0,0,0,107.0,0:3,600000
8476432,Boone,Jenner,1993-06-15,C,L,2016-17,82,18,16,34,0.41,14,211,8.53,52,79022.0,16:3,92,92,184,50.0,216,80,42,20,22,0,1,1,5580.0,1:8,2,0,2,4195.0,0:51,2900000
8476436,Dmitrij,Jaskin,1993-03-23,RW,L,2016-17,51,1,10,11,0.22,5,55,1.82,18,35352.0,11:33,5,5,10,50.0,98,19,13,7,6,0,0,0,1184.0,0:23,0,0,0,20.0,0:0,1000000
8476437,Victor,Rask,1993-03-01,C,L,2016-17,82,16,29,45,0.55,-10,186,8.6,16,85088.0,17:17,457,461,918,49.78,43,33,41,46,-5,4,6,10,10463.0,2:7,0,1,1,1854.0,0:22,4000000
8476438,Brandon,Saad,1992-10-27,LW,L,2016-17,82,24,29,53,0.65,23,210,11.43,8,83786.0,17:1,4,5,9,44.44,24,26,43,29,14,1,2,3,7743.0,1:34,0,0,0,2442.0,0:29,6000000
8476439,Brett,Ritchie,1993-07-01,RW,R,2016-17,78,16,8,24,0.31,11,167,9.58,38,60355.0,12:53,1,1,2,50.0,153,23,15,26,-11,1,1,2,7384.0,1:34,0,0,0,32.0,0:0,875000
8476440,Markus,Granlund,1993-04-16,C,L,2016-17,69,19,13,32,0.46,-19,122,15.57,14,71657.0,17:18,40,61,101,39.6,32,11,33,18,15,3,4,7,8015.0,1:56,0,0,0,5021.0,1:12,900000
8476441,Joel,Edmundson,1993-06-28,D,L,2016-17,69,3,12,15,0.22,11,81,3.7,60,73562.0,17:46,0,0,0,0.0,122,95,7,26,-19,0,0,0,148.0,0:2,0,0,0,7806.0,1:53,1050000
8476442,Matt,Nieto,1992-11-05,LW,L,2016-17,59,7,6,13,0.22,-12,85,8.24,8,52834.0,14:55,2,4,6,33.33,41,34,28,18,10,0,0,0,1975.0,0:33,0,1,1,5904.0,1:40,735000
8476443,Xavier,Ouellet,1993-07-29,D,L,2016-17,66,3,9,12,0.18,2,89,3.37,51,71173.0,17:58,0,2,2,0.0,73,87,9,21,-12,0,0,0,367.0,0:5,0,0,0,7597.0,1:55,715000
8476447,Miikka,Salomaki,1993-03-09,RW,L,2016-17,5,0,0,0,0.0,-1,3,0.0,2,3664.0,12:12,0,0,0,0.0,14,9,1,0,1,0,0,0,11.0,0:2,0,0,0,337.0,1:7,612500
8476448,William,Karlsson,1993-01-08,C,L,2016-17,81,6,19,25,0.31,10,96,6.25,10,65063.0,13:23,435,525,960,45.31,35,24,33,20,13,1,0,1,991.0,0:12,0,2,2,7914.0,1:37,1000000
8476449,Scott,Harrington,1993-03-10,D,L,2016-17,22,1,2,3,0.14,3,16,6.25,10,17169.0,13:0,0,0,0,0.0,21,24,4,5,-1,0,0,0,0.0,0:0,0,0,0,403.0,0:18,632500
8476450,Ryan,Sproul,1993-01-13,D,R,2016-17,27,1,6,7,0.26,-8,46,2.17,6,24539.0,15:8,0,0,0,0.0,12,14,5,7,-2,1,2,3,3450.0,2:7,0,0,0,100.0,0:3,625000
8476452,Tyler,Wotherspoon,1993-03-12,D,L,2016-17,4,0,0,0,0.0,-2,4,0.0,0,2616.0,10:54,0,0,0,0.0,3,2,1,4,-3,0,0,0,0.0,0:0,0,0,0,0.0,0:0,625000
8476453,Nikita,Kucherov,1993-06-17,RW,L,2016-17,74,40,45,85,1.15,13,246,16.26,38,86320.0,19:26,0,0,0,0.0,30,20,54,64,-10,17,15,32,14911.0,3:21,0,0,0,110.0,0:1,4766667
8476454,Ryan,Nugent-Hopkins,1993-04-12,C,L,2016-17,82,18,25,43,0.52,-10,200,9.0,29,87045.0,17:41,556,712,1268,43.85,47,35,48,30,18,5,6,11,9303.0,1:53,0,0,0,8505.0,1:43,6000000
8476455,Gabriel,Landeskog,1992-11-23,LW,L,2016-17,72,18,15,33,0.46,-25,169,10.65,62,81136.0,18:46,62,63,125,49.6,143,41,65,36,29,5,1,6,10179.0,2:21,1,0,1,7737.0,1:47,5571429
8476456,Jonathan,Huberdeau,1993-06-04,LW,L,2016-17,31,10,16,26,0.84,-2,86,11.63,13,33330.0,17:55,4,5,9,44.44,18,7,15,24,-9,3,4,7,4725.0,2:32,0,0,0,173.0,0:5,3250000
8476457,Adam,Larsson,1992-11-12,D,R,2016-17,79,4,15,19,0.24,21,85,4.71,55,95509.0,20:8,0,0,0,0.0,253,160,28,71,-43,0,0,0,879.0,0:11,0,0,0,7563.0,1:35,4166666
8476458,Ryan,Strome,1993-07-11,C,R,2016-17,69,13,17,30,0.43,-8,114,11.4,40,60476.0,14:36,147,197,344,42.73,59,21,33,32,1,2,6,8,10983.0,2:39,0,0,0,149.0,0:2,2500000
8476459,Mika,Zibanejad,1993-04-18,C,R,2016-17,56,14,23,37,0.66,9,119,11.76,16,57362.0,17:4,494,456,950,52.0,23,27,36,31,5,4,7,11,8035.0,2:23,0,0,0,2386.0,0:42,2625000
8476460,Mark,Scheifele,1993-03-15,C,R,2016-17,79,32,50,82,1.04,18,160,20.0,38,97447.0,20:33,635,826,1461,43.46,49,34,67,42,25,7,8,15,14672.0,3:5,0,2,2,3337.0,0:42,6125000
8476461,Sean,Couturier,1992-12-07,C,L,2016-17,66,14,20,34,0.52,12,120,11.67,33,73045.0,18:26,587,479,1066,55.07,41,35,46,33,13,0,2,2,7207.0,1:49,0,1,1,7279.0,1:50,4333333
8476462,Dougie,Hamilton,1993-06-17,D,R,2016-17,81,13,37,50,0.62,12,222,5.86,64,95665.0,19:41,0,0,0,0.0,68,94,17,52,-35,2,12,14,11011.0,2:15,0,1,1,4298.0,0:53,5750000
8476463,Jonas,Brodin,1993-07-12,D,L,2016-17,68,3,22,25,0.37,5,85,3.53,20,79838.0,19:34,0,0,0,0.0,20,89,16,29,-13,2,5,7,6241.0,1:31,0,0,0,7530.0,1:50,4166667
8476464,Duncan,Siemens,1993-09-07,D,L,2016-17,3,0,0,0,0.0,-2,2,0.0,2,2216.0,12:18,0,0,0,0.0,10,1,0,2,-2,0,0,0,0.0,0:0,0,0,0,193.0,1:4,874125
8476465,Ryan,Murphy,1993-03-31,D,R,2016-17,27,0,2,2,0.07,-11,17,0.0,8,21339.0,13:10,0,0,0,0.0,2,31,11,8,3,0,0,0,639.0,0:23,0,0,0,2.0,0:0,787500
8476466,Sven,Baertschi,1992-10-05,LW,L,2016-17,68,18,17,35,0.51,-6,114,15.79,8,64773.0,15:52,1,0,1,100.0,52,29,39,23,16,2,4,6,7751.0,1:53,0,0,0,1114.0,0:16,1850000
8476467,Jamie,Oleksiak,1992-12-21,D,L,2016-17,41,5,2,7,0.17,-4,33,15.15,37,39878.0,16:12,0,0,0,0.0,51,53,13,27,-14,0,0,0,302.0,0:7,0,1,1,3022.0,1:13,918750
8476468,J.T.,Miller,1993-03-14,C,L,2016-17,82,22,34,56,0.68,17,132,16.67,21,80523.0,16:21,157,200,357,43.98,101,56,49,51,-2,2,5,7,7142.0,1:27,3,1,4,6189.0,1:15,2750000
8476469,Joel,Armia,1993-05-31,RW,R,2016-17,57,10,9,19,0.33,-8,111,9.01,20,51769.0,15:8,3,4,7,42.86,68,30,42,19,23,0,2,2,3006.0,0:52,4,0,4,6297.0,1:50,925000
8476470,Nathan,Beaulieu,1992-12-05,D,L,2016-17,74,4,24,28,0.38,8,118,3.39,44,86490.0,19:28,0,0,0,0.0,65,102,16,71,-55,2,10,12,7349.0,1:39,0,0,0,4317.0,0:58,1000000
8476471,Mark,McNeill,1993-02-22,C,R,2016-17,1,0,0,0,0.0,-1,1,0.0,0,829.0,13:49,0,2,2,0.0,0,1,0,1,-1,0,0,0,0.0,0:0,0,0,0,0.0,0:0,600000
8476472,Oscar,Klefbom,1993-07-20,D,L,2016-17,82,12,26,38,0.46,7,201,5.97,6,110061.0,22:22,0,0,0,0.0,43,146,29,67,-38,3,13,16,12422.0,2:31,0,1,1,8250.0,1:40,4167000
8476473,Connor,Murphy,1993-03-26,D,R,2016-17,77,2,15,17,0.22,-13,81,2.47,45,88604.0,19:10,0,0,0,0.0,201,119,13,31,-18,0,0,0,1238.0,0:16,1,0,1,8526.0,1:50,3850000
8476474,Stefan,Noesen,1993-02-12,RW,R,2016-17,44,8,2,10,0.23,6,63,12.7,24,29371.0,11:7,26,41,67,38.81,50,10,11,11,0,0,0,0,418.0,0:9,0,0,0,1000.0,0:22,600000
8476476,Joe,Morrow,1992-12-09,D,L,2016-17,17,0,1,1,0.06,-4,19,0.0,8,15836.0,15:31,0,0,0,0.0,29,19,1,7,-6,0,0,0,42.0,0:2,0,0,0,827.0,0:48,800000
8476477,Matt,Puempel,1993-01-24,LW,L,2016-17,40,6,3,9,0.22,-11,44,13.64,11,23145.0,9:38,0,1,1,0.0,28,12,8,6,2,3,0,3,1640.0,0:41,0,0,0,0.0,0:0,900000
8476479,Phillip,Danault,1993-02-24,C,L,2016-17,82,13,27,40,0.49,5,133,9.77,35,76662.0,15:34,533,498,1031,51.7,76,52,49,36,13,0,2,2,3056.0,0:37,0,1,1,5491.0,1:6,912500
8476480,Vladislav,Namestnikov,1992-11-22,C,L,2016-17,74,10,18,28,0.38,-4,114,8.77,31,65645.0,14:47,209,271,480,43.54,72,31,14,26,-12,3,3,6,9284.0,2:5,0,1,1,1322.0,0:17,1937500
8476482,Nicklas,Jensen,1993-03-06,RW,L,2016-17,7,0,0,0,0.0,-2,8,0.0,0,3874.0,9:13,0,0,0,0.0,7,2,2,1,1,0,0,0,425.0,1:0,0,0,0,0.0,0:0,600000
8476483,Rickard,Rakell,1993-05-05,C,R,2016-17,71,33,18,51,0.72,10,177,18.64,12,74065.0,17:23,62,85,147,42.18,81,32,23,37,-14,5,7,12,9652.0,2:15,0,0,0,37.0,0:0,3853672
8476495,Seth,Griffith,1993-01-04,C,R,2016-17,24,0,5,5,0.21,6,21,0.0,8,18337.0,12:44,2,6,8,25.0,30,5,5,6,-1,0,1,1,1927.0,1:20,0,0,0,1.0,0:0,625000
8476511,Samuel,Henley,1993-07-25,C,L,2016-17,1,1,0,1,1.0,1,1,100.0,2,318.0,5:18,0,1,1,0.0,2,0,0,0,0,0,0,0,0.0,0:0,0,0,0,12.0,0:12,586666
8476525,Colin,Miller,1992-10-29,D,R,2016-17,61,6,7,13,0.21,0,85,7.06,55,57886.0,15:48,0,0,0,0.0,85,36,19,30,-11,1,1,2,5974.0,1:37,0,0,0,961.0,0:15,1000000
8476526,Ben,Thomson,1993-01-16,LW,L,2016-17,3,0,0,0,0.0,-4,7,0.0,4,1960.0,10:53,0,1,1,0.0,7,1,0,1,-1,0,0,0,2.0,0:0,0,0,0,0.0,0:0,626667
8476539,Jonathan,Marchessault,1990-12-27,C,R,2016-17,75,30,21,51,0.68,-21,193,15.54,38,76099.0,16:54,122,148,270,45.19,105,17,64,46,18,8,10,18,12143.0,2:41,0,0,0,213.0,0:2,750000
8476545,Kurtis,Gabriel,1993-04-20,RW,R,2016-17,13,0,1,1,0.08,0,3,0.0,29,4539.0,5:49,0,0,0,0.0,26,1,0,3,-3,0,0,0,0.0,0:0,0,0,0,0.0,0:0,666667
8476619,Zack,Mitchell,1993-01-07,RW,R,2016-17,11,0,0,0,0.0,-1,10,0.0,0,5561.0,8:25,11,8,19,57.89,14,3,2,1,1,0,0,0,37.0,0:3,0,0,0,0.0,0:0,615000
8476624,Barclay,Goodrow,1993-02-26,RW,L,2016-17,3,0,1,1,0.33,0,3,0.0,0,2035.0,11:18,0,0,0,0.0,3,1,1,1,0,0,0,0,5.0,0:1,0,0,0,73.0,0:24,626667
8476766,Cole,Schneider,1990-08-26,LW,L,2016-17,4,0,1,1,0.25,2,6,0.0,0,1714.0,7:8,0,0,0,0.0,3,2,0,0,0,0,0,0,0.0,0:0,0,0,0,0.0,0:0,600000
8476769,Bobby,Farnham,1989-01-21,RW,L,2016-17,3,0,0,0,0.0,0,4,0.0,17,1489.0,8:16,1,0,1,100.0,8,2,0,0,0,0,0,0,0.0,0:0,0,0,0,0.0,0:0,575000
8476779,Brad,Hunt,1988-08-24,D,L,2016-17,12,1,5,6,0.5,-1,14,7.14,2,10441.0,14:30,0,0,0,0.0,0,3,4,3,1,1,1,2,442.0,0:36,0,0,0,178.0,0:14,600000
8476792,Torey,Krug,1991-04-12,D,L,2016-17,81,8,43,51,0.63,-10,208,3.85,37,104979.0,21:36,0,1,1,0.0,59,82,22,60,-38,6,19,25,15877.0,3:16,0,0,0,1842.0,0:22,5250000
8476798,Karl,Stollery,1987-11-21,D,L,2016-17,11,0,3,3,0.27,-5,11,0.0,13,11166.0,16:55,0,0,0,0.0,26,16,3,6,-3,0,3,3,1653.0,2:30,0,0,0,50.0,0:4,575000
8476805,Spencer,Abbott,1988-04-30,LW,R,2016-17,1,0,0,0,0.0,0,1,0.0,0,514.0,8:34,0,0,0,0.0,0,0,1,0,1,0,0,0,0.0,0:0,0,0,0,0.0,0:0,575000
8476806,J.T.,Brown,1990-07-02,RW,R,2016-17,64,3,3,6,0.09,-7,67,4.48,73,39824.0,10:22,12,26,38,31.58,103,25,8,11,-3,0,0,0,396.0,0:6,1,0,1,3992.0,1:2,1250000
8476807,Matt,Tennyson,1990-04-23,D,R,2016-17,45,0,6,6,0.13,-13,36,0.0,6,35874.0,13:17,0,0,0,0.0,65,48,11,11,0,0,0,0,121.0,0:2,0,0,0,829.0,0:18,675000
8476808,Brian,Flynn,1988-07-26,C,R,2016-17,51,6,4,10,0.2,2,47,12.77,4,36921.0,12:3,69,80,149,46.31,20,29,13,15,-2,0,0,0,145.0,0:2,0,0,0,4596.0,1:30,950000
8476822,Luke,Glendening,1989-04-28,RW,R,2016-17,74,3,11,14,0.19,-10,76,3.95,26,57343.0,12:54,307,261,568,54.05,150,62,19,12,7,0,1,1,391.0,0:5,0,0,0,10077.0,2:16,628333
8476826,Yanni,Gourde,1991-12-15,C,L,2016-17,20,6,2,8,0.4,-1,30,20.0,8,18441.0,15:22,60,103,163,36.81,11,3,12,4,8,0,0,0,1005.0,0:50,1,0,1,1671.0,1:23,575000
8476850,Ryan,Murray,1993-09-27,D,L,2016-17,60,2,9,11,0.18,3,52,3.85,24,65999.0,18:19,0,0,0,0.0,23,96,8,18,-10,0,1,1,1602.0,0:26,0,1,1,6747.0,1:52,2825000
8476851,Alex,Galchenyuk,1994-02-12,LW,L,2016-17,61,17,27,44,0.72,-5,104,16.35,24,58303.0,15:55,274,368,642,42.68,36,32,17,34,-17,6,9,15,8337.0,2:16,0,0,0,132.0,0:2,2800000
8476853,Morgan,Rielly,1994-03-09,D,L,2016-17,76,6,21,27,0.36,-20,171,3.51,21,101089.0,22:10,0,0,0,0.0,46,120,34,76,-42,1,4,5,4418.0,0:58,0,0,0,10811.0,2:22,5000000
8476854,Hampus,Lindholm,1994-01-20,D,L,2016-17,66,6,14,20,0.3,13,94,6.38,36,88900.0,22:26,2,0,2,100.0,98,94,18,63,-45,1,4,5,7405.0,1:52,0,0,0,9616.0,2:25,5713415
8476855,Nail,Yakupov,1993-10-06,RW,L,2016-17,40,3,6,9,0.22,-3,35,8.57,14,25553.0,10:38,0,0,0,0.0,32,8,11,3,8,0,0,0,675.0,0:16,0,0,0,10.0,0:0,2500000
8476856,Matt,Dumba,1994-07-25,D,R,2016-17,76,11,23,34,0.45,15,131,8.4,59,92686.0,20:19,0,0,0,0.0,96,71,18,43,-25,6,6,12,10377.0,2:16,0,1,1,2785.0,0:36,2550000
8476857,Pontus,Aberg,1993-09-23,LW,R,2016-17,15,1,1,2,0.13,-2,12,8.33,4,11102.0,12:20,1,0,1,100.0,9,2,5,2,3,0,0,0,233.0,0:15,0,0,0,6.0,0:0,780833
8476858,Phillip,Di Giuseppe,1993-10-09,LW,L,2016-17,36,1,6,7,0.19,-12,68,1.47,15,26559.0,12:17,0,2,2,0.0,91,10,12,13,-1,0,1,1,1044.0,0:29,0,0,0,53.0,0:1,817500
8476867,Brendan,Gaunce,1994-03-25,C,L,2016-17,57,0,5,5,0.09,-2,51,0.0,33,32460.0,9:29,84,80,164,51.22,94,12,11,6,5,0,0,0,228.0,0:4,0,0,0,1640.0,0:28,863333
8476869,Brady,Skjei,1994-03-26,D,L,2016-17,80,5,34,39,0.49,11,127,3.94,42,83821.0,17:27,0,1,1,0.0,147,69,17,51,-34,0,7,7,6652.0,1:23,0,0,0,1411.0,0:17,925000
8476871,Tanner,Pearson,1992-08-10,LW,L,2016-17,80,24,20,44,0.55,5,187,12.83,13,78336.0,16:19,10,14,24,41.67,124,31,25,20,5,3,5,8,11557.0,2:24,1,1,2,5229.0,1:5,1400000
8476872,Scott,Laughton,1994-05-30,C,L,2016-17,2,0,0,0,0.0,0,4,0.0,0,1229.0,10:14,11,9,20,55.0,3,0,1,0,1,0,0,0,0.0,0:0,0,0,0,0.0,0:0,863333
8476874,Olli,Maatta,1994-08-22,D,L,2016-17,55,1,6,7,0.13,17,66,1.52,12,59611.0,18:3,0,0,0,0.0,72,102,11,30,-19,0,0,0,421.0,0:7,0,0,0,7634.0,2:18,4083333
8476875,Mike,Matheson,1994-02-27,D,L,2016-17,81,7,10,17,0.21,-5,179,3.91,36,102317.0,21:3,1,0,1,100.0,69,118,48,65,-17,0,1,1,2465.0,0:30,0,1,1,12621.0,2:35,925000
8476877,Jordan,Schmaltz,1993-10-08,D,R,2016-17,9,0,2,2,0.22,0,5,0.0,4,7744.0,14:20,0,0,0,0.0,4,10,1,2,-1,0,1,1,648.0,1:12,0,0,0,60.0,0:6,925000
8476878,Zemgus,Girgensons,1994-01-05,C,L,2016-17,75,7,9,16,0.21,-7,112,6.25,18,59218.0,13:9,273,306,579,47.15,120,26,17,16,1,0,0,0,315.0,0:4,0,0,0,5188.0,1:9,1150000
8476879,Cody,Ceci,1993-12-21,D,R,2016-17,79,2,15,17,0.22,-11,143,1.4,20,109992.0,23:12,1,0,1,100.0,111,159,22,74,-52,0,1,1,4463.0,0:56,0,2,2,14312.0,3:1,2800000
8476880,Tom,Wilson,1994-03-29,RW,R,2016-17,82,7,12,19,0.23,9,95,7.37,133,63592.0,12:55,3,7,10,30.0,239,44,36,21,15,0,0,0,230.0,0:2,0,0,0,10173.0,2:4,2000000
8476881,Tomas,Hertl,1993-11-12,C,L,2016-17,49,10,12,22,0.45,-8,100,10.0,14,50638.0,17:13,245,229,474,51.69,76,42,30,18,12,1,1,2,5475.0,1:51,0,0,0,3574.0,1:12,3000000
8476882,Teuvo,Teravainen,1994-09-11,LW,L,2016-17,81,15,27,42,0.52,-6,169,8.88,16,78927.0,16:14,193,220,413,46.73,27,33,51,67,-16,5,10,15,10866.0,2:14,0,0,0,77.0,0:0,894167
8476884,Derrick,Pouliot,1994-01-16,D,L,2016-17,11,0,0,0,0.0,-4,11,0.0,4,9824.0,14:53,0,0,0,0.0,14,8,3,6,-3,0,0,0,647.0,0:58,0,0,0,731.0,1:6,863333
8476885,Jacob,Trouba,1994-02-26,D,R,2016-17,60,8,25,33,0.55,4,154,5.19,54,89868.0,24:57,0,0,0,0.0,107,118,36,62,-26,2,2,4,6024.0,1:40,0,1,1,10784.0,2:59,3308824
8476886,Slater,Koekkoek,1994-02-18,D,L,2016-17,29,0,4,4,0.14,-4,27,0.0,8,22592.0,12:59,0,0,0,0.0,25,27,1,7,-6,0,0,0,180.0,0:6,0,0,0,658.0,0:22,894167
8476887,Filip,Forsberg,1994-08-13,LW,R,2016-17,82,31,27,58,0.71,-4,234,13.25,32,91109.0,18:31,5,13,18,27.78,97,26,76,62,14,3,6,9,12882.0,2:37,3,0,3,7143.0,1:27,6000000
8476888,Mikhail,Grigorenko,1994-05-16,C,L,2016-17,75,10,13,23,0.31,-14,85,11.76,18,63401.0,14:5,111,81,192,57.81,27,26,35,26,9,0,4,4,7973.0,1:46,0,0,0,4942.0,1:5,1300000
8476889,Radek,Faksa,1994-01-09,C,L,2016-17,80,12,21,33,0.41,-6,132,9.09,67,77628.0,16:10,590,632,1222,48.28,101,62,43,36,7,0,2,2,2592.0,0:32,0,0,0,9414.0,1:57,863333
8476891,Matt,Grzelcyk,1994-01-05,D,L,2016-17,2,0,0,0,0.0,0,4,0.0,2,1498.0,12:29,0,0,0,0.0,0,1,0,0,0,0,0,0,200.0,1:40,0,0,0,0.0,0:0,858750
8476892,Colton,Parayko,1993-05-12,D,R,2016-17,81,4,31,35,0.43,7,188,2.13,32,103018.0,21:11,0,0,0,0.0,80,117,38,39,-1,4,6,10,8508.0,1:45,0,1,1,10262.0,2:6,858750
8476897,Oskar,Sundqvist,1994-03-23,C,R,2016-17,10,0,0,0,0.0,-4,9,0.0,2,5504.0,9:10,16,28,44,36.36,13,2,1,2,-1,0,0,0,5.0,0:0,0,0,0,297.0,0:29,700833
8476902,Esa,Lindell,1994-05-23,D,L,2016-17,73,6,12,18,0.25,8,99,6.06,22,95795.0,21:52,0,1,1,0.0,93,119,34,47,-13,0,2,2,4563.0,1:2,0,0,0,8879.0,2:1,745833
8476905,Chandler,Stephenson,1994-04-22,C,L,2016-17,4,0,0,0,0.0,0,3,0.0,0,2131.0,8:52,12,13,25,48.0,0,0,1,0,1,0,0,0,6.0,0:1,0,0,0,57.0,0:14,725833
8476906,Shayne,Gostisbehere,1993-04-20,D,L,2016-17,76,7,32,39,0.51,-21,198,3.54,32,89350.0,19:35,0,0,0,0.0,43,94,18,70,-52,2,21,23,17458.0,3:49,0,0,0,328.0,0:4,925000
8476911,Tanner,Richard,1993-04-06,C,L,2016-17,3,0,0,0,0.0,-2,1,0.0,2,2287.0,12:42,13,17,30,43.33,6,2,2,1,1,0,0,0,303.0,1:41,0,0,0,0.0,0:0,575000
8476913,Devin,Shore,1994-07-19,C,L,2016-17,82,13,20,33,0.4,-4,115,11.3,14,69547.0,14:8,221,249,470,47.02,44,71,26,25,1,1,5,6,9061.0,1:50,0,0,0,741.0,0:9,870000
8476915,Jujhar,Khaira,1994-08-13,LW,L,2016-17,10,1,0,1,0.1,1,10,10.0,2,5554.0,9:15,7,12,19,36.84,20,5,1,2,-1,0,0,0,59.0,0:5,0,0,0,14.0,0:1,875000
8476917,Adam,Pelech,1994-08-16,D,L,2016-17,44,3,7,10,0.23,-5,40,7.5,6,44442.0,16:50,0,0,0,0.0,73,68,17,28,-11,0,0,0,89.0,0:2,0,0,0,2580.0,0:58,854333
8476918,Jimmy,Vesey,1993-05-26,LW,L,2016-17,80,16,11,27,0.34,-13,116,13.79,26,65442.0,13:38,2,5,7,28.57,64,37,44,34,10,5,3,8,7428.0,1:32,0,0,0,48.0,0:0,925000
8476919,Chris,Tierney,1994-07-01,C,L,2016-17,80,11,12,23,0.29,0,90,12.22,6,70098.0,14:36,401,425,826,48.55,50,44,41,59,-18,1,0,1,1313.0,0:16,1,1,2,8592.0,1:47,711667
8476921,Jordan,Martinook,1992-07-25,LW,L,2016-17,77,11,14,25,0.32,-8,109,10.09,40,72438.0,15:40,460,577,1037,44.36,50,68,40,21,19,1,1,2,1748.0,0:22,1,2,3,10319.0,2:14,612500
8476923,Damon,Severson,1994-08-07,D,R,2016-17,80,3,28,31,0.39,-31,125,2.4,58,97691.0,20:21,0,0,0,0.0,79,73,24,54,-30,0,13,13,10887.0,2:16,0,0,0,1514.0,0:18,605833
8476924,Martin,Frk,1993-10-05,RW,R,2016-17,2,0,0,0,0.0,-3,1,0.0,0,1000.0,8:20,0,0,0,0.0,3,1,0,1,-1,0,0,0,0.0,0:0,0,0,0,0.0,0:0,639167
8476925,Colton,Sissons,1993-11-05,C,R,2016-17,58,8,2,10,0.17,11,42,19.05,12,38708.0,11:7,192,192,384,50.0,104,24,12,11,1,0,0,0,242.0,0:4,1,0,1,3189.0,0:54,625000
8476931,Jake,McCabe,1993-10-12,D,L,2016-17,76,3,17,20,0.26,-7,79,3.8,26,94415.0,20:42,0,0,0,0.0,73,114,29,46,-17,1,3,4,4794.0,1:3,0,0,0,7470.0,1:38,1600000
8476934,Brock,McGinn,1994-02-02,LW,L,2016-17,57,7,9,16,0.28,-11,74,9.46,6,41031.0,11:59,1,3,4,25.0,91,22,29,14,15,0,0,0,232.0,0:4,0,1,1,2691.0,0:47,811667
8476941,Connor,Carrick,1994-04-13,D,R,2016-17,67,2,6,8,0.12,8,89,2.25,51,65671.0,16:20,0,0,0,0.0,66,79,14,46,-32,1,0,1,2240.0,0:33,0,0,0,1120.0,0:16,750000
8476948,Charles,Hudon,1994-06-23,LW,L,2016-17,3,0,2,2,0.67,1,3,0.0,2,2147.0,11:55,0,0,0,0.0,11,0,3,2,1,0,0,0,73.0,0:24,0,0,0,0.0,0:0,625000
8476955,Taylor,Leier,1994-02-15,LW,L,2016-17,10,1,1,2,0.2,-1,7,14.29,4,5436.0,9:3,0,1,1,0.0,7,0,2,0,2,0,0,0,10.0,0:1,0,0,0,194.0,0:19,779617
8476958,Jaccob,Slavin,1994-05-01,D,L,2016-17,82,5,29,34,0.41,23,99,5.05,12,115316.0,23:26,0,0,0,0.0,35,161,83,54,29,0,4,4,4557.0,0:55,1,3,4,15349.0,3:7,742500
8476960,Andreas,Athanasiou,1994-08-06,LW,L,2016-17,64,18,11,29,0.45,-7,120,15.0,28,51703.0,13:27,37,46,83,44.58,30,21,17,19,-2,1,3,4,4654.0,1:12,0,0,0,1989.0,0:31,628333
8476966,Gemel,Smith,1994-04-16,C,L,2016-17,17,3,3,6,0.35,-1,19,15.79,21,13857.0,13:35,25,34,59,42.37,6,6,4,6,-2,0,0,0,69.0,0:4,1,0,1,1305.0,1:16,645000
8476967,Brett,Kulak,1994-01-06,D,L,2016-17,21,0,3,3,0.14,-3,19,0.0,12,17945.0,14:14,0,0,0,0.0,14,13,4,10,-6,0,0,0,362.0,0:17,0,0,0,133.0,0:6,656667
8476975,Cedric,Paquette,1993-08-13,C,L,2016-17,58,4,6,10,0.17,-6,68,5.88,80,40102.0,11:31,200,234,434,46.08,144,46,17,8,9,0,0,0,263.0,0:4,0,0,0,5087.0,1:27,812500
8476981,Josh,Anderson,1994-05-07,RW,R,2016-17,78,17,12,29,0.37,12,119,14.29,89,56253.0,12:1,8,21,29,27.59,147,40,25,16,9,0,0,0,366.0,0:4,0,0,0,883.0,0:11,678333
8476982,Danny,O'Regan,1994-01-30,C,R,2016-17,3,1,0,1,0.33,-2,5,20.0,0,2079.0,11:33,15,17,32,46.88,1,2,2,0,2,1,0,1,69.0,0:23,0,0,0,37.0,0:12,858750
8476983,Paul,LaDue,1992-09-06,D,R,2016-17,22,0,8,8,0.36,-5,27,0.0,4,20335.0,15:24,0,0,0,0.0,17,13,3,12,-9,0,4,4,1985.0,1:30,0,0,0,200.0,0:9,925000
8476988,Matt,Benning,1994-05-25,D,R,2016-17,62,3,12,15,0.24,8,69,4.35,29,61791.0,16:36,0,0,0,0.0,111,64,7,49,-42,1,2,3,1556.0,0:25,0,0,0,2586.0,0:41,925000
8476989,Petteri,Lindbohm,1993-09-23,D,L,2016-17,7,0,0,0,0.0,-4,10,0.0,4,5453.0,12:59,0,0,0,0.0,10,5,1,1,0,0,0,0,2.0,0:0,0,0,0,73.0,0:10,636667
8476994,Vinnie,Hinostroza,1994-04-03,LW,R,2016-17,49,6,8,14,0.29,-1,76,7.89,17,35216.0,11:58,68,103,171,39.77,31,19,27,15,12,0,0,0,939.0,0:19,0,0,0,0.0,0:0,717500
8477003,Riley,Barber,1994-02-07,RW,R,2016-17,3,0,0,0,0.0,0,2,0.0,0,1544.0,8:34,0,0,0,0.0,1,0,0,0,0,0,0,0,0.0,0:0,0,0,0,0.0,0:0,692500
8477006,Christoph,Bertschy,1994-04-05,C,R,2016-17,5,0,1,1,0.2,0,5,0.0,4,2440.0,8:8,0,0,0,0.0,7,3,0,0,0,0,0,0,0.0,0:0,0,0,0,0.0,0:0,775833
8477009,Jake,Dotchin,1994-03-24,D,R,2016-17,35,0,11,11,0.31,10,50,0.0,35,38701.0,18:25,0,0,0,0.0,85,19,4,23,-19,0,0,0,1950.0,0:55,0,0,0,306.0,0:8,616667
8477010,Joseph,Blandisi,1994-07-18,LW,L,2016-17,27,3,6,9,0.33,-10,24,12.5,26,21643.0,13:21,76,93,169,44.97,37,6,7,4,3,1,4,5,2709.0,1:40,0,0,0,33.0,0:1,648333
8477015,Connor,Brown,1994-01-14,RW,R,2016-17,82,20,16,36,0.44,3,139,14.39,10,79733.0,16:12,2,6,8,25.0,50,46,40,25,15,2,4,6,6060.0,1:13,1,0,1,9819.0,1:59,686667
8477018,Ben,Hutton,1993-04-20,D,L,2016-17,71,5,14,19,0.27,-22,130,3.85,31,87317.0,20:29,0,0,0,0.0,46,106,31,50,-19,2,9,11,8766.0,2:3,0,0,0,2297.0,0:32,896250
8477041,Brady,Austin,1993-06-16,D,L,2016-17,5,0,0,0,0.0,0,8,0.0,4,4827.0,16:5,0,0,0,0.0,6,0,1,2,-1,0,0,0,0.0,0:0,0,0,0,182.0,0:36,626666
8477091,Evan,McEneny,1994-05-22,D,L,2016-17,1,0,0,0,0.0,-1,1,0.0,0,908.0,15:8,0,0,0,0.0,0,0,0,0,0,0,0,0,0.0,0:0,0,0,0,0.0,0:0,585000
8477126,Jayson,Megna,1990-02-01,C,R,2016-17,58,4,4,8,0.14,-4,72,5.56,6,43271.0,12:26,2,14,16,12.5,87,23,20,8,12,0,1,1,3219.0,0:55,0,0,0,157.0,0:2,600000
8477205,Andrej,Sustr,1990-11-29,D,R,2016-17,80,3,11,14,0.18,-10,93,3.23,43,84427.0,17:35,0,1,1,0.0,45,102,18,49,-31,0,0,0,431.0,0:5,0,0,0,10012.0,2:5,1450000
8477210,Buddy,Robinson,1991-09-30,RW,R,2016-17,4,0,0,0,0.0,0,4,0.0,2,1667.0,6:56,0,0,0,0.0,9,0,1,1,0,0,0,0,0.0,0:0,0,0,0,0.0,0:0,750000
8477213,Tim,Schaller,1990-11-16,C,L,2016-17,59,7,7,14,0.24,-6,89,7.87,23,43436.0,12:16,28,29,57,49.12,73,38,19,18,1,0,0,0,1565.0,0:26,0,0,0,3986.0,1:7,600000
8477215,Danny,DeKeyser,1990-03-07,D,L,2016-17,82,4,8,12,0.15,-22,85,4.71,33,107976.0,21:56,0,0,0,0.0,100,170,16,45,-29,0,0,0,2770.0,0:33,0,0,0,13122.0,2:40,5000000
8477220,Nate,Schmidt,1991-07-16,D,L,2016-17,60,3,14,17,0.28,22,60,5.0,16,55723.0,15:28,0,0,0,0.0,51,37,36,44,-8,0,0,0,572.0,0:9,0,1,1,2561.0,0:42,812500
8477240,Carter,Rowney,1989-05-10,RW,R,2016-17,27,3,4,7,0.26,2,24,12.5,4,17773.0,10:58,95,103,198,47.98,64,15,11,5,6,0,0,0,4.0,0:0,0,0,0,1703.0,1:3,612500
8477244,Chad,Ruhwedel,1990-05-07,D,R,2016-17,34,2,8,10,0.29,9,45,4.44,8,35366.0,17:20,0,0,0,0.0,36,26,9,12,-3,0,3,3,1927.0,0:56,0,0,0,2308.0,1:7,575000
8477290,Michael,Raffl,1988-12-01,LW,L,2016-17,52,8,3,11,0.21,-7,63,12.7,20,41378.0,13:15,3,7,10,30.0,91,22,13,17,-4,0,0,0,332.0,0:6,0,0,0,83.0,0:1,2350000
8477320,Anton,Blidh,1995-03-14,LW,L,2016-17,19,1,1,2,0.11,-2,26,3.85,7,10006.0,8:46,0,0,0,0.0,41,4,4,4,0,0,0,0,30.0,0:1,0,0,0,299.0,0:15,784167
8477326,Joel,Vermin,1992-02-05,RW,L,2016-17,18,0,3,3,0.17,2,12,0.0,4,11801.0,10:55,2,1,3,66.67,17,7,5,2,3,0,0,0,122.0,0:6,0,0,0,897.0,0:49,575000
8477346,MacKenzie,Weegar,1994-01-07,D,R,2016-17,3,0,0,0,0.0,0,3,0.0,4,3140.0,17:26,0,0,0,0.0,4,1,1,0,1,0,0,0,345.0,1:55,0,0,0,0.0,0:0,680000
8477353,Tyler,Motte,1995-03-10,C,L,2016-17,33,4,3,7,0.21,2,46,8.7,14,22546.0,11:23,4,6,10,40.0,27,24,13,4,9,0,0,0,179.0,0:5,0,0,0,2206.0,1:6,925000
8477380,Jonny,Brodzinski,1993-06-19,C,L,2016-17,6,0,2,2,0.33,2,17,0.0,2,4423.0,12:17,0,0,0,0.0,10,4,2,1,1,0,0,0,112.0,0:18,0,0,0,3.0,0:0,808750
8477391,Sean,Malone,1995-04-30,C,L,2016-17,1,0,0,0,0.0,0,1,0.0,0,732.0,12:12,5,3,8,62.5,0,1,0,1,-1,0,0,0,50.0,0:50,0,0,0,0.0,0:0,883750
8477392,Hudson,Fasching,1995-07-28,RW,R,2016-17,10,0,1,1,0.1,-1,6,0.0,2,6245.0,10:24,0,0,0,0.0,17,2,1,1,0,0,0,0,130.0,0:13,0,0,0,323.0,0:32,925000
8477401,John,Hayden,1995-02-14,RW,R,2016-17,12,1,3,4,0.33,3,22,4.55,4,8413.0,11:41,0,0,0,0.0,44,2,5,2,3,0,0,0,188.0,0:15,0,0,0,0.0,0:0,925000
8477402,Pavel,Buchnevich,1995-04-17,RW,L,2016-17,41,8,12,20,0.49,6,55,14.55,13,32616.0,13:15,1,6,7,14.29,17,8,11,22,-11,1,2,3,4612.0,1:52,0,0,0,17.0,0:0,925000
8477404,Jake,Guentzel,1994-10-06,C,L,2016-17,40,16,17,33,0.82,7,81,19.75,10,38126.0,15:53,8,9,17,47.06,61,18,16,9,7,1,2,3,3293.0,1:22,0,0,0,15.0,0:0,734167
8477407,Anthony,Duclair,1995-08-26,LW,L,2016-17,58,5,10,15,0.26,-7,76,6.58,14,46282.0,13:17,4,4,8,50.0,22,17,30,22,8,0,2,2,4355.0,1:15,0,0,0,16.0,0:0,772500
8477413,Sven,Andrighetto,1993-03-21,RW,L,2016-17,46,7,17,24,0.52,1,68,10.29,12,38550.0,13:58,7,3,10,70.0,40,22,19,9,10,2,2,4,3070.0,1:6,0,0,0,43.0,0:0,650000
8477415,Anton,Slepyshev,1994-05-13,LW,R,2016-17,41,4,6,10,0.24,5,55,7.27,4,27342.0,11:6,2,3,5,40.0,64,15,19,14,5,0,0,0,262.0,0:6,0,0,0,29.0,0:0,925000
8477416,Oliver,Bjorkstrand,1995-04-10,RW,R,2016-17,26,6,7,13,0.5,4,55,10.91,6,21980.0,14:5,1,0,1,100.0,14,9,8,8,0,0,0,0,2646.0,1:41,0,0,0,4.0,0:0,655833
8477417,Peter,Cehlarik,1995-08-02,LW,L,2016-17,11,0,2,2,0.18,0,8,0.0,0,9183.0,13:54,2,1,3,66.67,7,4,8,10,-2,0,1,1,916.0,1:23,0,0,0,0.0,0:0,742500
8477425,Miles,Wood,1995-09-13,LW,L,2016-17,60,8,9,17,0.28,-21,105,7.62,86,46269.0,12:51,1,1,2,50.0,68,26,16,14,2,2,2,4,5191.0,1:26,0,0,0,65.0,0:1,925000
8477426,Nick,Paul,1995-03-20,LW,L,2016-17,1,0,0,0,0.0,-2,4,0.0,0,989.0,16:29,5,8,13,38.46,3,0,1,0,1,0,0,0,46.0,0:46,0,0,0,0.0,0:0,670000
8477429,Andrew,Copp,1994-07-08,C,L,2016-17,64,9,8,17,0.27,8,77,11.69,18,47398.0,12:20,95,97,192,49.48,87,28,20,16,4,0,0,0,552.0,0:8,1,0,1,5577.0,1:27,925000
8477433,Ben,Harpur,1995-01-12,D,L,2016-17,6,0,0,0,0.0,-1,3,0.0,0,6409.0,17:48,0,0,0,0.0,5,3,2,5,-3,0,0,0,155.0,0:25,0,0,0,101.0,0:16,653333
8477444,Andre,Burakovsky,1995-02-09,LW,L,2016-17,64,12,23,35,0.55,13,111,10.81,14,50931.0,13:15,2,5,7,28.57,31,25,33,33,0,2,3,5,5602.0,1:27,0,0,0,14.0,0:0,894167
8477445,Hunter,Shinkaruk,1994-10-13,C,L,2016-17,7,0,1,1,0.14,-3,5,0.0,2,4445.0,10:35,0,0,0,0.0,3,3,2,1,1,0,0,0,23.0,0:3,0,0,0,0.0,0:0,863333
8477446,Michael,McCarron,1995-03-07,RW,R,2016-17,31,1,4,5,0.16,-4,31,3.23,41,18393.0,9:53,76,99,175,43.43,75,11,7,6,1,0,0,0,809.0,0:26,0,0,0,18.0,0:0,863333
8477447,Shea,Theodore,1995-08-03,D,L,2016-17,34,2,7,9,0.26,-6,60,3.33,28,35319.0,17:18,0,0,0,0.0,14,30,4,30,-26,1,1,2,4437.0,2:10,0,1,1,1591.0,0:46,863333
8477448,Marko,Dano,1994-11-30,C,L,2016-17,38,4,7,11,0.29,0,44,9.09,10,24361.0,10:41,1,3,4,25.0,83,14,18,10,8,2,0,2,3099.0,1:21,0,0,0,76.0,0:2,925000
8477450,Jason,Dickinson,1995-07-04,C,L,2016-17,10,2,0,2,0.2,-3,9,22.22,0,7074.0,11:47,4,9,13,30.77,8,4,3,0,3,0,0,0,3.0,0:0,0,0,0,46.0,0:4,894167
8477451,Ryan,Hartman,1994-09-20,RW,R,2016-17,76,19,12,31,0.41,13,170,11.18,70,58218.0,12:46,25,37,62,40.32,121,30,36,31,5,1,0,1,2372.0,0:31,0,0,0,413.0,0:5,863333
8477454,Adam,Erne,1995-04-20,LW,L,2016-17,26,3,0,3,0.12,-9,40,7.5,11,18419.0,11:48,0,2,2,0.0,71,13,2,5,-3,0,0,0,1598.0,1:1,0,0,0,0.0,0:0,874167
8477455,Jacob,de la Rose,1995-05-20,LW,L,2016-17,9,0,0,0,0.0,-3,4,0.0,4,5890.0,10:54,17,17,34,50.0,23,5,4,0,4,0,0,0,7.0,0:0,0,0,0,1141.0,2:6,925000
8477456,J.T.,Compher,1995-04-08,LW,R,2016-17,21,3,2,5,0.24,0,30,10.0,4,18811.0,14:55,78,86,164,47.56,11,21,6,8,-2,1,0,1,2340.0,1:51,0,0,0,1062.0,0:50,925000
8477458,Valentin,Zykov,1995-05-15,LW,R,2016-17,2,1,0,1,0.5,1,3,33.33,0,750.0,6:15,0,0,0,0.0,0,0,0,1,-1,0,0,0,132.0,1:6,0,0,0,0.0,0:0,705000
8477460,Laurent,Dauphin,1995-03-27,C,L,2016-17,24,2,1,3,0.12,-2,32,6.25,12,15710.0,10:54,37,45,82,45.12,32,11,9,3,6,0,0,0,40.0,0:1,1,0,1,2450.0,1:42,745000
8477461,Remi,Elie,1995-04-16,LW,L,2016-17,18,1,6,7,0.39,5,15,6.67,8,16875.0,15:37,1,0,1,100.0,30,11,12,13,-1,0,0,0,54.0,0:3,0,0,0,1137.0,1:3,728333
8477462,Robert,Hagg,1995-02-08,D,L,2016-17,1,0,0,0,0.0,0,5,0.0,0,1279.0,21:19,0,0,0,0.0,4,3,0,0,0,0,0,0,0.0,0:0,0,0,0,94.0,1:34,894167
8477463,Steven,Santini,1995-03-07,D,R,2016-17,38,2,5,7,0.18,-6,46,4.35,14,36670.0,16:5,0,0,0,0.0,83,35,1,11,-10,0,0,0,94.0,0:2,0,0,0,3136.0,1:22,925000
8477464,Nic,Petan,1995-03-22,LW,L,2016-17,54,1,12,13,0.24,-13,57,1.75,12,35316.0,10:54,145,170,315,46.03,12,10,16,18,-2,0,8,8,6896.0,2:7,0,0,0,236.0,0:4,758333
8477466,Nick,Sorensen,1994-10-23,RW,R,2016-17,5,0,1,1,0.2,-1,7,0.0,2,3267.0,10:53,1,0,1,100.0,2,3,0,0,0,0,0,0,291.0,0:58,0,0,0,23.0,0:4,803333
8477467,Gustav,Olofsson,1994-12-01,D,L,2016-17,13,0,3,3,0.23,-1,7,0.0,2,10516.0,13:28,0,0,0,0.0,10,16,3,1,2,0,1,1,504.0,0:38,0,0,0,47.0,0:3,795000
8477473,Justin,Bailey,1995-07-01,RW,R,2016-17,32,2,2,4,0.12,0,36,5.56,4,20414.0,10:37,0,1,1,0.0,27,14,8,10,-2,0,0,0,8.0,0:0,0,0,0,0.0,0:0,670000
8477476,Artturi,Lehkonen,1995-07-04,LW,L,2016-17,73,18,10,28,0.38,-1,158,11.39,8,60702.0,13:51,2,2,4,50.0,72,25,25,20,5,2,2,4,4042.0,0:55,1,0,1,1972.0,0:27,839166
8477478,William,Carrier,1994-12-20,LW,L,2016-17,41,5,3,8,0.2,-1,50,10.0,21,22142.0,9:0,1,1,2,50.0,112,10,8,10,-2,0,0,0,11.0,0:0,0,0,0,144.0,0:3,689167
8477479,Tyler,Bertuzzi,1995-02-24,LW,L,2016-17,7,0,0,0,0.0,-1,3,0.0,0,3825.0,9:6,1,1,2,50.0,12,0,1,3,-2,0,0,0,22.0,0:3,0,0,0,0.0,0:0,661667
8477482,Zach,Sanford,1994-11-09,LW,L,2016-17,39,4,4,8,0.21,2,36,11.11,10,25370.0,10:50,17,22,39,43.59,22,20,14,14,0,0,0,0,1220.0,0:31,0,0,0,593.0,0:15,875000
8477488,Brett,Pesce,1994-11-15,D,R,2016-17,82,2,18,20,0.24,23,109,1.83,20,104325.0,21:12,0,0,0,0.0,57,148,55,34,21,0,2,2,3044.0,0:37,0,0,0,10647.0,2:9,809167
8477491,Nicholas,Baptiste,1995-08-04,RW,R,2016-17,14,3,1,4,0.29,1,16,18.75,6,7761.0,9:14,1,2,3,33.33,12,1,1,1,0,0,0,0,482.0,0:34,0,0,0,14.0,0:1,718333
8477492,Nathan,MacKinnon,1995-09-01,C,R,2016-17,82,16,37,53,0.65,-14,251,6.37,16,98124.0,19:56,769,752,1521,50.56,56,30,47,45,2,2,12,14,13672.0,2:46,2,0,2,8589.0,1:44,6300000
8477493,Aleksander,Barkov,1995-09-02,C,L,2016-17,61,21,31,52,0.85,13,142,14.79,10,71010.0,19:24,476,547,1023,46.53,39,30,49,30,19,3,11,14,10649.0,2:54,0,0,0,4684.0,1:16,5900000
8477494,Jonathan,Drouin,1995-03-28,LW,L,2016-17,73,21,32,53,0.73,-13,183,11.48,16,77555.0,17:42,96,124,220,43.64,50,16,45,65,-20,9,17,26,13508.0,3:5,0,0,0,24.0,0:0,894167
8477495,Seth,Jones,1994-10-03,D,R,2016-17,75,12,30,42,0.56,6,152,7.89,24,105315.0,23:24,0,0,0,0.0,61,118,32,44,-12,1,6,7,7491.0,1:39,0,0,0,9544.0,2:7,5400000
8477496,Elias,Lindholm,1994-12-02,C,R,2016-17,72,11,34,45,0.62,-2,151,7.28,16,78543.0,18:10,353,282,635,55.59,99,43,57,37,20,2,9,11,9527.0,2:12,1,4,5,5339.0,1:14,2700000
8477497,Sean,Monahan,1994-10-12,C,L,2016-17,82,27,31,58,0.71,-1,199,13.57,20,86478.0,17:34,743,701,1444,51.45,34,25,50,44,6,8,9,17,14879.0,3:1,1,0,1,2447.0,0:29,6375000
8477498,Darnell,Nurse,1995-02-04,D,L,2016-17,44,5,6,11,0.25,0,85,5.88,33,44927.0,17:1,0,0,0,0.0,107,53,11,36,-25,0,0,0,299.0,0:6,0,0,0,3134.0,1:11,863333
8477499,Rasmus,Ristolainen,1994-10-27,D,R,2016-17,79,6,39,45,0.57,-9,186,3.23,58,125458.0,26:28,0,0,0,0.0,195,161,25,59,-34,1,24,25,15150.0,3:11,0,1,1,14145.0,2:59,5400000
8477500,Bo,Horvat,1995-04-05,C,L,2016-17,81,20,32,52,0.64,-7,158,12.66,27,87636.0,18:1,756,742,1498,50.47,65,41,37,27,10,3,7,10,9382.0,1:55,2,0,2,8901.0,1:49,894167
8477502,Samuel,Morin,1995-07-12,D,L,2016-17,1,0,0,0,0.0,0,2,0.0,0,1067.0,17:47,0,0,0,0.0,7,0,1,0,1,0,0,0,0.0,0:0,0,0,0,189.0,3:9,863333
8477503,Max,Domi,1995-03-02,LW,L,2016-17,59,9,29,38,0.64,-9,108,8.33,40,60112.0,16:58,5,5,10,50.0,28,21,27,36,-9,1,7,8,9073.0,2:33,0,0,0,393.0,0:6,863333
8477504,Josh,Morrissey,1995-03-28,D,L,2016-17,82,6,14,20,0.24,6,99,6.06,38,95896.0,19:29,0,0,0,0.0,145,139,15,39,-24,1,0,1,3055.0,0:37,0,0,0,4292.0,0:52,863333
8477505,Alexander,Wennberg,1994-09-22,C,L,2016-17,80,13,46,59,0.74,9,109,11.93,21,88212.0,18:22,609,676,1285,47.39,58,56,44,31,13,2,21,23,12685.0,2:38,0,0,0,3039.0,0:37,925000
8477507,Nikita,Zadorov,1995-04-16,D,L,2016-17,56,0,10,10,0.18,-20,61,0.0,73,63960.0,19:2,0,0,0,0.0,153,69,12,25,-13,0,2,2,2140.0,0:38,0,0,0,7186.0,2:8,894167
8477508,Curtis,Lazar,1995-02-02,C,R,2016-17,37,1,3,4,0.11,-8,26,3.85,4,20277.0,9:8,39,60,99,39.39,66,17,7,6,1,0,0,0,234.0,0:6,0,0,0,656.0,0:17,894167
8477509,Mirco,Mueller,1995-03-21,D,L,2016-17,4,1,1,2,0.5,2,3,33.33,0,2302.0,9:35,0,0,0,0.0,2,3,2,2,0,0,0,0,0.0,0:0,0,0,0,56.0,0:14,894167
8477511,Anthony,Mantha,1994-09-16,RW,L,2016-17,60,17,19,36,0.6,10,133,12.78,53,57246.0,15:54,5,6,11,45.45,46,33,26,39,-13,1,2,3,6820.0,1:53,0,0,0,149.0,0:2,863333
8477512,Frederik,Gauthier,1995-04-26,C,L,2016-17,21,2,1,3,0.14,2,15,13.33,23,12213.0,9:41,120,115,235,51.06,17,17,5,3,2,0,0,0,117.0,0:5,0,0,0,1313.0,1:2,863333
8477566,Sergey,Tolchinsky,1995-02-03,LW,L,2016-17,2,0,1,1,0.5,0,2,0.0,0,1377.0,11:28,0,0,0,0.0,0,0,0,0,0,0,0,0,7.0,0:3,0,0,0,0.0,0:0,616667
8477591,Josh,Jooris,1990-07-14,RW,R,2016-17,54,4,8,12,0.22,-2,75,5.33,16,39514.0,12:11,222,228,450,49.33,49,30,10,5,5,0,0,0,88.0,0:1,0,1,1,4775.0,1:28,600000
8477715,Tyler,Gaudet,1993-04-04,C,L,2016-17,4,0,1,1,0.25,0,3,0.0,0,3117.0,12:59,14,21,35,40.0,3,1,0,0,0,0,0,0,0.0,0:0,0,0,0,544.0,2:16,874125
8477810,Joel,Hanley,1991-06-08,D,L,2016-17,7,0,0,0,0.0,-3,5,0.0,4,4266.0,10:9,0,0,0,0.0,8,4,1,3,-2,0,0,0,0.0,0:0,0,0,0,0.0,0:0,600000
8477839,Conor,Sheary,1992-06-08,LW,L,2016-17,61,23,30,53,0.87,24,154,14.94,22,58332.0,15:56,0,0,0,0.0,29,23,26,25,1,2,3,5,6534.0,1:47,0,0,0,40.0,0:0,667500
8477845,Trevor,van Riemsdyk,1991-07-24,D,R,2016-17,58,5,11,16,0.28,17,73,6.85,29,64062.0,18:24,0,0,0,0.0,22,100,22,35,-13,0,0,0,1906.0,0:32,0,0,0,2993.0,0:51,825000
8477846,Ryan,Carpenter,1991-01-18,C,R,2016-17,11,2,2,4,0.36,5,20,10.0,4,6853.0,10:23,34,41,75,45.33,15,2,1,3,-2,0,0,0,42.0,0:3,0,0,0,533.0,0:48,600000
8477850,Christian,Folin,1991-02-09,D,R,2016-17,51,2,6,8,0.16,10,39,5.13,26,45700.0,14:56,0,0,0,0.0,69,59,9,15,-6,0,0,0,116.0,0:2,0,0,0,2933.0,0:57,725000
8477851,Jordan,Oesterle,1992-06-25,D,L,2016-17,2,0,0,0,0.0,-1,2,0.0,0,2074.0,17:17,0,0,0,0.0,2,3,2,2,0,0,0,0,36.0,0:18,0,0,0,0.0,0:0,585000
8477881,Connor,Jones,1990-08-16,C,L,2016-17,4,0,0,0,0.0,1,2,0.0,2,2843.0,11:50,8,5,13,61.54,13,3,2,1,1,0,0,0,0.0,0:0,0,0,0,107.0,0:26,575000
8477887,Patrick,Brown,1992-05-29,C,R,2016-17,14,0,0,0,0.0,-6,12,0.0,0,8160.0,9:42,9,6,15,60.0,30,5,2,3,-1,0,0,0,19.0,0:1,0,0,0,78.0,0:5,650000
8477901,Daniel,Carr,1991-11-01,LW,L,2016-17,33,2,7,9,0.27,4,44,4.55,6,20306.0,10:15,2,1,3,66.67,19,12,7,6,1,0,0,0,427.0,0:12,0,0,0,77.0,0:2,725000
8477903,Garnet,Hathaway,1991-11-23,RW,R,2016-17,26,1,4,5,0.19,0,22,4.55,44,14257.0,9:8,10,9,19,52.63,56,14,8,3,5,0,0,0,76.0,0:2,0,0,0,116.0,0:4,690000
8477916,Borna,Rendulic,1992-03-25,RW,R,2016-17,1,0,0,0,0.0,0,1,0.0,0,291.0,4:51,0,0,0,0.0,0,0,0,0,0,0,0,0,0.0,0:0,0,0,0,0.0,0:0,575000
8477919,Frederick,Gaudreau,1993-05-01,C,R,2016-17,9,0,1,1,0.11,1,8,0.0,0,4678.0,8:39,4,8,12,33.33,1,5,2,1,1,0,0,0,25.0,0:2,0,0,0,68.0,0:7,595000
8477922,Melker,Karlsson,1990-07-18,C,R,2016-17,67,11,11,22,0.33,7,73,15.07,22,51459.0,12:48,1,5,6,16.67,67,59,17,23,-6,0,0,0,437.0,0:6,2,0,2,6358.0,1:34,1650000
8477929,Dennis,Rasmussen,1990-07-03,C,L,2016-17,68,4,4,8,0.12,-4,77,5.19,12,48254.0,11:49,165,205,370,44.59,61,49,25,19,6,0,0,0,167.0,0:2,0,0,0,7195.0,1:45,575000
8477930,Pierre-Edouard,Bellemare,1985-03-06,LW,L,2016-17,82,4,4,8,0.1,-1,90,4.44,20,63814.0,12:58,402,429,831,48.38,73,70,24,14,10,0,0,0,248.0,0:3,0,1,1,13616.0,2:46,712500
8477931,Tomas,Nosek,1992-09-01,LW,L,2016-17,11,1,0,1,0.09,-1,19,5.26,2,6682.0,10:7,37,31,68,54.41,10,5,5,3,2,0,0,0,29.0,0:2,0,0,0,140.0,0:12,612500
8477932,Aaron,Ekblad,1996-02-07,D,R,2016-17,68,10,11,21,0.31,-23,225,4.44,58,87557.0,21:27,0,0,0,0.0,88,62,25,58,-33,4,4,8,11369.0,2:47,1,0,1,3310.0,0:48,925000
8477933,Sam,Reinhart,1995-11-06,C,R,2016-17,79,17,30,47,0.59,-11,178,9.55,8,81609.0,17:13,86,124,210,40.95,21,40,25,27,-2,9,8,17,13903.0,2:55,0,0,0,239.0,0:3,894167
8477934,Leon,Draisaitl,1995-10-27,C,L,2016-17,82,29,48,77,0.94,7,172,16.86,20,92909.0,18:53,476,496,972,48.97,41,36,75,75,0,10,17,27,14309.0,2:54,0,0,0,2076.0,0:25,925000
8477935,Sam,Bennett,1996-06-20,C,L,2016-17,81,13,13,26,0.32,-16,122,10.66,75,72839.0,14:59,374,437,811,46.12,127,46,43,25,18,4,0,4,5999.0,1:14,0,1,1,5474.0,1:7,925000
8477937,Jake,Virtanen,1996-08-17,RW,R,2016-17,10,0,1,1,0.1,1,13,0.0,2,6087.0,10:8,3,0,3,100.0,17,4,4,0,4,0,0,0,93.0,0:9,0,0,0,0.0,0:0,894167
8477939,William,Nylander,1996-05-01,C,R,2016-17,81,22,39,61,0.75,-3,205,10.73,32,77820.0,16:0,49,73,122,40.16,25,16,59,30,29,9,17,26,11446.0,2:21,0,0,0,37.0,0:0,894167
8477940,Nikolaj,Ehlers,1996-02-14,LW,L,2016-17,82,25,39,64,0.78,1,204,12.25,38,86032.0,17:29,0,4,4,0.0,43,28,36,51,-15,5,7,12,12834.0,2:36,0,0,0,89.0,0:1,894167
8477941,Nick,Ritchie,1995-12-05,LW,L,2016-17,77,14,14,28,0.36,4,149,9.4,62,59992.0,12:59,4,4,8,50.0,247,24,16,23,-7,1,1,2,2611.0,0:33,0,0,0,266.0,0:3,894167
8477942,Kevin,Fiala,1996-07-22,LW,L,2016-17,54,11,5,16,0.3,1,114,9.65,18,43780.0,13:30,0,0,0,0.0,44,14,39,27,12,0,0,0,2663.0,0:49,0,0,0,419.0,0:7,863333
8477943,Brendan,Perlini,1996-04-27,LW,L,2016-17,57,14,7,21,0.37,-4,92,15.22,20,50747.0,14:50,1,1,2,50.0,42,15,8,13,-5,3,2,5,5947.0,1:44,0,0,0,147.0,0:2,863333
8477944,Jakub,Vrana,1996-02-28,LW,L,2016-17,21,3,3,6,0.29,2,32,9.38,2,13997.0,11:6,0,3,3,0.0,6,7,4,9,-5,3,1,4,2276.0,1:48,0,0,0,0.0,0:0,863333
8477945,Julius,Honka,1995-12-03,D,R,2016-17,16,1,4,5,0.31,-4,34,2.94,4,16194.0,16:52,0,0,0,0.0,9,15,6,9,-3,0,1,1,1333.0,1:23,0,0,0,6.0,0:0,863333
8477946,Dylan,Larkin,1996-07-30,C,L,2016-17,80,17,15,32,0.4,-28,178,9.55,37,77534.0,16:9,196,236,432,45.37,67,22,49,51,-2,5,2,7,8996.0,1:52,1,0,1,1630.0,0:20,925000
8477947,Sonny,Milano,1996-05-12,LW,L,2016-17,4,0,0,0,0.0,-3,2,0.0,0,2804.0,11:41,0,0,0,0.0,3,2,1,3,-2,0,0,0,386.0,1:36,0,0,0,0.0,0:0,863333
8477949,Alex,Tuch,1996-05-10,RW,R,2016-17,6,0,0,0,0.0,-3,8,0.0,0,3853.0,10:42,0,0,0,0.0,5,7,2,0,2,0,0,0,0.0,0:0,0,0,0,0.0,0:0,925000
8477951,Nick,Schmaltz,1996-02-23,C,R,2016-17,61,6,22,28,0.46,10,66,9.09,6,48536.0,13:15,84,188,272,30.88,20,27,46,22,24,0,2,2,3822.0,1:2,0,0,0,64.0,0:1,925000
8477952,Robby,Fabbri,1996-01-22,C,L,2016-17,51,11,18,29,0.57,-16,91,12.09,27,47764.0,15:36,13,11,24,54.17,64,14,20,8,12,4,5,9,6949.0,2:16,0,0,0,124.0,0:2,894167
8477953,Kasperi,Kapanen,1996-07-23,RW,R,2016-17,8,1,0,1,0.12,-2,11,9.09,0,5134.0,10:41,0,0,0,0.0,6,2,2,4,-2,0,0,0,27.0,0:3,0,0,0,670.0,1:23,863333
8477955,Jared,McCann,1996-05-31,C,L,2016-17,29,1,6,7,0.24,-1,44,2.27,4,20245.0,11:38,41,64,105,39.05,28,6,8,8,0,0,1,1,1718.0,0:59,0,0,0,34.0,0:1,894167
8477956,David,Pastrnak,1996-05-25,RW,R,2016-17,75,34,36,70,0.93,11,262,12.98,34,80921.0,17:58,2,1,3,66.67,72,32,50,65,-15,10,14,24,11825.0,2:37,0,0,0,71.0,0:0,925000
8477957,Nikita,Scherbak,1995-12-30,RW,L,2016-17,3,1,0,1,0.33,1,3,33.33,0,2048.0,11:22,0,0,0,0.0,0,1,0,0,0,1,0,1,287.0,1:35,0,0,0,0.0,0:0,863333
8477958,Nikolay,Goldobin,1995-10-07,RW,L,2016-17,14,3,0,3,0.21,0,14,21.43,0,9551.0,11:22,0,0,0,0.0,1,4,3,8,-5,0,0,0,434.0,0:31,0,0,0,0.0,0:0,863333
8477959,Joshua,Ho-Sang,1996-01-22,RW,R,2016-17,21,4,6,10,0.48,1,22,18.18,12,20735.0,16:27,0,2,2,0.0,4,2,9,20,-11,1,1,2,3040.0,2:24,0,0,0,0.0,0:0,863333
8477960,Adrian,Kempe,1996-09-13,LW,L,2016-17,25,2,4,6,0.24,-3,32,6.25,6,18346.0,12:13,67,86,153,43.79,23,7,5,10,-5,0,2,2,1205.0,0:48,0,1,1,938.0,0:37,894167
8477961,John,Quenneville,1996-04-16,C,L,2016-17,12,1,3,4,0.33,1,21,4.76,2,9863.0,13:41,0,0,0,0.0,15,7,4,4,0,1,1,2,1365.0,1:53,0,0,0,22.0,0:1,811667
8477964,Ivan,Barbashev,1995-12-14,C,L,2016-17,30,5,7,12,0.4,5,20,25.0,2,21224.0,11:47,83,124,207,40.1,34,14,9,3,6,0,0,0,1620.0,0:54,0,0,0,32.0,0:1,741667
8477971,Andreas,Englund,1996-01-21,D,L,2016-17,5,0,0,0,0.0,-3,3,0.0,2,3189.0,10:37,0,0,0,0.0,18,0,0,2,-2,0,0,0,6.0,0:1,0,0,0,53.0,0:10,775833
8477973,Vladislav,Kamenev,1996-08-12,C,L,2016-17,2,0,0,0,0.0,-1,1,0.0,2,1207.0,10:3,6,7,13,46.15,1,1,0,0,0,0,0,0,109.0,0:54,0,0,0,0.0,0:0,833333
8477986,Brandon,Montour,1994-04-11,D,R,2016-17,27,2,4,6,0.22,11,50,4.0,14,28157.0,17:22,0,0,0,0.0,21,24,3,17,-14,0,1,1,3065.0,1:53,0,0,0,450.0,0:16,925000
8477989,Christian,Dvorak,1996-02-02,C,L,2016-17,78,15,18,33,0.42,7,88,17.05,22,73086.0,15:37,471,535,1006,46.82,72,56,14,15,-1,2,3,5,6676.0,1:25,0,0,0,3964.0,0:50,839167
8477997,Nikita,Tryamkin,1994-08-30,D,L,2016-17,66,2,7,9,0.14,-7,65,3.08,64,66291.0,16:44,0,0,0,0.0,145,87,12,33,-21,0,0,0,129.0,0:1,0,0,0,5786.0,1:27,925000
8478004,Brett,Lernout,1995-09-24,D,R,2016-17,2,0,0,0,0.0,-1,3,0.0,0,2279.0,18:59,0,0,0,0.0,8,3,0,0,0,0,0,0,0.0,0:0,0,0,0,14.0,0:7,653333
8478010,Brayden,Point,1996-03-13,C,R,2016-17,68,18,22,40,0.59,4,122,14.75,14,69898.0,17:7,238,294,532,44.74,39,31,30,19,11,5,7,12,10273.0,2:31,0,0,0,1124.0,0:16,686667
8478027,Lucas,Wallmark,1995-09-05,C,L,2016-17,8,0,2,2,0.25,1,11,0.0,2,5216.0,10:52,31,27,58,53.45,14,3,3,1,2,0,0,0,68.0,0:8,0,0,0,0.0,0:0,683333
8478031,Nelson,Nogier,1996-05-27,D,R,2016-17,10,0,0,0,0.0,-1,8,0.0,5,7028.0,11:42,0,0,0,0.0,12,5,0,6,-6,0,0,0,12.0,0:1,0,0,0,0.0,0:0,713333
8478042,Viktor,Arvidsson,1993-04-08,LW,R,2016-17,80,31,30,61,0.76,16,246,12.6,28,82343.0,17:9,4,12,16,25.0,23,45,37,26,11,4,5,9,9562.0,1:59,5,2,7,5110.0,1:3,631667
8478046,Danton,Heinen,1995-07-05,C,L,2016-17,8,0,0,0,0.0,-3,7,0.0,2,6352.0,13:14,0,0,0,0.0,6,2,5,2,3,0,0,0,850.0,1:46,0,0,0,40.0,0:5,872500
8478055,Gustav,Forsling,1996-06-12,D,L,2016-17,38,2,3,5,0.13,3,48,4.17,4,33787.0,14:49,0,0,0,0.0,16,17,5,27,-22,0,1,1,2133.0,0:56,0,0,0,188.0,0:4,872500
8478073,Anton,Lindholm,1994-11-29,D,L,2016-17,12,0,0,0,0.0,-8,7,0.0,2,10621.0,14:45,0,0,0,0.0,38,12,2,4,-2,0,0,0,0.0,0:0,0,0,0,846.0,1:10,717500
8478099,Kevin,Labanc,1995-12-12,RW,R,2016-17,55,8,12,20,0.36,9,70,11.43,22,45139.0,13:40,2,2,4,50.0,19,14,16,27,-11,0,2,2,3759.0,1:8,0,0,0,631.0,0:11,717500
8478131,Ondrej,Kase,1995-11-08,RW,R,2016-17,53,5,10,15,0.28,-1,77,6.49,18,37473.0,11:47,1,6,7,14.29,42,14,23,33,-10,0,0,0,722.0,0:13,0,0,0,26.0,0:0,670000
8478366,Frank,Vatrano,1994-03-14,C,L,2016-17,44,10,8,18,0.41,-3,116,8.62,14,35581.0,13:28,2,5,7,28.57,51,16,9,8,1,4,1,5,4649.0,1:45,0,0,0,132.0,0:3,792500
8478371,Matt,Lorito,1990-07-03,LW,L,2016-17,2,0,1,1,0.5,0,6,0.0,0,1732.0,14:26,0,0,0,0.0,0,0,1,0,1,0,0,0,109.0,0:54,0,0,0,0.0,0:0,637500
8478373,Nikita,Soshnikov,1993-10-14,RW,L,2016-17,56,5,4,9,0.16,1,70,7.14,16,36450.0,10:50,2,15,17,11.76,101,28,20,15,5,0,1,1,2059.0,0:36,0,0,0,3835.0,1:8,736666
8478376,Casey,Bailey,1991-10-27,RW,R,2016-17,7,0,0,0,0.0,-1,10,0.0,0,3358.0,7:59,0,1,1,0.0,4,4,1,0,1,0,0,0,0.0,0:0,0,0,0,0.0,0:0,874125
8478396,Noah,Hanifin,1997-01-25,D,L,2016-17,81,4,25,29,0.36,-19,108,3.7,26,87092.0,17:55,0,0,0,0.0,57,73,42,53,-11,2,9,11,9875.0,2:1,0,0,0,185.0,0:2,925000
8478398,Kyle,Connor,1996-12-09,LW,L,2016-17,20,2,3,5,0.25,-7,24,8.33,4,14665.0,12:13,1,1,2,50.0,1,8,11,5,6,0,2,2,1679.0,1:23,0,0,0,0.0,0:0,925000
8478400,Colin,White,1997-01-30,C,R,2016-17,2,0,0,0,0.0,0,1,0.0,0,1645.0,13:42,7,14,21,33.33,0,1,1,0,1,0,0,0,201.0,1:40,0,0,0,0.0,0:0,925000
8478401,Pavel,Zacha,1997-04-06,C,L,2016-17,70,8,16,24,0.34,-17,83,9.64,19,60093.0,14:18,184,273,457,40.26,54,24,16,26,-10,5,8,13,7726.0,1:50,0,0,0,2941.0,0:42,894167
8478402,Connor,McDavid,1997-01-13,C,L,2016-17,82,30,70,100,1.22,27,251,11.95,26,103967.0,21:7,348,458,806,43.18,34,29,76,54,22,3,24,27,14933.0,3:2,1,1,2,3949.0,0:48,925000
8478403,Jack,Eichel,1996-10-28,C,R,2016-17,61,24,33,57,0.93,-13,249,9.64,22,72908.0,19:55,310,486,796,38.94,26,35,38,46,-8,10,14,24,10917.0,2:58,0,0,0,881.0,0:14,925000
8478414,Timo,Meier,1996-10-08,RW,L,2016-17,34,3,3,6,0.18,1,85,3.53,10,25446.0,12:28,1,4,5,20.0,64,5,24,28,-4,0,0,0,379.0,0:11,0,0,0,827.0,0:24,894167
8478420,Mikko,Rantanen,1996-10-29,RW,L,2016-17,75,20,18,38,0.51,-25,133,15.04,22,81262.0,18:3,29,21,50,58.0,29,33,49,32,17,4,6,10,12260.0,2:43,0,0,0,346.0,0:4,894167
8478421,A.J.,Greer,1996-12-14,LW,L,2016-17,5,0,1,1,0.2,-2,8,0.0,4,4097.0,13:39,0,0,0,0.0,4,3,1,2,-1,0,0,0,172.0,0:34,0,0,0,118.0,0:23,741666
8478425,Brendan,Guhle,1997-07-29,D,L,2016-17,3,0,0,0,0.0,1,4,0.0,0,2943.0,16:21,0,0,0,0.0,3,8,0,0,0,0,0,0,5.0,0:1,0,0,0,0.0,0:0,703333
8478427,Sebastian,Aho,1997-07-26,RW,L,2016-17,82,24,25,49,0.6,-1,214,11.21,26,82591.0,16:47,17,18,35,48.57,51,14,40,57,-17,6,11,17,10911.0,2:13,1,1,2,1074.0,0:13,925000
8478431,Evgeny,Svechnikov,1996-10-31,RW,L,2016-17,2,0,0,0,0.0,0,4,0.0,0,1577.0,13:8,0,0,0,0.0,2,1,0,1,-1,0,0,0,0.0,0:0,0,0,0,0.0,0:0,894167
8478432,Christian,Fischer,1997-04-15,RW,R,2016-17,7,3,0,3,0.43,0,10,30.0,0,5177.0,12:19,0,0,0,0.0,9,0,0,3,-3,0,0,0,0.0,0:0,0,0,0,93.0,0:13,852500
8478439,Travis,Konecny,1997-03-11,C,R,2016-17,70,11,17,28,0.4,-2,133,8.27,49,59180.0,14:5,0,5,5,0.0,92,26,26,28,-2,3,1,4,7085.0,1:41,0,0,0,76.0,0:1,894167
8478440,Dylan,Strome,1997-03-07,C,L,2016-17,7,0,1,1,0.14,-5,6,0.0,0,5747.0,13:41,31,46,77,40.26,3,2,3,0,3,0,0,0,862.0,2:3,0,0,0,10.0,0:1,894167
8478443,Brandon,Carlo,1996-11-26,D,R,2016-17,82,6,10,16,0.2,9,88,6.82,59,102414.0,20:48,0,0,0,0.0,87,115,21,42,-21,0,0,0,434.0,0:5,1,0,1,12871.0,2:36,789167
8478444,Brock,Boeser,1997-02-25,RW,R,2016-17,9,4,1,5,0.56,0,25,16.0,0,8755.0,16:12,0,0,0,0.0,5,0,1,4,-3,2,0,2,954.0,1:46,0,0,0,0.0,0:0,925000
8478458,Jack,Roslovic,1997-01-29,C,R,2016-17,1,0,0,0,0.0,-1,1,0.0,0,504.0,8:24,1,5,6,16.67,0,1,0,0,0,0,0,0,0.0,0:0,0,0,0,0.0,0:0,925000
8478460,Zach,Werenski,1997-07-19,D,L,2016-17,78,11,36,47,0.6,17,188,5.85,14,97864.0,20:54,0,0,0,0.0,41,90,27,40,-13,4,17,21,13055.0,2:47,0,0,0,3541.0,0:45,925000
8478463,Anthony,Beauvillier,1997-06-08,C,L,2016-17,66,9,15,24,0.36,1,101,8.91,10,51563.0,13:1,123,174,297,41.41,81,26,17,30,-13,0,1,1,1986.0,0:30,0,0,0,244.0,0:3,894167
8478469,Thomas,Chabot,1997-01-30,D,L,2016-17,1,0,0,0,0.0,-2,1,0.0,0,429.0,7:9,0,0,0,0.0,1,0,0,1,-1,0,0,0,0.0,0:0,0,0,0,0.0,0:0,894167
8478474,Lawson,Crouse,1997-06-23,LW,L,2016-17,72,5,7,12,0.17,-20,84,5.95,48,51358.0,11:53,1,1,2,50.0,160,29,14,5,9,0,0,0,111.0,0:1,1,0,1,6398.0,1:28,894167
8478480,Blake,Speers,1997-01-02,C,R,2016-17,3,0,0,0,0.0,0,3,0.0,0,1707.0,9:29,0,2,2,0.0,1,1,1,0,1,0,0,0,12.0,0:4,0,0,0,201.0,1:7,717500
8478483,Mitchell,Marner,1997-05-05,C,R,2016-17,77,19,42,61,0.79,0,176,10.8,38,77663.0,16:48,14,23,37,37.84,41,39,67,62,5,4,17,21,10995.0,2:22,0,0,0,613.0,0:7,894167
8478491,Jacob,Larsson,1997-04-29,D,L,2016-17,4,0,0,0,0.0,-1,2,0.0,2,3943.0,16:25,0,0,0,0.0,1,1,0,1,-1,0,0,0,259.0,1:4,0,0,0,492.0,2:3,925000
8478493,Joel,Eriksson Ek,1997-01-29,C,L,2016-17,15,3,4,7,0.47,1,15,20.0,4,9551.0,10:36,45,64,109,41.28,23,8,3,3,0,0,0,0,88.0,0:5,0,0,0,148.0,0:9,894166
8478500,Ivan,Provorov,1997-01-13,D,L,2016-17,82,6,24,30,0.37,-7,161,3.73,34,108132.0,21:58,0,0,0,0.0,111,166,23,81,-58,0,5,5,8344.0,1:41,0,0,0,13939.0,2:49,894167
8478506,Gabriel,Carlsson,1997-01-02,D,L,2016-17,2,0,1,1,0.5,-2,3,0.0,0,2055.0,17:7,0,0,0,0.0,5,2,0,0,0,0,0,0,0.0,0:0,0,0,0,44.0,0:22,925000
8478512,Austin,Czarnik,1992-12-12,C,R,2016-17,49,5,8,13,0.27,-10,66,7.58,12,38267.0,13:0,57,76,133,42.86,19,25,19,11,8,0,3,3,5145.0,1:45,0,0,0,3320.0,1:7,817500
8478528,Tanner,Kero,1992-07-24,C,L,2016-17,47,6,10,16,0.34,15,60,10.0,8,38030.0,13:29,209,262,471,44.37,41,51,14,11,3,0,0,0,284.0,0:6,0,0,0,4036.0,1:25,667500
8478541,Markus,Hannikainen,1993-03-26,LW,L,2016-17,10,1,1,2,0.2,0,8,12.5,6,5476.0,9:7,0,0,0,0.0,16,5,0,0,0,0,0,0,11.0,0:1,0,0,0,410.0,0:41,717500
8478542,Evan,Rodrigues,1993-07-28,LW,R,2016-17,30,4,2,6,0.2,-7,51,7.84,4,23265.0,12:55,104,146,250,41.6,12,12,12,9,3,1,0,1,334.0,0:11,0,0,0,1928.0,1:4,842500
8478550,Artemi,Panarin,1991-10-30,LW,R,2016-17,82,31,43,74,0.9,18,211,14.69,21,95798.0,19:28,2,8,10,20.0,23,14,57,55,2,9,8,17,15464.0,3:8,0,0,0,150.0,0:1,812500
8478561,Andreas,Martinsen,1990-06-13,LW,L,2016-17,64,3,4,7,0.11,-14,73,4.11,32,38220.0,9:57,3,1,4,75.0,173,28,25,11,14,0,0,0,292.0,0:4,0,1,1,3487.0,0:54,640000
8478562,Jakub,Nakladal,1987-12-30,D,R,2016-17,3,0,0,0,0.0,-4,3,0.0,0,2610.0,14:30,0,0,0,0.0,2,4,1,0,1,0,0,0,0.0,0:0,0,0,0,14.0,0:4,600000
8478566,Sergey,Kalinin,1991-03-17,C,L,2016-17,43,2,2,4,0.09,-14,38,5.26,15,33008.0,12:47,72,102,174,41.38,53,20,7,10,-3,0,0,0,1171.0,0:27,0,0,0,5093.0,1:58,800000
8478569,Noel,Acciari,1991-12-01,C,R,2016-17,29,2,3,5,0.17,3,24,8.33,16,18047.0,10:22,11,18,29,37.93,80,5,10,4,6,0,0,0,49.0,0:1,0,0,0,350.0,0:12,792500
8478585,Derek,Ryan,1986-12-29,C,R,2016-17,67,11,18,29,0.43,-8,73,15.07,22,59864.0,14:53,391,316,707,55.3,33,37,33,36,-3,4,4,8,8534.0,2:7,1,0,1,1768.0,0:26,600000
8478843,Denis,Malgin,1997-01-18,C,R,2016-17,47,6,4,10,0.21,-5,67,8.96,8,31692.0,11:14,67,117,184,36.41,34,15,17,11,6,2,0,2,3140.0,1:6,0,0,0,15.0,0:0,690000
8478851,Alexandre,Carrier,1996-10-08,D,R,2016-17,2,0,0,0,0.0,1,1,0.0,0,1247.0,10:23,0,0,0,0.0,0,1,0,0,0,0,0,0,0.0,0:0,0,0,0,1.0,0:0,668333
8478866,Dominik,Simon,1994-08-08,C,L,2016-17,2,0,1,1,0.5,-1,2,0.0,0,1565.0,13:2,0,0,0,0.0,2,0,1,1,0,0,0,0,57.0,0:28,0,0,0,0.0,0:0,692500
8478906,Markus,Nutivaara,1994-06-06,D,L,2016-17,66,2,5,7,0.11,7,66,3.03,6,52322.0,13:12,0,0,0,0.0,36,38,9,20,-11,0,0,0,678.0,0:10,0,0,0,102.0,0:1,817500
8478963,Ryan,Johnston,1992-02-14,D,R,2016-17,7,0,0,0,0.0,-3,3,0.0,4,4145.0,9:52,0,0,0,0.0,1,2,1,3,-2,0,0,0,0.0,0:0,0,0,0,0.0,0:0,680000
8479249,Andrew,Poturalski,1994-01-14,C,R,2016-17,2,0,0,0,0.0,-3,1,0.0,0,1472.0,12:16,12,12,24,50.0,1,1,1,0,1,0,0,0,22.0,0:11,0,0,0,0.0,0:0,858750
8479250,Nick,Lappin,1992-11-01,RW,R,2016-17,43,4,3,7,0.16,-17,57,7.02,17,30240.0,11:43,2,5,7,28.57,36,11,13,6,7,0,0,0,1145.0,0:26,0,0,0,697.0,0:16,842500
8479252,Dan,Renouf,1994-06-01,D,L,2016-17,1,0,0,0,0.0,0,1,0.0,0,815.0,13:35,0,0,0,0.0,3,0,0,0,0,0,0,0,0.0,0:0,0,0,0,0.0,0:0,767500
8479268,Casey,Nelson,1992-07-18,D,R,2016-17,11,0,0,0,0.0,-3,10,0.0,4,8319.0,12:36,0,0,0,0.0,15,5,0,1,-1,0,0,0,157.0,0:14,0,0,0,39.0,0:3,650000
8479290,Kalle,Kossila,1993-04-14,C,L,2016-17,1,0,0,0,0.0,0,1,0.0,0,414.0,6:54,3,4,7,42.86,1,0,0,0,0,0,0,0,0.0,0:0,0,0,0,0.0,0:0,925000
8479291,Kevin,Rooney,1993-05-21,C,L,2016-17,4,0,0,0,0.0,-3,2,0.0,4,2445.0,10:11,10,17,27,37.04,4,1,0,1,-1,0,0,0,15.0,0:3,0,0,0,36.0,0:9,796429
8479293,Brandon,Tanev,1991-12-31,LW,L,2016-17,51,2,2,4,0.08,-6,54,3.7,26,32672.0,10:40,1,0,1,100.0,128,31,19,9,10,0,0,0,37.0,0:0,0,0,0,5120.0,1:40,874125
8479314,Matthew,Tkachuk,1997-12-11,LW,L,2016-17,76,13,35,48,0.63,14,142,9.15,105,66854.0,14:39,8,15,23,34.78,65,22,40,27,13,3,10,13,9221.0,2:1,0,0,0,96.0,0:1,925000
8479318,Auston,Matthews,1997-09-17,C,L,2016-17,82,40,29,69,0.84,2,279,14.34,14,86745.0,17:37,530,602,1132,46.82,21,61,76,44,32,8,13,21,12088.0,2:27,0,0,0,88.0,0:1,925000
8479339,Patrik,Laine,1998-04-19,RW,R,2016-17,73,36,28,64,0.88,7,204,17.65,26,78457.0,17:54,0,3,3,0.0,80,33,43,55,-12,9,5,14,11958.0,2:43,0,0,0,85.0,0:1,925000
8479344,Jesse,Puljujarvi,1998-05-07,RW,R,2016-17,28,1,7,8,0.29,5,41,2.44,10,18907.0,11:15,0,1,1,0.0,11,10,12,10,2,1,0,1,1373.0,0:49,0,0,0,16.0,0:0,925000
8479345,Jakob,Chychrun,1998-03-31,D,L,2016-17,68,7,13,20,0.29,-14,86,8.14,47,68000.0,16:40,0,0,0,0.0,109,99,12,45,-33,1,1,2,2108.0,0:31,0,0,0,4655.0,1:8,925000
8479370,Tyson,Jost,1998-03-14,C,L,2016-17,6,1,0,1,0.17,-5,9,11.11,0,5643.0,15:40,28,42,70,40.0,3,3,3,1,2,0,0,0,636.0,1:46,0,0,0,338.0,0:56,916667
8479410,Mikhail,Sergachev,1998-06-25,D,L,2016-17,4,0,0,0,0.0,1,2,0.0,0,2910.0,12:7,0,0,0,0.0,10,3,1,3,-2,0,0,0,83.0,0:20,0,0,0,0.0,0:0,925000
8479423,Alexander,Nylander,1998-03-02,RW,R,2016-17,4,0,1,1,0.25,-2,4,0.0,0,2959.0,12:19,0,2,2,0.0,1,2,3,3,0,0,0,0,186.0,0:46,0,0,0,0.0,0:0,925000
8479442,Troy,Stecher,1994-04-07,D,R,2016-17,71,3,21,24,0.34,-16,125,2.4,25,85110.0,19:58,0,0,0,0.0,51,66,26,33,-7,1,7,8,11571.0,2:42,0,0,0,257.0,0:3,925000
8479458,Nikita,Zaitsev,1991-10-29,D,R,2016-17,82,4,32,36,0.44,-22,106,3.77,38,108332.0,22:1,0,0,0,0.0,176,136,33,58,-25,1,11,12,9854.0,2:0,0,1,1,8460.0,1:43,925000
8479465,Drake,Caggiula,1994-06-20,LW,L,2016-17,60,7,11,18,0.3,3,93,7.53,16,47647.0,13:14,117,167,284,41.2,97,19,22,25,-3,2,3,5,5944.0,1:39,0,1,1,2462.0,0:41,925000
8479482,Michal,Kempny,1990-09-08,D,L,2016-17,50,2,6,8,0.16,1,67,2.99,22,44898.0,14:57,0,0,0,0.0,76,59,6,26,-20,0,0,0,340.0,0:6,0,0,0,2029.0,0:40,700000
8479483,Yohann,Auvitu,1989-07-27,D,L,2016-17,25,2,2,4,0.16,1,54,3.7,2,23405.0,15:36,0,0,0,0.0,20,9,7,13,-6,0,1,1,3141.0,2:5,0,0,0,0.0,0:0,792500
8479648,Roman,Lyubimov,1992-01-06,LW,R,2016-17,47,4,2,6,0.13,-2,41,9.76,8,27011.0,9:34,1,6,7,14.29,28,16,12,5,7,0,0,0,149.0,0:3,0,0,0,1404.0,0:29,925000
8479969,Griffen,Molino,1994-01-21,C,L,2016-17,5,0,0,0,0.0,-2,3,0.0,0,3176.0,10:35,0,0,0,0.0,1,1,0,1,-1,0,0,0,0.0,0:0,0,0,0,0.0,0:0,925000
8480081,Michael,Kapla,1994-09-19,D,L,2016-17,5,0,0,0,0.0,-1,4,0.0,0,5232.0,17:26,0,0,0,0.0,5,5,2,3,-1,0,0,0,280.0,0:56,0,0,0,109.0,0:21,925000
8480083,C.J.,Smith,1994-12-01,LW,L,2016-17,2,0,1,1,0.5,-1,2,0.0,0,1384.0,11:32,0,0,0,0.0,0,0,2,2,0,0,0,0,37.0,0:18,0,0,0,0.0,0:0,925000
8480087,Mike,Vecchione,1993-02-25,C,R,2016-17,2,0,0,0,0.0,-1,1,0.0,0,1020.0,8:30,8,4,12,66.67,1,1,0,1,-1,0,0,0,16.0,0:8,0,0,0,0.0,0:0,2553000
8448208,Jaromir,Jagr,1972-02-15,RW,L,2017-18,22,1,6,7,0.32,6,32,3.12,10,17220.0,13:2,0,0,0,0.0,1,8,11,12,-1,0,1,1,2091.0,1:35,0,0,0,0.0,0:0,1000000
8464989,Matt,Cullen,1976-11-02,C,L,2017-18,79,11,11,22,0.28,-1,104,10.58,20,56369.0,11:53,355,350,705,50.35,14,42,14,17,-3,0,1,1,519.0,0:6,0,0,0,4125.0,0:52,1000000
8465009,Zdeno,Chara,1977-03-18,D,L,2017-18,73,7,17,24,0.33,22,144,4.86,60,100317.0,22:54,0,0,0,0.0,141,118,42,74,-32,0,0,0,1697.0,0:23,0,1,1,15991.0,3:39,4000000
8466138,Joe,Thornton,1979-07-02,C,L,2017-18,47,13,23,36,0.77,-9,75,17.33,38,51733.0,18:20,229,211,440,52.05,32,18,33,55,-22,7,11,18,10108.0,3:35,0,0,0,55.0,0:1,8000000
8466139,Patrick,Marleau,1979-09-15,C,L,2017-18,82,27,20,47,0.57,1,203,13.3,16,83580.0,16:59,157,144,301,52.16,85,26,28,33,-5,5,4,9,9795.0,1:59,0,0,0,1959.0,0:23,6250000
8466251,Jason,Chimera,1979-05-02,LW,L,2017-18,74,3,10,13,0.18,-12,79,3.8,37,45730.0,10:17,11,17,28,39.29,132,17,12,25,-13,0,0,0,241.0,0:3,0,0,0,2335.0,0:31,2250000
8467370,Mike,Fisher,1980-06-05,C,R,2017-18,16,2,2,4,0.25,0,14,14.29,8,11851.0,12:20,107,77,184,58.15,25,14,8,5,3,0,0,0,26.0,0:1,0,0,0,1590.0,1:39,1000000
8467400,Francois,Beauchemin,1980-06-04,D,L,2017-18,67,3,14,17,0.25,12,93,3.23,26,69593.0,17:18,0,0,0,0.0,102,121,11,47,-36,0,2,2,2086.0,0:31,0,1,1,6754.0,1:40,4500000
8467407,Brian,Gionta,1979-01-18,RW,R,2017-18,20,2,5,7,0.35,-1,42,4.76,2,15681.0,13:4,6,7,13,46.15,17,6,5,1,4,1,2,3,2278.0,1:53,0,0,0,403.0,0:20,700000
8467875,Daniel,Sedin,1980-09-26,LW,L,2017-18,81,23,32,55,0.68,-21,189,12.17,40,74214.0,15:16,18,22,40,45.0,38,2,17,37,-20,9,14,23,14046.0,2:53,0,0,0,58.0,0:0,7000000
8467876,Henrik,Sedin,1980-09-26,C,L,2017-18,82,3,47,50,0.61,-22,67,4.48,30,76498.0,15:32,438,504,942,46.5,18,19,10,28,-18,0,17,17,14259.0,2:53,0,0,0,55.0,0:0,7000000
8467967,Chris,Kelly,1980-11-11,C,L,2017-18,12,0,2,2,0.17,1,5,0.0,2,5516.0,7:39,2,7,9,22.22,7,6,0,1,-1,0,0,0,0.0,0:0,0,0,0,458.0,0:38,1250000
8468001,Derek,MacKenzie,1981-06-11,C,L,2017-18,75,3,11,14,0.19,-9,86,3.49,31,50886.0,11:18,315,290,605,52.07,124,45,24,14,10,0,0,0,180.0,0:2,1,3,4,10355.0,2:18,1375000
8468083,Henrik,Zetterberg,1980-10-09,C,L,2017-18,82,11,45,56,0.68,1,180,6.11,14,95924.0,19:29,666,709,1375,48.44,49,34,51,57,-6,1,17,18,12923.0,2:37,0,0,0,66.0,0:0,6083333
8468085,Radim,Vrbata,1981-06-13,RW,R,2017-18,42,5,9,14,0.33,-7,88,5.68,16,32521.0,12:54,7,14,21,33.33,15,16,22,18,4,2,2,4,3312.0,1:18,0,0,0,4.0,0:0,2500000
8468208,Joel,Ward,1980-12-02,RW,R,2017-18,52,5,7,12,0.23,-2,40,12.5,20,37047.0,11:52,107,124,231,46.32,35,27,21,13,8,0,0,0,744.0,0:14,0,0,0,3351.0,1:4,3275000
8468309,Mark,Streit,1977-12-11,D,L,2017-18,2,0,0,0,0.0,-2,3,0.0,0,1706.0,14:13,0,0,0,0.0,2,0,0,0,0,0,0,0,250.0,2:5,0,0,0,0.0,0:0,700000
8468483,Marian,Gaborik,1982-02-14,RW,L,2017-18,46,11,10,21,0.46,2,80,13.75,24,38566.0,13:58,0,0,0,0.0,12,9,13,20,-7,3,3,6,5136.0,1:51,0,0,0,124.0,0:2,4875000
8468486,Scott,Hartnell,1982-04-18,LW,L,2017-18,62,13,11,24,0.39,-3,82,15.85,82,44707.0,12:1,3,12,15,20.0,82,25,14,25,-11,2,3,5,4545.0,1:13,0,0,0,34.0,0:0,4750000
8468493,Ron,Hainsey,1981-03-24,D,L,2017-18,80,4,19,23,0.29,12,73,5.48,20,104951.0,21:51,0,0,0,0.0,91,169,18,85,-67,1,0,1,659.0,0:8,0,2,2,19109.0,3:58,3000000
8468498,Brooks,Orpik,1980-09-26,D,L,2017-18,81,0,10,10,0.12,-9,54,0.0,68,94113.0,19:21,0,0,0,0.0,218,168,17,44,-27,0,0,0,111.0,0:1,0,0,0,15133.0,3:6,5500000
8468508,Justin,Williams,1981-10-04,RW,R,2017-18,82,16,35,51,0.62,-9,198,8.08,56,81613.0,16:35,52,64,116,44.83,79,42,46,85,-39,2,10,12,10505.0,2:8,0,0,0,59.0,0:0,4500000
8468509,Niklas,Kronwall,1981-01-12,D,L,2017-18,79,4,23,27,0.34,-14,76,5.26,36,87794.0,18:31,0,0,0,0.0,82,107,14,52,-38,2,13,15,10995.0,2:19,0,0,0,2019.0,0:25,4750000
8468535,Antoine,Vermette,1982-07-20,C,L,2017-18,64,8,8,16,0.25,-5,91,8.79,34,52799.0,13:44,609,406,1015,60.0,38,40,14,17,-3,2,0,2,4643.0,1:12,0,1,1,2978.0,0:46,1750000
8468542,Paul,Martin,1981-03-05,D,L,2017-18,14,0,2,2,0.14,3,6,0.0,2,12399.0,14:45,0,0,0,0.0,8,17,9,7,2,0,0,0,18.0,0:1,0,0,0,105.0,0:7,4850000
8468575,Dominic,Moore,1980-08-03,C,L,2017-18,50,6,6,12,0.24,3,46,13.04,16,30892.0,10:17,196,165,361,54.29,41,19,19,19,0,0,0,0,155.0,0:3,0,1,1,3673.0,1:13,1000000
8468611,Matt,Hendricks,1981-06-17,C,L,2017-18,60,5,8,13,0.22,-1,56,8.93,39,33927.0,9:25,226,232,458,49.34,123,42,16,12,4,0,0,0,223.0,0:3,0,0,0,7161.0,1:59,700000
8468674,Deryk,Engelland,1982-04-03,D,R,2017-18,79,5,18,23,0.29,6,108,4.63,24,96128.0,20:16,0,0,0,0.0,126,150,25,53,-28,0,0,0,384.0,0:4,0,0,0,14023.0,2:57,1000000
8469455,Jason,Spezza,1983-06-13,C,R,2017-18,78,8,18,26,0.33,-14,138,5.8,12,60868.0,13:0,417,330,747,55.82,16,26,12,36,-24,4,7,11,9331.0,1:59,0,0,0,153.0,0:1,7500000
8469459,Mikko,Koivu,1983-03-12,C,L,2017-18,82,14,31,45,0.55,9,170,8.24,46,90957.0,18:29,809,766,1575,51.37,51,53,44,23,21,3,11,14,12239.0,2:29,0,1,1,10086.0,2:3,6750000
8469465,Dan,Hamhuis,1982-12-13,D,L,2017-18,80,3,21,24,0.3,-7,66,4.55,33,96903.0,20:11,0,1,1,0.0,82,113,13,30,-17,0,2,2,1643.0,0:20,0,0,0,12780.0,2:39,3750000
8469466,Ales,Hemsky,1983-08-13,RW,R,2017-18,7,0,0,0,0.0,-1,5,0.0,10,4167.0,9:55,0,1,1,0.0,0,2,1,3,-2,0,0,0,1082.0,2:34,0,0,0,7.0,0:1,1000000
8469500,Michael,Cammalleri,1982-06-08,LW,L,2017-18,66,7,22,29,0.44,-3,128,5.47,18,54536.0,13:46,77,67,144,53.47,43,32,22,36,-14,3,1,4,5492.0,1:23,0,0,0,1067.0,0:16,5000000
8469501,Chris,Thorburn,1983-06-03,RW,R,2017-18,50,1,6,7,0.14,-4,35,2.86,60,21115.0,7:2,7,5,12,58.33,99,16,5,6,-1,0,0,0,68.0,0:1,0,0,0,16.0,0:0,900000
8469506,Jason,Pominville,1982-11-30,RW,R,2017-18,82,16,18,34,0.41,-17,168,9.52,8,73323.0,14:54,33,24,57,57.89,39,35,22,20,2,5,2,7,9412.0,1:54,0,0,0,117.0,0:1,5600000
8469521,Tomas,Plekanec,1982-10-31,C,L,2017-18,77,6,20,26,0.34,1,144,4.17,45,69929.0,15:8,659,577,1236,53.32,61,41,29,51,-22,0,0,0,722.0,0:9,0,0,0,9148.0,1:58,6000000
8469544,Patrick,Sharp,1981-12-27,LW,R,2017-18,70,10,11,21,0.3,-16,143,6.99,14,54111.0,12:53,53,43,96,55.21,46,25,16,13,3,0,4,4,6566.0,1:33,0,0,0,159.0,0:2,800000
8469598,Kevin,Bieksa,1981-06-16,D,R,2017-18,59,0,8,8,0.14,-13,66,0.0,83,63786.0,18:1,0,0,0,0.0,116,81,12,41,-29,0,2,2,1715.0,0:29,0,0,0,6818.0,1:55,4000000
8469619,Dennis,Seidenberg,1981-07-18,D,L,2017-18,28,0,5,5,0.18,-9,31,0.0,17,30043.0,17:52,0,0,0,0.0,65,43,2,18,-16,0,0,0,73.0,0:2,0,0,0,4047.0,2:24,4000000
8469638,Jussi,Jokinen,1983-04-01,LW,L,2017-18,60,5,12,17,0.28,2,73,6.85,12,41672.0,11:34,101,86,187,54.01,21,22,18,16,2,0,5,5,2849.0,0:47,0,0,0,2537.0,0:42,4000000
8469639,Brooks,Laich,1983-06-23,C,L,2017-18,12,0,1,1,0.08,-5,10,0.0,6,8059.0,11:11,53,56,109,48.62,22,5,4,2,2,0,0,0,27.0,0:2,0,0,0,1028.0,1:25,650000
8469665,Johnny,Oduya,1981-10-01,D,L,2017-18,52,4,4,8,0.15,1,59,6.78,32,53383.0,17:6,0,0,0,0.0,50,76,16,34,-18,0,0,0,105.0,0:2,0,0,0,6129.0,1:57,1000000
8470041,Rick,Nash,1984-06-16,LW,L,2017-18,71,21,13,34,0.48,-12,230,9.13,28,72654.0,17:3,4,15,19,21.05,51,42,58,38,20,5,2,7,10056.0,2:21,0,0,0,6938.0,1:37,7800000
8470047,Valtteri,Filppula,1984-03-20,C,L,2017-18,81,11,22,33,0.41,-7,70,15.71,20,80077.0,16:28,487,463,950,51.26,25,55,36,37,-1,3,1,4,7479.0,1:32,0,2,2,6279.0,1:17,5000000
8470105,Scottie,Upshall,1983-10-07,RW,L,2017-18,63,7,12,19,0.3,-1,71,9.86,46,41027.0,10:51,8,7,15,53.33,119,24,18,9,9,0,0,0,201.0,0:3,0,0,0,5159.0,1:21,800000
8470110,Trevor,Daley,1983-10-09,D,L,2017-18,77,9,7,16,0.21,-5,103,8.74,36,95616.0,20:41,0,0,0,0.0,24,125,11,50,-39,0,0,0,2815.0,0:36,1,2,3,12920.0,2:47,3166666
8470144,Frans,Nielsen,1984-04-24,C,L,2017-18,79,16,17,33,0.42,1,134,11.94,14,75023.0,15:49,483,558,1041,46.4,49,62,29,25,4,4,3,7,4155.0,0:52,2,1,3,10144.0,2:8,5250000
8470151,Jay,Bouwmeester,1983-09-27,D,L,2017-18,35,2,5,7,0.2,5,45,4.44,16,42287.0,20:8,0,0,0,0.0,29,58,5,14,-9,0,0,0,86.0,0:2,0,0,0,4540.0,2:9,5400000
8470162,Matt,Stajan,1983-12-19,C,L,2017-18,68,4,8,12,0.18,4,65,6.15,28,44614.0,10:56,248,234,482,51.45,74,31,20,16,4,0,0,0,244.0,0:3,0,0,0,6282.0,1:32,3125000
8470187,Johnny,Boychuk,1984-01-19,D,R,2017-18,58,6,12,18,0.31,-8,141,4.26,30,70268.0,20:11,0,0,0,0.0,114,112,15,46,-31,2,0,2,1900.0,0:32,0,0,0,9011.0,2:35,6000000
8470257,Alexander,Steen,1984-03-01,LW,L,2017-18,76,15,31,46,0.61,-11,168,8.93,20,85244.0,18:41,24,35,59,40.68,53,58,34,19,15,4,10,14,13339.0,2:55,1,0,1,5611.0,1:13,5750000
8470281,Duncan,Keith,1983-07-16,D,L,2017-18,82,2,30,32,0.39,-29,187,1.07,28,117229.0,23:49,0,0,0,0.0,41,165,34,73,-39,2,8,10,12771.0,2:35,0,0,0,11943.0,2:25,5538462
8470318,Jonathan,Ericsson,1984-03-02,D,L,2017-18,81,3,10,13,0.16,-7,86,3.49,47,93839.0,19:18,1,0,1,100.0,133,84,13,70,-57,0,0,0,433.0,0:5,0,1,1,12716.0,2:36,4250000
8470324,Josh,Gorges,1984-08-14,D,L,2017-18,34,0,2,2,0.06,-4,15,0.0,17,30478.0,14:56,0,0,0,0.0,69,54,3,7,-4,0,0,0,59.0,0:1,0,0,0,3902.0,1:54,3900000
8470358,Alexandre,Burrows,1981-04-11,RW,L,2017-18,71,6,8,14,0.2,-8,90,6.67,59,49798.0,11:41,8,22,30,26.67,65,32,7,14,-7,2,1,3,5905.0,1:23,0,0,0,3373.0,0:47,2500000
8470543,Chris,Kunitz,1979-09-26,LW,L,2017-18,82,13,16,29,0.35,8,81,16.05,35,58776.0,11:56,7,12,19,36.84,131,30,38,29,9,0,1,1,1168.0,0:14,1,0,1,3199.0,0:39,2000000
8470595,Eric,Staal,1984-10-29,C,L,2017-18,82,42,34,76,0.93,8,241,17.43,42,87635.0,17:48,571,544,1115,51.21,42,49,48,26,22,11,6,17,10741.0,2:10,2,1,3,5327.0,1:4,3500000
8470598,Thomas,Vanek,1984-01-19,LW,R,2017-18,80,24,32,56,0.7,-3,168,14.29,36,67621.0,14:5,6,18,24,25.0,36,18,28,35,-7,4,11,15,9558.0,1:59,0,0,0,36.0,0:0,2000000
8470600,Ryan,Suter,1985-01-21,D,L,2017-18,78,6,45,51,0.65,-1,149,4.03,34,125318.0,26:46,0,0,0,0.0,78,138,14,37,-23,1,22,23,14453.0,3:5,0,1,1,14045.0,3:0,7538462
8470601,Braydon,Coburn,1985-02-27,D,L,2017-18,72,1,14,15,0.21,3,73,1.37,40,69223.0,16:1,0,0,0,0.0,77,75,11,23,-12,0,0,0,122.0,0:1,0,0,0,9068.0,2:5,3700000
8470602,Dion,Phaneuf,1985-04-10,D,L,2017-18,79,6,20,26,0.33,-15,134,4.48,49,94786.0,19:59,0,0,0,0.0,161,154,20,52,-32,4,7,11,9315.0,1:57,0,0,0,7117.0,1:30,7000000
8470604,Jeff,Carter,1985-01-01,C,R,2017-18,27,13,9,22,0.81,4,85,15.29,2,28905.0,17:50,222,176,398,55.78,27,11,7,9,-2,6,3,9,5121.0,3:9,1,0,1,2155.0,1:19,5272727
8470606,Dustin,Brown,1984-11-04,RW,R,2017-18,81,28,33,61,0.75,31,222,12.61,58,96405.0,19:50,17,29,46,36.96,189,33,40,55,-15,9,6,15,13209.0,2:43,1,0,1,8968.0,1:50,5875000
8470607,Brent,Seabrook,1985-04-20,D,R,2017-18,81,7,19,26,0.32,-3,136,5.15,38,98159.0,20:11,0,2,2,0.0,85,170,25,71,-46,2,6,8,10270.0,2:6,0,0,0,10357.0,2:7,6875000
8470609,Steve,Bernier,1985-03-31,RW,R,2017-18,4,0,0,0,0.0,-2,4,0.0,0,2413.0,10:3,2,2,4,50.0,11,1,0,0,0,0,0,0,312.0,1:18,0,0,0,0.0,0:0,650000
8470610,Zach,Parise,1984-07-28,LW,L,2017-18,42,15,9,24,0.57,0,119,12.61,14,43049.0,17:4,5,7,12,41.67,26,37,15,14,1,2,1,3,6064.0,2:24,0,0,0,1731.0,0:41,7538462
8470611,Eric,Fehr,1985-09-07,C,R,2017-18,18,3,1,4,0.22,6,27,11.11,2,12724.0,11:46,66,73,139,47.48,24,14,6,4,2,0,0,0,35.0,0:1,0,0,0,1663.0,1:32,2000000
8470612,Ryan,Getzlaf,1985-05-10,C,R,2017-18,56,11,50,61,1.09,20,117,9.4,42,71990.0,21:25,406,443,849,47.82,96,57,45,64,-19,0,13,13,9474.0,2:49,1,1,2,3563.0,1:3,8250000
8470613,Brent,Burns,1985-03-09,D,R,2017-18,82,12,55,67,0.82,-16,332,3.61,46,124194.0,25:14,0,0,0,0.0,79,136,75,124,-49,5,22,27,18084.0,3:40,0,1,1,7422.0,1:30,8000000
8470616,Ryan,Kesler,1984-08-31,C,R,2017-18,44,8,6,14,0.32,-4,78,10.26,46,47612.0,18:2,400,350,750,53.33,71,38,13,21,-8,2,0,2,3911.0,1:28,0,0,0,5856.0,2:13,6875000
8470619,Brian,Boyle,1984-12-18,C,L,2017-18,69,13,10,23,0.33,-9,120,10.83,45,55026.0,13:17,420,412,832,50.48,126,26,19,18,1,5,2,7,8502.0,2:3,0,0,0,1103.0,0:15,2550000
8470621,Corey,Perry,1985-05-16,RW,R,2017-18,71,17,32,49,0.69,-4,168,10.12,71,75730.0,17:46,2,14,16,12.5,59,36,18,42,-24,4,7,11,11350.0,2:39,0,0,0,125.0,0:1,8625000
8470622,Patrick,Eaves,1984-05-01,RW,R,2017-18,2,1,0,1,0.5,0,3,33.33,0,1975.0,16:27,0,1,1,0.0,5,1,0,0,0,0,0,0,406.0,3:23,0,0,0,0.0,0:0,3150000
8470626,Loui,Eriksson,1985-07-17,LW,L,2017-18,50,10,13,23,0.46,0,101,9.9,4,48808.0,16:16,6,8,14,42.86,7,30,25,9,16,0,3,3,4202.0,1:24,1,1,2,6886.0,2:17,6000000
8470638,Patrice,Bergeron,1985-07-24,C,R,2017-18,64,30,33,63,0.98,21,224,13.39,26,74640.0,19:26,784,584,1368,57.31,48,42,55,42,13,10,11,21,11373.0,2:57,2,1,3,6977.0,1:49,6875000
8470642,Shea,Weber,1985-08-14,D,R,2017-18,26,6,10,16,0.62,-8,75,8.0,14,39543.0,25:20,0,0,0,0.0,66,59,7,31,-24,2,3,5,5628.0,3:36,0,1,1,4776.0,3:3,7857143
8470655,David,Backes,1984-05-01,RW,R,2017-18,57,14,19,33,0.58,2,160,8.75,53,52652.0,15:23,125,117,242,51.65,137,25,31,21,10,2,4,6,6715.0,1:57,0,1,1,692.0,0:12,6000000
8470724,Kyle,Quincey,1985-08-12,D,L,2017-18,18,0,3,3,0.17,-4,11,0.0,28,15418.0,14:16,0,0,0,0.0,21,18,6,16,-10,0,0,0,19.0,0:1,0,0,0,2733.0,2:31,1250000
8470740,Lee,Stempniak,1983-02-04,RW,R,2017-18,37,3,6,9,0.24,-8,41,7.32,4,27688.0,12:28,3,11,14,21.43,40,11,17,23,-6,1,0,1,236.0,0:6,0,0,0,886.0,0:23,2500000
8470755,Brad,Richardson,1985-02-04,C,L,2017-18,76,3,12,15,0.2,-23,105,2.86,45,67373.0,14:46,543,500,1043,52.06,72,52,24,15,9,0,0,0,422.0,0:5,0,0,0,9480.0,2:4,2083333
8470760,Marc,Methot,1985-06-21,D,L,2017-18,36,1,2,3,0.08,11,25,4.0,31,38628.0,17:53,0,0,0,0.0,77,52,1,11,-10,0,0,0,131.0,0:3,0,0,0,4615.0,2:8,4900000
8470775,Nate,Thompson,1984-10-05,C,L,2017-18,69,5,12,17,0.25,-1,53,9.43,20,52858.0,12:46,360,278,638,56.43,122,39,21,15,6,0,0,0,188.0,0:2,1,0,1,8479.0,2:2,1650000
8470794,Joe,Pavelski,1984-07-11,C,R,2017-18,82,22,44,66,0.8,0,224,9.82,41,94737.0,19:15,500,411,911,54.88,93,70,44,55,-11,7,16,23,15709.0,3:11,0,0,0,1429.0,0:17,6000000
8470803,Kyle,Brodziak,1984-05-25,C,R,2017-18,81,10,23,33,0.41,13,113,8.85,33,65429.0,13:27,504,463,967,52.12,83,55,52,18,34,0,0,0,359.0,0:4,1,2,3,8517.0,1:45,950000
8470828,Toby,Enstrom,1984-11-05,D,L,2017-18,43,1,5,6,0.14,8,31,3.23,20,43941.0,17:1,0,0,0,0.0,20,51,3,31,-28,0,0,0,246.0,0:5,0,0,0,1587.0,0:36,5750000
8470834,Dustin,Byfuglien,1985-03-27,D,R,2017-18,69,8,37,45,0.65,15,193,4.15,112,100763.0,24:20,0,0,0,0.0,147,100,34,79,-45,4,18,22,12687.0,3:3,0,1,1,5276.0,1:16,7600000
8470852,Matt,Moulson,1983-11-01,LW,L,2017-18,14,0,0,0,0.0,-9,13,0.0,2,8641.0,10:17,0,0,0,0.0,8,8,1,1,0,0,0,0,1272.0,1:30,0,0,0,22.0,0:1,5000000
8470854,Tanner,Glass,1983-11-29,LW,L,2017-18,16,0,0,0,0.0,-4,14,0.0,19,9005.0,9:22,2,4,6,33.33,35,7,2,0,2,0,0,0,28.0,0:1,0,0,0,852.0,0:53,650000
8470966,Mark,Giordano,1983-10-03,D,L,2017-18,82,13,25,38,0.46,0,214,6.07,63,121955.0,24:47,0,0,0,0.0,93,161,50,46,4,1,9,10,15427.0,3:8,1,0,1,15255.0,3:6,6750000
8471214,Alex,Ovechkin,1985-09-17,LW,R,2017-18,82,49,38,87,1.06,3,355,13.8,32,99110.0,20:8,3,5,8,37.5,139,21,25,71,-46,17,14,31,20691.0,4:12,0,0,0,148.0,0:1,9538462
8471215,Evgeni,Malkin,1986-07-31,C,L,2017-18,78,42,56,98,1.26,16,239,17.57,87,88873.0,18:59,460,592,1052,43.73,48,32,75,73,2,14,24,38,17182.0,3:40,0,0,0,327.0,0:4,9500000
8471217,Andrew,Ladd,1985-12-12,LW,L,2017-18,73,12,17,29,0.4,11,112,10.71,24,69612.0,15:53,1,9,10,10.0,76,40,29,40,-11,0,1,1,7620.0,1:44,1,1,2,5449.0,1:14,5500000
8471218,Blake,Wheeler,1986-08-31,RW,R,2017-18,81,23,68,91,1.12,13,246,9.35,52,98447.0,20:15,166,196,362,45.86,94,66,34,55,-21,6,34,40,15287.0,3:8,0,2,2,6193.0,1:16,5600000
8471226,Drew,Stafford,1985-10-30,RW,R,2017-18,59,8,7,15,0.25,-20,102,7.84,10,49062.0,13:51,41,40,81,50.62,77,15,16,14,2,4,1,5,6742.0,1:54,0,0,0,85.0,0:1,800000
8471228,Alexander,Radulov,1986-07-05,RW,L,2017-18,82,27,45,72,0.88,5,217,12.44,72,99029.0,20:7,6,4,10,60.0,77,64,46,50,-4,7,16,23,16326.0,3:19,0,0,0,100.0,0:1,6250000
8471233,Travis,Zajac,1985-05-13,C,R,2017-18,63,12,14,26,0.41,-8,91,13.19,25,67692.0,17:54,557,537,1094,50.91,64,38,42,15,27,2,4,6,6978.0,1:50,1,1,2,8815.0,2:19,5750000
8471242,Mike,Green,1985-10-12,D,R,2017-18,66,8,25,33,0.5,-14,132,6.06,38,87445.0,22:4,0,0,0,0.0,78,74,29,68,-39,1,12,13,9322.0,2:21,0,0,0,573.0,0:8,6000000
8471260,Blake,Comeau,1986-02-18,LW,R,2017-18,79,13,21,34,0.43,5,123,10.57,50,75235.0,15:52,104,167,271,38.38,145,38,47,29,18,0,0,0,373.0,0:4,3,0,3,11954.0,2:31,2400000
8471262,Carl,Soderberg,1985-10-12,C,L,2017-18,77,16,21,37,0.48,0,150,10.67,26,80171.0,17:21,425,514,939,45.26,71,64,41,14,27,3,2,5,8810.0,1:54,0,1,1,11176.0,2:25,4750000
8471266,David,Booth,1984-11-24,LW,L,2017-18,28,4,1,5,0.18,-5,33,12.12,10,11711.0,6:58,4,6,10,40.0,23,7,0,9,-9,0,1,1,197.0,0:7,0,0,0,76.0,0:2,700000
8471273,Brandon,Dubinsky,1986-04-29,C,L,2017-18,62,6,10,16,0.26,-2,89,6.74,33,57072.0,15:20,521,431,952,54.73,145,47,25,12,13,0,1,1,1177.0,0:18,1,1,2,5934.0,1:35,5850000
8471274,Alex,Goligoski,1985-07-30,D,L,2017-18,78,12,23,35,0.45,-31,119,10.08,26,108938.0,23:16,0,0,0,0.0,114,154,16,66,-50,3,8,11,9048.0,1:56,0,0,0,8984.0,1:55,5475000
8471276,David,Krejci,1986-04-28,C,R,2017-18,64,17,27,44,0.69,10,119,14.29,18,64803.0,16:52,502,465,967,51.91,31,35,25,30,-5,7,6,13,8518.0,2:13,0,0,0,1009.0,0:15,7250000
8471284,Andrej,Sekera,1986-06-08,D,L,2017-18,36,0,8,8,0.22,-15,36,0.0,6,35274.0,16:19,0,0,0,0.0,27,42,11,18,-7,0,2,2,2101.0,0:58,0,0,0,2755.0,1:16,5500000
8471296,Alexei,Emelin,1986-04-25,D,L,2017-18,76,1,8,9,0.12,9,59,1.69,40,76979.0,16:52,1,0,1,100.0,181,109,20,39,-19,0,0,0,168.0,0:2,0,0,0,7447.0,1:37,4100000
8471303,Alexander,Edler,1986-04-21,D,L,2017-18,70,6,28,34,0.49,-18,172,3.49,68,101965.0,24:16,1,1,2,50.0,157,203,31,56,-25,1,14,15,11824.0,2:48,0,0,0,11243.0,2:40,5000000
8471338,Torrey,Mitchell,1985-01-30,C,R,2017-18,60,6,5,11,0.18,-5,55,10.91,30,41049.0,11:24,194,197,391,49.62,53,29,7,18,-11,0,0,0,108.0,0:1,0,1,1,5500.0,1:31,1200000
8471339,Ryan,Callahan,1985-03-21,RW,R,2017-18,67,5,13,18,0.27,-4,104,4.81,29,53551.0,13:19,27,39,66,40.91,138,40,26,16,10,1,1,2,3580.0,0:53,1,1,2,5834.0,1:27,5800000
8471346,Kris,Versteeg,1986-05-13,RW,R,2017-18,24,3,5,8,0.33,-8,49,6.12,6,18983.0,13:10,46,32,78,58.97,6,6,14,20,-6,1,4,5,4470.0,3:6,0,0,0,0.0,0:0,1750000
8471392,Roman,Polak,1986-04-28,D,R,2017-18,54,2,10,12,0.22,5,47,4.26,46,57163.0,17:38,0,0,0,0.0,131,84,5,32,-27,0,0,0,30.0,0:0,0,0,0,8116.0,2:30,1100000
8471426,Troy,Brouwer,1985-08-17,RW,R,2017-18,76,6,16,22,0.29,-7,79,7.59,53,63527.0,13:55,101,116,217,46.54,125,42,28,31,-3,0,5,5,5632.0,1:14,0,1,1,9426.0,2:4,4500000
8471436,Matt,Hunwick,1985-05-21,D,L,2017-18,42,4,6,10,0.24,-4,52,7.69,21,44127.0,17:30,0,0,0,0.0,51,53,14,20,-6,0,0,0,191.0,0:4,1,0,1,5188.0,2:3,2250000
8471476,Daniel,Winnik,1985-03-06,LW,L,2017-18,81,6,17,23,0.28,5,82,7.32,27,65940.0,13:34,89,110,199,44.72,27,53,23,10,13,0,1,1,266.0,0:3,0,0,0,8809.0,1:48,660000
8471490,Adam,Cracknell,1985-07-15,RW,R,2017-18,5,0,0,0,0.0,-1,6,0.0,0,2313.0,7:42,3,3,6,50.0,12,1,3,2,1,0,0,0,0.0,0:0,0,0,0,283.0,0:56,675000
8471498,Jannik,Hansen,1986-03-15,RW,R,2017-18,46,2,13,15,0.33,2,54,3.7,15,33233.0,12:2,8,4,12,66.67,38,19,25,27,-2,0,0,0,216.0,0:4,0,1,1,2097.0,0:45,2500000
8471657,Cody,McLeod,1984-06-26,LW,L,2017-18,48,1,3,4,0.08,-11,36,2.78,111,21264.0,7:23,0,0,0,0.0,131,19,2,6,-4,0,0,0,25.0,0:0,0,0,0,15.0,0:0,1333333
8471663,Mike,Blunden,1986-12-15,RW,R,2017-18,1,0,0,0,0.0,0,1,0.0,0,391.0,6:31,0,0,0,0.0,6,0,0,0,0,0,0,0,0.0,0:0,0,0,0,0.0,0:0,737500
8471669,Paul,Stastny,1985-12-27,C,L,2017-18,82,16,37,53,0.65,1,159,10.06,18,90059.0,18:18,832,683,1515,54.92,43,38,43,19,24,3,6,9,12972.0,2:38,0,1,1,4865.0,0:59,7000000
8471675,Sidney,Crosby,1987-08-07,C,L,2017-18,82,29,60,89,1.09,0,247,11.74,46,101791.0,20:41,1026,909,1935,53.02,75,36,42,76,-34,9,29,38,17960.0,3:39,0,0,0,1266.0,0:15,8700000
8471676,Bobby,Ryan,1987-03-17,RW,R,2017-18,62,11,22,33,0.53,-12,112,9.82,14,61163.0,16:26,12,10,22,54.55,97,52,24,37,-13,1,3,4,10074.0,2:42,0,0,0,30.0,0:0,7250000
8471677,Jack,Johnson,1987-01-13,D,L,2017-18,77,3,8,11,0.14,-6,88,3.41,22,90304.0,19:32,0,0,0,0.0,101,135,20,23,-3,0,0,0,666.0,0:8,0,0,0,9664.0,2:5,4357143
8471678,Benoit,Pouliot,1986-09-29,LW,L,2017-18,74,13,6,19,0.26,-8,83,15.66,22,60751.0,13:40,12,21,33,36.36,69,34,35,31,4,1,0,1,2818.0,0:38,2,0,2,7415.0,1:40,4000000
8471685,Anze,Kopitar,1987-08-24,C,L,2017-18,82,35,57,92,1.12,21,200,17.5,20,108658.0,22:5,983,833,1816,54.13,50,64,54,70,-16,7,20,27,14202.0,2:53,0,2,2,10685.0,2:10,10000000
8471686,Marc,Staal,1987-01-13,D,L,2017-18,72,1,7,8,0.11,11,68,1.47,18,80059.0,18:31,0,0,0,0.0,76,96,32,43,-11,0,0,0,166.0,0:2,0,0,0,12202.0,2:49,5700000
8471691,Martin,Hanzal,1987-02-20,C,L,2017-18,38,5,5,10,0.26,-16,62,8.06,23,32168.0,14:6,239,195,434,55.07,66,21,10,10,0,2,1,3,3791.0,1:39,0,0,0,3923.0,1:43,4750000
8471698,T.J.,Oshie,1986-12-23,RW,R,2017-18,74,18,29,47,0.64,2,127,14.17,31,81747.0,18:24,101,110,211,47.87,124,54,51,39,12,9,9,18,14945.0,3:21,0,0,0,3487.0,0:47,5750000
8471699,Andrew,Cogliano,1987-06-14,LW,L,2017-18,80,12,23,35,0.44,19,175,6.86,41,72970.0,15:12,35,36,71,49.3,80,31,24,41,-17,0,0,0,519.0,0:6,3,1,4,8251.0,1:43,3000000
8471702,Matt,Niskanen,1986-12-06,D,R,2017-18,68,7,22,29,0.43,24,120,5.83,36,92237.0,22:36,0,0,0,0.0,117,98,18,73,-55,0,0,0,2088.0,0:30,0,1,1,11099.0,2:43,5750000
8471707,James,Neal,1987-09-03,LW,L,2017-18,71,25,19,44,0.62,-11,202,12.38,24,73166.0,17:10,0,2,2,0.0,44,30,49,32,17,5,4,9,10430.0,2:26,0,0,0,135.0,0:1,5000000
8471709,Marc-Edouard,Vlasic,1987-03-30,D,L,2017-18,81,11,21,32,0.4,9,161,6.83,34,109586.0,22:32,0,1,1,0.0,26,174,20,55,-35,1,2,3,5477.0,1:7,0,1,1,13683.0,2:48,4250000
8471710,Taylor,Chorney,1987-04-27,D,L,2017-18,25,1,3,4,0.16,10,14,7.14,8,19707.0,13:8,0,0,0,0.0,21,31,4,12,-8,0,0,0,0.0,0:0,0,1,1,2601.0,1:44,800000
8471716,Justin,Abdelkader,1987-02-25,LW,L,2017-18,75,13,22,35,0.47,-11,110,11.82,78,74479.0,16:33,47,50,97,48.45,174,40,21,34,-13,4,5,9,10545.0,2:20,0,0,0,6227.0,1:23,4250000
8471717,Adam,McQuaid,1986-10-12,D,R,2017-18,38,1,3,4,0.11,-1,39,2.56,62,35803.0,15:42,0,0,0,0.0,80,56,7,13,-6,0,0,0,39.0,0:1,0,0,0,4780.0,2:5,2750000
8471724,Kris,Letang,1987-04-24,D,R,2017-18,79,9,42,51,0.65,-9,222,4.05,56,120058.0,25:19,0,1,1,0.0,109,108,53,89,-36,4,16,20,14711.0,3:6,0,1,1,12274.0,2:35,7250000
8471729,Kris,Russell,1987-05-02,D,L,2017-18,78,4,17,21,0.27,-7,90,4.44,8,89240.0,19:4,0,0,0,0.0,97,223,20,72,-52,0,2,2,1229.0,0:15,0,0,0,9439.0,2:1,4000000
8471735,Keith,Yandle,1986-09-09,D,L,2017-18,82,8,48,56,0.68,7,179,4.47,35,120486.0,24:29,0,0,0,0.0,26,101,42,129,-87,1,17,18,16231.0,3:17,0,2,2,10999.0,2:14,6350000
8471742,Cody,Franson,1987-08-08,D,R,2017-18,23,1,6,7,0.3,-1,51,1.96,8,22930.0,16:36,0,0,0,0.0,18,18,7,21,-14,0,4,4,3006.0,2:10,0,0,0,70.0,0:3,1000000
8471743,Vladimir,Sobotka,1987-07-02,LW,L,2017-18,81,11,20,31,0.38,-6,136,8.09,50,83224.0,17:7,191,161,352,54.26,127,45,21,14,7,0,3,3,8067.0,1:39,1,0,1,5572.0,1:8,3500000
8471761,Chris,Butler,1986-10-27,D,L,2017-18,6,0,0,0,0.0,1,2,0.0,2,4790.0,13:18,0,0,0,0.0,3,3,0,2,-2,0,0,0,117.0,0:19,0,0,0,118.0,0:19,650000
8471766,Jared,Boll,1986-05-13,RW,R,2017-18,10,1,0,1,0.1,0,4,25.0,16,2655.0,4:25,0,0,0,0.0,9,0,0,0,0,0,0,0,38.0,0:3,0,0,0,0.0,0:0,900000
8471768,Tom,Pyatt,1987-02-14,LW,L,2017-18,81,7,15,22,0.27,-12,103,6.8,10,68302.0,14:3,17,34,51,33.33,55,93,24,18,6,0,0,0,70.0,0:0,1,1,2,9940.0,2:2,1100000
8471769,Niklas,Hjalmarsson,1987-06-06,D,L,2017-18,48,1,8,9,0.19,-3,32,3.12,18,59610.0,20:41,0,0,0,0.0,16,118,16,37,-21,0,1,1,687.0,0:14,0,0,0,7112.0,2:28,4100000
8471794,Darren,Helm,1987-01-21,LW,L,2017-18,75,13,18,31,0.41,3,141,9.22,39,70048.0,15:33,45,57,102,44.12,131,36,38,33,5,0,0,0,573.0,0:7,2,2,4,9040.0,2:0,3850000
8471804,Nathan,Gerbe,1987-07-24,C,L,2017-18,2,0,0,0,0.0,-1,1,0.0,0,1032.0,8:36,0,0,0,0.0,4,0,0,0,0,0,0,0,0.0,0:0,0,0,0,0.0,0:0,750000
8471811,Cal,O'Reilly,1986-09-30,C,L,2017-18,1,0,0,0,0.0,0,1,0.0,0,496.0,8:16,2,3,5,40.0,0,1,1,0,1,0,0,0,0.0,0:0,0,0,0,20.0,0:20,700000
8471817,Ryan,Reaves,1987-01-20,RW,R,2017-18,79,4,6,10,0.13,-7,42,9.52,94,36004.0,7:35,14,14,28,50.0,236,27,12,10,2,0,0,0,183.0,0:2,0,0,0,8.0,0:0,1125000
8471873,Anton,Stralman,1986-08-01,D,R,2017-18,80,4,14,18,0.22,29,131,3.05,18,103137.0,21:29,0,0,0,0.0,104,100,31,29,2,0,0,0,2005.0,0:25,0,0,0,13123.0,2:44,4500000
8471887,Patric,Hornqvist,1987-01-01,RW,R,2017-18,70,29,20,49,0.7,2,247,11.74,58,72756.0,17:19,16,17,33,48.48,137,64,24,14,10,15,7,22,14813.0,3:31,0,0,0,177.0,0:2,4250000
8471958,Dan,Girardi,1984-04-29,D,R,2017-18,77,6,12,18,0.23,18,93,6.45,27,80320.0,17:23,0,1,1,0.0,133,155,15,27,-12,1,0,1,318.0,0:4,0,1,1,11511.0,2:29,5500000
8471976,David,Desharnais,1986-09-14,C,L,2017-18,71,6,22,28,0.39,-22,55,10.91,18,55622.0,13:3,386,315,701,55.06,22,36,26,26,0,2,5,7,6101.0,1:25,0,0,0,0.0,0:0,1000000
8472382,Andy,Greene,1982-10-30,D,L,2017-18,81,3,10,13,0.16,-9,93,3.23,21,102662.0,21:7,0,0,0,0.0,84,188,24,37,-13,0,0,0,377.0,0:4,0,0,0,15749.0,3:14,5000000
8473412,Bryan,Little,1987-11-12,C,R,2017-18,82,16,27,43,0.52,2,129,12.4,28,83314.0,16:56,732,574,1306,56.05,50,33,37,20,17,2,10,12,10724.0,2:10,0,0,0,5093.0,1:2,4700000
8473415,Alex,Biega,1988-04-04,D,R,2017-18,44,1,8,9,0.2,3,79,1.27,32,39654.0,15:1,0,0,0,0.0,126,53,9,20,-11,0,0,0,88.0,0:2,0,1,1,2080.0,0:47,750000
8473419,Brad,Marchand,1988-05-11,LW,L,2017-18,68,34,51,85,1.25,25,182,18.68,63,80441.0,19:42,50,76,126,39.68,37,25,58,76,-18,8,15,23,12585.0,3:5,1,3,4,7373.0,1:48,6125000
8473422,Nick,Foligno,1987-10-31,LW,L,2017-18,72,15,18,33,0.46,1,137,10.95,50,79273.0,18:21,340,401,741,45.88,182,60,34,35,-1,2,2,4,10319.0,2:23,0,0,0,5199.0,1:12,5500000
8473432,Derek,Dorsett,1986-12-20,RW,R,2017-18,20,7,2,9,0.45,-1,26,26.92,74,18338.0,15:16,0,3,3,0.0,39,14,4,2,2,0,0,0,88.0,0:4,2,0,2,3244.0,2:42,2650000
8473440,Will,O'Neill,1988-04-28,D,L,2017-18,1,0,0,0,0.0,0,3,0.0,0,565.0,9:25,0,0,0,0.0,0,0,0,0,0,0,0,0,0.0,0:0,0,0,0,0.0,0:0,612500
8473446,Erik,Johnson,1988-03-21,D,R,2017-18,62,9,16,25,0.4,2,168,5.36,58,94622.0,25:26,0,1,1,0.0,114,135,41,39,2,0,3,3,6596.0,1:46,0,1,1,13658.0,3:40,6000000
8473449,Kyle,Okposo,1988-04-16,RW,R,2017-18,76,15,29,44,0.58,-34,161,9.32,40,77644.0,17:1,23,27,50,46.0,70,34,24,28,-4,6,15,21,15553.0,3:24,0,0,0,525.0,0:6,6000000
8473453,Trevor,Lewis,1987-01-08,C,R,2017-18,68,14,12,26,0.38,-6,134,10.45,25,62157.0,15:14,47,62,109,43.12,125,32,19,14,5,1,2,3,2003.0,0:29,2,0,2,6789.0,1:39,2000000
8473463,Leo,Komarov,1987-01-23,C,L,2017-18,74,7,12,19,0.26,0,114,6.14,31,70094.0,15:47,112,100,212,52.83,219,48,47,42,5,2,1,3,3101.0,0:41,1,0,1,11450.0,2:34,2950000
8473465,Jamie,McGinn,1988-08-05,LW,L,2017-18,76,13,16,29,0.38,-5,116,11.21,33,61351.0,13:27,7,19,26,26.92,120,22,20,35,-15,4,2,6,7198.0,1:34,0,0,0,90.0,0:1,3333333
8473468,Eric,Gryba,1988-04-14,D,R,2017-18,21,0,2,2,0.1,4,19,0.0,31,18564.0,14:44,0,0,0,0.0,57,19,9,11,-2,0,0,0,0.0,0:0,0,0,0,1825.0,1:26,900000
8473473,Milan,Lucic,1988-06-07,LW,L,2017-18,82,10,24,34,0.41,-12,147,6.8,80,78526.0,15:57,29,23,52,55.77,254,25,29,76,-47,3,4,7,10494.0,2:7,0,0,0,79.0,0:0,6000000
8473485,Chris,Stewart,1987-10-30,RW,R,2017-18,54,10,6,16,0.3,-5,68,14.71,27,34805.0,10:44,3,7,10,30.0,48,14,7,10,-3,1,0,1,1321.0,0:24,0,0,0,33.0,0:0,1150000
8473492,Matt,Beleskey,1988-06-07,LW,L,2017-18,15,0,0,0,0.0,-9,17,0.0,21,9877.0,10:58,2,7,9,22.22,34,5,5,2,3,0,0,0,844.0,0:56,0,0,0,356.0,0:23,3800000
8473504,Cal,Clutterbuck,1987-11-18,RW,R,2017-18,76,8,10,18,0.24,-7,101,7.92,53,58317.0,12:47,7,13,20,35.0,226,53,14,31,-17,0,0,0,428.0,0:5,1,0,1,9641.0,2:6,3500000
8473507,Jeff,Petry,1987-12-09,D,R,2017-18,82,12,30,42,0.51,-30,178,6.74,28,115595.0,23:29,0,1,1,0.0,167,138,41,102,-61,6,17,23,13699.0,2:47,0,0,0,11653.0,2:22,5500000
8473512,Claude,Giroux,1988-01-12,C,R,2017-18,82,34,68,102,1.24,28,193,17.62,20,100188.0,20:21,638,450,1088,58.64,30,23,34,44,-10,9,27,36,17114.0,3:28,0,0,0,3911.0,0:47,8275000
8473533,Jordan,Staal,1988-09-10,C,L,2017-18,79,19,27,46,0.58,-4,160,11.88,26,91249.0,19:15,757,581,1338,56.58,181,32,58,44,14,4,8,12,12311.0,2:35,2,0,2,8220.0,1:44,6000000
8473534,Patrik,Berglund,1988-06-02,C,L,2017-18,57,17,9,26,0.46,-5,112,15.18,30,55253.0,16:9,173,141,314,55.1,111,36,22,11,11,3,3,6,5885.0,1:43,1,0,1,3194.0,0:56,3850000
8473544,Derick,Brassard,1987-09-22,C,L,2017-18,72,21,25,46,0.64,0,197,10.66,34,76605.0,17:43,516,534,1050,49.14,96,25,42,40,2,5,1,6,10919.0,2:31,0,0,0,451.0,0:6,5000000
8473546,Michael,Grabner,1987-10-05,RW,L,2017-18,80,27,9,36,0.45,11,167,16.17,16,71127.0,14:49,10,12,22,45.45,68,37,46,33,13,0,1,1,265.0,0:3,2,1,3,9795.0,2:2,1650000
8473548,Phil,Kessel,1987-10-02,RW,R,2017-18,82,34,58,92,1.12,-4,261,13.03,36,91935.0,18:41,6,13,19,31.58,10,17,26,60,-34,12,30,42,18571.0,3:46,0,0,0,129.0,0:1,8000000
8473560,Korbinian,Holzer,1988-02-16,D,R,2017-18,16,0,0,0,0.0,-3,10,0.0,6,11151.0,11:36,0,0,0,0.0,22,14,1,9,-8,0,0,0,0.0,0:0,0,0,0,896.0,0:56,900000
8473563,Nicklas,Backstrom,1987-11-23,C,L,2017-18,81,21,50,71,0.88,5,165,12.73,46,95550.0,19:39,702,669,1371,51.2,37,51,44,58,-14,7,19,26,17090.0,3:30,0,0,0,4446.0,0:54,6700000
8473564,Michael,Frolik,1988-02-17,RW,L,2017-18,70,10,15,25,0.36,-19,167,5.99,26,71075.0,16:55,33,39,72,45.83,48,35,43,26,17,0,0,0,2450.0,0:35,2,0,2,8480.0,2:1,4300000
8473573,Artem,Anisimov,1988-05-24,C,L,2017-18,72,20,11,31,0.43,-17,130,15.38,22,72527.0,16:47,416,494,910,45.71,15,40,18,26,-8,11,1,12,11751.0,2:43,1,0,1,6312.0,1:27,4550000
8473574,Shawn,Matthias,1988-02-19,LW,L,2017-18,27,1,2,3,0.11,-1,26,3.85,10,18100.0,11:10,12,16,28,42.86,22,14,7,3,4,0,0,0,140.0,0:5,0,0,0,2208.0,1:21,2125000
8473579,Nikolay,Kulemin,1986-07-14,LW,L,2017-18,13,1,2,3,0.23,0,7,14.29,0,9311.0,11:56,4,6,10,40.0,16,15,1,8,-7,0,0,0,46.0,0:3,0,0,0,1899.0,2:26,4187500
8473584,Andrew,MacDonald,1986-09-07,D,L,2017-18,66,6,15,21,0.32,8,82,7.32,30,78611.0,19:51,0,0,0,0.0,36,131,16,46,-30,0,0,0,588.0,0:8,0,1,1,7092.0,1:47,5000000
8473604,Jonathan,Toews,1988-04-29,C,L,2017-18,74,20,32,52,0.7,-1,211,9.48,47,87426.0,19:41,900,653,1553,57.95,32,24,53,42,11,2,10,12,13960.0,3:8,0,0,0,7564.0,1:42,10500000
8473618,Mathieu,Perreault,1988-01-05,C,L,2017-18,70,17,22,39,0.56,4,139,12.23,38,60725.0,14:27,33,26,59,55.93,120,25,42,25,17,6,8,14,9425.0,2:14,0,1,1,100.0,0:1,4125000
8473673,David,Schlemko,1987-05-07,D,L,2017-18,37,1,4,5,0.14,3,38,2.63,6,40104.0,18:3,0,0,0,0.0,33,72,13,27,-14,0,2,2,2306.0,1:2,0,0,0,2519.0,1:8,2100000
8473914,Mark,Letestu,1985-02-04,C,R,2017-18,80,9,14,23,0.29,-17,111,8.11,10,61671.0,12:50,473,414,887,53.33,62,32,19,20,-1,3,3,6,8523.0,1:46,2,1,3,8816.0,1:50,1800000
8473933,Ben,Lovejoy,1984-02-20,D,R,2017-18,57,2,6,8,0.14,7,74,2.7,25,56738.0,16:35,0,0,0,0.0,84,86,22,27,-5,0,0,0,162.0,0:2,0,1,1,10241.0,2:59,2666667
8473986,Alex,Killorn,1989-09-14,LW,L,2017-18,82,15,32,47,0.57,22,156,9.62,45,81170.0,16:29,22,33,55,40.0,82,25,32,32,0,2,7,9,14034.0,2:51,0,0,0,8293.0,1:41,4450000
8473991,Karl,Alzner,1988-09-24,D,L,2017-18,82,1,11,12,0.15,-7,84,1.19,40,98796.0,20:4,0,0,0,0.0,141,144,22,90,-68,0,0,0,99.0,0:1,0,1,1,14077.0,2:51,4625000
8473992,Justin,Falk,1988-10-11,D,L,2017-18,46,1,1,2,0.04,-16,36,2.78,28,44404.0,16:5,0,0,0,0.0,121,62,3,12,-9,0,0,0,85.0,0:1,0,1,1,4393.0,1:35,650000
8473994,Jamie,Benn,1989-07-18,LW,L,2017-18,82,36,43,79,0.96,21,241,14.94,54,97529.0,19:49,381,345,726,52.48,140,62,63,66,-3,9,13,22,15007.0,3:3,1,1,2,6812.0,1:23,9500000
8474000,Steven,Kampfer,1988-09-24,D,R,2017-18,22,0,1,1,0.05,-7,31,0.0,20,22772.0,17:15,0,0,0,0.0,46,41,6,11,-5,0,0,0,64.0,0:2,0,0,0,2485.0,1:52,650000
8474008,Paul,Carey,1988-09-24,C,L,2017-18,60,7,7,14,0.23,-13,51,13.73,20,36936.0,10:15,19,22,41,46.34,67,22,21,31,-10,1,0,1,87.0,0:1,1,0,1,1767.0,0:29,650000
8474009,Nick,Bonino,1988-04-20,C,L,2017-18,71,12,13,25,0.35,4,83,14.46,20,66608.0,15:38,527,443,970,54.33,18,72,64,33,31,0,0,0,2897.0,0:40,0,0,0,8876.0,2:5,4100000
8474013,Ian,Cole,1989-02-21,D,L,2017-18,67,5,15,20,0.3,14,84,5.95,76,71457.0,17:46,0,0,0,0.0,95,116,21,27,-6,0,1,1,95.0,0:1,0,0,0,8999.0,2:14,2100000
8474024,Jim,O'Brien,1989-01-29,C,R,2017-18,10,0,1,1,0.1,-1,11,0.0,0,5253.0,8:45,27,37,64,42.19,10,5,2,2,0,0,0,0,0.0,0:0,0,0,0,278.0,0:27,650000
8474027,Justin,Braun,1987-02-10,D,R,2017-18,81,5,28,33,0.41,7,115,4.35,28,103656.0,21:19,0,0,0,0.0,143,152,32,35,-3,0,0,0,407.0,0:5,0,0,0,13072.0,2:41,3800000
8474031,Kevin,Shattenkirk,1989-01-29,D,R,2017-18,46,5,18,23,0.5,-14,94,5.32,44,55949.0,20:16,0,0,0,0.0,44,65,24,61,-37,2,10,12,8802.0,3:11,0,0,0,207.0,0:4,6650000
8474034,Patrick,Maroon,1988-04-23,LW,L,2017-18,74,17,26,43,0.58,1,141,12.06,73,73420.0,16:32,11,13,24,45.83,150,14,22,37,-15,1,6,7,8961.0,2:1,0,0,0,35.0,0:0,2000000
8474037,James,van Riemsdyk,1989-05-04,LW,L,2017-18,81,36,18,54,0.67,1,248,14.52,30,72385.0,14:53,0,1,1,0.0,40,23,30,38,-8,11,9,20,11095.0,2:16,0,0,0,87.0,0:1,4250000
8474038,Paul,Byron,1989-04-27,LW,L,2017-18,82,20,15,35,0.43,-4,115,17.39,23,79337.0,16:7,40,68,108,37.04,137,55,45,36,9,2,2,4,5521.0,1:7,1,1,2,9087.0,1:50,1166667
8474040,Sam,Gagner,1989-08-10,C,R,2017-18,74,10,21,31,0.42,-18,164,6.1,35,67093.0,15:6,220,241,461,47.72,54,28,17,22,-5,3,8,11,9010.0,2:1,0,0,0,460.0,0:6,3150000
8474053,Logan,Couture,1989-03-28,C,L,2017-18,78,34,27,61,0.78,-2,204,16.67,18,86802.0,18:32,149,176,325,45.85,33,72,55,52,3,10,11,21,14562.0,3:6,2,1,3,6546.0,1:23,6000000
8474056,P.K.,Subban,1989-05-13,D,R,2017-18,82,16,43,59,0.72,18,207,7.73,82,118644.0,24:6,1,2,3,33.33,111,90,44,97,-53,5,20,25,15203.0,3:5,0,1,1,13021.0,2:38,9000000
8474062,Riley,Nash,1989-05-09,C,R,2017-18,76,15,26,41,0.54,16,113,13.27,18,70266.0,15:24,459,490,949,48.37,86,67,55,14,41,2,1,3,1910.0,0:25,0,0,0,8715.0,1:54,900000
8474066,Thomas,Hickey,1989-02-08,D,L,2017-18,69,5,20,25,0.36,20,87,5.75,24,74822.0,18:4,0,0,0,0.0,76,110,14,60,-46,0,0,0,415.0,0:6,0,0,0,8688.0,2:5,2200000
8474068,Kyle,Turris,1989-08-14,C,R,2017-18,76,16,35,51,0.67,19,145,11.03,26,75761.0,16:36,449,423,872,51.49,21,35,38,33,5,7,14,21,10573.0,2:19,0,0,0,488.0,0:6,3500000
8474074,Paul,Postma,1989-02-22,D,R,2017-18,14,0,1,1,0.07,-2,14,0.0,2,8590.0,10:13,0,0,0,0.0,13,10,1,4,-3,0,0,0,685.0,0:48,0,0,0,18.0,0:1,725000
8474089,Brad,Malone,1989-05-20,C,L,2017-18,7,0,0,0,0.0,0,9,0.0,6,3355.0,7:59,21,10,31,67.74,19,3,2,3,-1,0,0,0,11.0,0:1,0,0,0,231.0,0:33,650000
8474090,Brendan,Smith,1989-02-08,D,L,2017-18,44,1,7,8,0.18,2,66,1.52,69,45322.0,17:10,0,0,0,0.0,58,37,23,46,-23,0,1,1,138.0,0:3,0,0,0,3780.0,1:25,4350000
8474091,Brandon,Sutter,1989-02-14,C,R,2017-18,61,11,15,26,0.43,8,106,10.38,8,63375.0,17:18,570,532,1102,51.72,55,32,29,14,15,0,0,0,774.0,0:12,0,4,4,11343.0,3:5,4375000
8474098,Colton,Sceviour,1989-04-20,C,R,2017-18,76,11,13,24,0.32,6,141,7.8,24,61284.0,13:26,77,81,158,48.73,84,69,31,32,-1,0,0,0,266.0,0:3,1,2,3,10702.0,2:20,950000
8474102,David,Perron,1988-05-28,LW,R,2017-18,70,16,50,66,0.94,1,125,12.8,50,74795.0,17:48,96,142,238,40.34,118,20,48,33,15,1,17,18,10608.0,2:31,0,0,0,859.0,0:12,3750000
8474125,Carl,Gunnarsson,1986-11-09,D,L,2017-18,63,5,4,9,0.14,15,59,8.47,22,61107.0,16:9,0,0,0,0.0,35,102,7,22,-15,0,0,0,153.0,0:2,0,0,0,4837.0,1:16,2900000
8474131,Mario,Kempe,1988-09-19,RW,L,2017-18,18,2,2,4,0.22,-1,20,10.0,4,11975.0,11:5,27,43,70,38.57,20,11,3,3,0,0,0,0,5.0,0:0,0,0,0,764.0,0:42,650000
8474134,Yannick,Weber,1988-09-23,D,R,2017-18,47,2,3,5,0.11,2,40,5.0,16,34002.0,12:3,0,0,0,0.0,47,35,4,13,-9,0,0,0,49.0,0:1,0,0,0,294.0,0:6,650000
8474141,Patrick,Kane,1988-11-19,RW,L,2017-18,82,27,49,76,0.93,-20,285,9.47,32,99318.0,20:11,7,11,18,38.89,18,14,47,33,14,5,17,22,16767.0,3:24,0,0,0,359.0,0:4,10500000
8474145,Robert,Bortuzzo,1989-03-18,D,R,2017-18,72,4,9,13,0.18,11,76,5.26,41,63947.0,14:48,0,0,0,0.0,121,108,5,17,-12,0,0,0,148.0,0:2,0,0,0,5878.0,1:21,1150000
8474149,Evgenii,Dadonov,1989-03-12,RW,L,2017-18,74,28,37,65,0.88,10,188,14.89,8,83023.0,18:41,0,0,0,0.0,27,33,46,45,1,6,7,13,14747.0,3:19,0,0,0,14.0,0:0,4000000
8474150,Mikael,Backlund,1989-03-17,C,L,2017-18,82,14,31,45,0.55,-21,214,6.54,78,93593.0,19:1,705,705,1410,50.0,54,40,81,48,33,3,8,11,10525.0,2:8,1,2,3,11669.0,2:22,3575000
8474151,Ryan,McDonagh,1989-06-13,D,L,2017-18,63,4,25,29,0.46,8,99,4.04,20,88179.0,23:19,0,0,0,0.0,71,163,44,60,-16,1,8,9,6516.0,1:43,0,1,1,11662.0,3:5,4700000
8474157,Max,Pacioretty,1988-11-20,LW,L,2017-18,64,17,20,37,0.58,-16,212,8.02,30,73007.0,19:0,7,13,20,35.0,118,27,24,40,-16,6,9,15,11899.0,3:5,1,0,1,6563.0,1:42,4500000
8474161,Jakub,Voracek,1989-08-15,RW,L,2017-18,82,20,65,85,1.04,10,228,8.77,50,95729.0,19:27,15,19,34,44.12,23,32,33,65,-32,5,30,35,17180.0,3:29,0,0,0,133.0,0:1,8250000
8474162,Jake,Muzzin,1989-02-21,D,L,2017-18,74,8,34,42,0.57,10,154,5.19,40,96131.0,21:39,0,0,0,0.0,170,123,17,59,-42,4,10,14,9984.0,2:14,0,1,1,10416.0,2:20,4000000
8474166,Alec,Martinez,1987-07-26,D,L,2017-18,77,9,16,25,0.32,3,111,8.11,34,105625.0,22:51,0,1,1,0.0,100,206,11,81,-70,2,9,11,9004.0,1:56,0,1,1,10971.0,2:22,4000000
8474176,Carl,Hagelin,1988-08-23,LW,L,2017-18,81,10,21,31,0.38,8,169,5.92,28,77478.0,15:56,21,28,49,42.86,112,36,46,25,21,0,0,0,265.0,0:3,1,1,2,12333.0,2:32,4000000
8474189,Lars,Eller,1989-05-08,C,L,2017-18,81,18,20,38,0.47,-6,161,11.18,38,74361.0,15:18,471,485,956,49.27,71,69,39,47,-8,3,3,6,5722.0,1:10,0,0,0,8788.0,1:48,3500000
8474190,Wayne,Simmonds,1988-08-26,RW,R,2017-18,75,24,22,46,0.61,-16,176,13.64,57,81394.0,18:5,12,9,21,57.14,129,54,38,27,11,11,6,17,14910.0,3:18,1,0,1,3858.0,0:51,3975000
8474207,Nick,Holden,1987-05-15,D,L,2017-18,73,4,13,17,0.23,-5,80,5.0,14,83247.0,19:0,0,0,0,0.0,136,83,26,39,-13,0,3,3,2151.0,0:29,0,0,0,8807.0,2:0,1650000
8474218,Jason,Demers,1988-06-09,D,R,2017-18,69,6,14,20,0.29,-4,95,6.32,37,87503.0,21:8,0,0,0,0.0,66,79,20,36,-16,0,3,3,4349.0,1:3,0,0,0,8168.0,1:58,4500000
8474230,Micheal,Haley,1986-03-30,C,L,2017-18,75,3,6,9,0.12,-13,55,5.45,212,35059.0,7:47,19,21,40,47.5,124,23,8,14,-6,0,0,0,141.0,0:1,0,0,0,322.0,0:4,825000
8474250,Zack,Smith,1988-04-05,LW,L,2017-18,68,5,14,19,0.28,-32,124,4.03,54,68217.0,16:43,297,323,620,47.9,90,29,27,29,-2,0,3,3,6191.0,1:31,0,1,1,5851.0,1:26,3250000
8474291,Jay,Beagle,1985-10-16,C,R,2017-18,79,7,15,22,0.28,3,65,10.77,16,58995.0,12:26,584,414,998,58.52,69,44,25,10,15,0,0,0,118.0,0:1,1,0,1,11964.0,2:31,1750000
8474520,Jason,Garrison,1984-11-13,D,L,2017-18,8,0,1,1,0.12,-2,7,0.0,4,9152.0,19:4,0,0,0,0.0,7,23,3,7,-4,0,0,0,70.0,0:8,0,0,0,839.0,1:44,4600000
8474563,Drew,Doughty,1989-12-08,D,R,2017-18,82,10,50,60,0.73,23,205,4.88,54,132031.0,26:50,0,1,1,0.0,127,128,17,79,-62,3,17,20,15515.0,3:9,1,0,1,13557.0,2:45,7000000
8474564,Steven,Stamkos,1990-02-07,C,R,2017-18,78,27,59,86,1.1,18,212,12.74,72,87864.0,18:46,466,426,892,52.24,61,35,27,50,-23,15,18,33,16151.0,3:27,0,0,0,1909.0,0:24,8500000
8474565,Alex,Pietrangelo,1990-01-18,D,R,2017-18,78,15,39,54,0.69,8,216,6.94,22,120447.0,25:44,0,0,0,0.0,48,164,54,41,13,3,10,13,14229.0,3:2,0,1,1,10910.0,2:19,6500000
8474567,Zach,Bogosian,1990-07-15,D,R,2017-18,18,0,1,1,0.06,-9,29,0.0,20,20689.0,19:9,0,0,0,0.0,22,23,3,9,-6,0,0,0,959.0,0:53,0,0,0,1198.0,1:6,5142857
8474568,Luke,Schenn,1989-11-02,D,R,2017-18,64,1,6,7,0.11,-12,59,1.69,35,62916.0,16:23,0,0,0,0.0,219,105,14,31,-17,0,0,0,101.0,0:1,0,0,0,7387.0,1:55,1250000
8474569,Colin,Wilson,1989-10-20,C,L,2017-18,56,6,12,18,0.32,-5,75,8.0,6,44125.0,13:7,60,55,115,52.17,38,23,11,13,-2,1,5,6,6739.0,2:0,0,0,0,111.0,0:1,3937500
8474571,Mikkel,Boedker,1989-12-16,LW,L,2017-18,74,15,22,37,0.5,0,119,12.61,12,59304.0,13:21,5,14,19,26.32,41,24,29,26,3,4,4,8,6099.0,1:22,0,0,0,73.0,0:0,4000000
8474573,Josh,Bailey,1989-10-02,RW,L,2017-18,76,18,53,71,0.93,-20,151,11.92,17,81551.0,17:53,11,39,50,22.0,12,33,45,62,-17,5,26,31,13730.0,3:0,0,0,0,1197.0,0:15,3300000
8474574,Tyler,Myers,1990-02-01,D,R,2017-18,82,6,30,36,0.44,9,150,4.0,48,105417.0,21:25,0,0,0,0.0,68,119,32,77,-45,3,14,17,10191.0,2:4,1,0,1,12772.0,2:35,5500000
8474578,Erik,Karlsson,1990-05-31,D,R,2017-18,71,9,53,62,0.87,-25,196,4.59,36,113914.0,26:44,0,0,0,0.0,58,120,55,86,-31,3,15,18,14149.0,3:19,0,1,1,6198.0,1:27,6500000
8474579,Luca,Sbisa,1990-01-30,D,L,2017-18,30,2,12,14,0.47,8,26,7.69,15,35137.0,19:31,0,0,0,0.0,50,54,12,16,-4,0,0,0,432.0,0:14,0,1,1,4265.0,2:22,3600000
8474581,Jake,Gardiner,1990-07-04,D,L,2017-18,82,5,47,52,0.63,9,133,3.76,32,110824.0,22:31,0,0,0,0.0,51,103,39,105,-66,1,14,15,10183.0,2:4,0,0,0,1833.0,0:22,4050000
8474584,Michael,Del Zotto,1990-06-24,D,L,2017-18,82,6,16,22,0.27,-8,128,4.69,48,102356.0,20:48,0,0,0,0.0,244,127,22,67,-45,0,5,5,4494.0,0:54,0,0,0,10600.0,2:9,3000000
8474586,Jordan,Eberle,1990-05-15,C,R,2017-18,81,25,34,59,0.73,5,183,13.66,21,78091.0,16:4,12,21,33,36.36,46,30,38,38,0,3,7,10,9467.0,1:56,0,0,0,132.0,0:1,6000000
8474589,Tyler,Ennis,1989-10-06,LW,L,2017-18,73,8,14,22,0.3,-1,115,6.96,12,52443.0,11:58,3,9,12,25.0,51,33,30,11,19,2,1,3,2457.0,0:33,0,0,0,15.0,0:0,4600000
8474590,John,Carlson,1990-01-10,D,R,2017-18,82,15,53,68,0.83,0,237,6.33,32,121926.0,24:46,0,1,1,0.0,47,146,58,97,-39,4,28,32,18223.0,3:42,0,0,0,12929.0,2:37,3966667
8474600,Roman,Josi,1990-06-01,D,L,2017-18,75,14,39,53,0.71,24,253,5.53,24,110117.0,24:28,0,0,0,0.0,80,120,30,59,-29,7,13,20,13001.0,2:53,0,1,1,13716.0,3:2,4000000
8474602,Justin,Schultz,1990-07-06,D,R,2017-18,63,4,23,27,0.43,22,109,3.67,14,73759.0,19:30,0,0,0,0.0,36,93,17,27,-10,0,10,10,8656.0,2:17,0,0,0,430.0,0:6,5500000
8474604,Aaron,Ness,1990-05-18,D,L,2017-18,8,0,1,1,0.12,2,2,0.0,8,6109.0,12:43,0,0,0,0.0,1,8,1,2,-1,0,0,0,0.0,0:0,0,0,0,409.0,0:51,612500
8474610,Zac,Dalpe,1989-11-01,C,R,2017-18,12,0,0,0,0.0,-3,18,0.0,13,5358.0,7:26,7,17,24,29.17,6,4,3,2,1,0,0,0,173.0,0:14,0,0,0,0.0,0:0,725000
8474612,Travis,Hamonic,1990-08-16,D,R,2017-18,74,1,10,11,0.15,-9,107,0.93,79,91900.0,20:41,0,1,1,0.0,83,124,28,46,-18,0,0,0,385.0,0:5,0,0,0,12514.0,2:49,3857143
8474613,Derek,Stepan,1990-06-18,C,R,2017-18,82,14,42,56,0.68,-7,209,6.7,26,94795.0,19:16,740,810,1550,47.74,52,54,42,28,14,3,15,18,12794.0,2:36,2,0,2,5831.0,1:11,6500000
8474618,Marco,Scandella,1990-02-23,D,L,2017-18,82,5,17,22,0.27,-15,138,3.62,37,114719.0,23:19,0,0,0,0.0,91,114,24,41,-17,0,4,4,7426.0,1:30,0,1,1,13192.0,2:40,4000000
8474625,Jimmy,Hayes,1989-11-21,RW,R,2017-18,33,3,6,9,0.27,-2,37,8.11,6,23617.0,11:55,6,9,15,40.0,50,6,15,8,7,1,0,1,3070.0,1:33,0,0,0,28.0,0:0,2300000
8474627,Jori,Lehtera,1987-12-23,C,L,2017-18,62,3,5,8,0.13,-8,45,6.67,14,39114.0,10:30,85,64,149,57.05,55,21,14,13,1,0,0,0,2076.0,0:33,1,0,1,2779.0,0:44,4700000
8474628,Michael,Stone,1990-06-07,D,R,2017-18,82,3,7,10,0.12,-11,98,3.06,28,82396.0,16:44,0,0,0,0.0,106,158,15,31,-16,0,1,1,2839.0,0:34,0,0,0,12020.0,2:26,3500000
8474641,Adam,Henrique,1990-02-06,C,L,2017-18,81,24,26,50,0.62,11,151,15.89,20,86436.0,17:47,508,547,1055,48.15,61,61,40,29,11,6,7,13,12295.0,2:31,1,2,3,7676.0,1:34,4000000
8474642,Lance,Bouma,1990-03-25,LW,L,2017-18,53,3,6,9,0.17,1,56,5.36,36,33868.0,10:39,14,19,33,42.42,132,27,5,8,-3,0,1,1,847.0,0:15,0,0,0,2902.0,0:54,2200000
8474660,David,Warsofsky,1990-05-30,D,L,2017-18,16,0,5,5,0.31,4,18,0.0,0,12859.0,13:23,0,0,0,0.0,1,22,4,7,-3,0,0,0,55.0,0:3,0,0,0,782.0,0:48,675000
8474668,Dale,Weise,1988-08-05,RW,R,2017-18,46,4,4,8,0.17,-7,44,9.09,21,29180.0,10:34,1,1,2,50.0,77,14,13,8,5,0,0,0,1046.0,0:22,0,0,0,48.0,0:1,2350000
8474673,TJ,Brodie,1990-06-07,D,L,2017-18,73,4,28,32,0.44,-16,118,3.39,18,103719.0,23:40,0,0,0,0.0,24,99,48,68,-20,1,10,11,11047.0,2:31,0,0,0,9162.0,2:5,4650400
8474679,Gustav,Nyquist,1989-09-01,RW,L,2017-18,82,21,19,40,0.49,-2,213,9.86,20,87828.0,17:51,6,7,13,46.15,65,36,44,44,0,3,5,8,12079.0,2:27,0,0,0,30.0,0:0,4750000
8474683,Derek,Grant,1990-04-20,C,L,2017-18,66,12,12,24,0.36,3,65,18.46,11,43948.0,11:5,317,280,597,53.1,63,39,18,13,5,3,0,3,2465.0,0:37,0,1,1,3224.0,0:48,650000
8474685,Matt,Calvert,1989-12-24,LW,L,2017-18,69,9,15,24,0.35,-10,108,8.33,33,55377.0,13:22,15,29,44,34.09,61,35,28,15,13,1,0,1,1186.0,0:17,2,0,2,6350.0,1:32,2200000
8474688,Greg,Pateryn,1990-06-20,D,R,2017-18,73,1,12,13,0.18,6,100,1.0,50,85918.0,19:36,0,0,0,0.0,155,148,5,38,-33,0,0,0,245.0,0:3,0,0,0,11299.0,2:34,800000
8474697,Mark,Borowiecki,1989-07-12,D,L,2017-18,52,3,8,11,0.21,-6,66,4.55,64,45684.0,14:38,0,1,1,0.0,226,81,11,17,-6,0,0,0,33.0,0:0,0,0,0,3719.0,1:11,1100000
8474709,Matt,Martin,1989-05-08,LW,L,2017-18,50,3,9,12,0.24,0,46,6.52,50,23965.0,7:59,12,4,16,75.0,147,9,6,7,-1,0,0,0,49.0,0:0,0,0,0,0.0,0:0,2500000
8474715,Cam,Atkinson,1989-06-05,RW,R,2017-18,65,24,22,46,0.71,19,231,10.39,14,73716.0,18:54,21,44,65,32.31,32,29,31,19,12,3,7,10,10744.0,2:45,1,0,1,5547.0,1:25,3500000
8474716,Jared,Spurgeon,1989-11-29,D,R,2017-18,61,9,28,37,0.61,-6,110,8.18,8,89837.0,24:32,0,1,1,0.0,64,127,23,20,3,3,10,13,9595.0,2:37,0,0,0,10295.0,2:48,5187500
8474717,Mark,Barberio,1990-03-23,D,L,2017-18,46,3,10,13,0.28,6,52,5.77,31,47693.0,17:16,0,0,0,0.0,26,62,8,16,-8,0,1,1,445.0,0:9,1,1,2,5856.0,2:7,750000
8474722,Luke,Witkowski,1990-04-14,RW,R,2017-18,31,1,3,4,0.13,-1,16,6.25,68,12809.0,6:53,1,1,2,50.0,57,11,2,7,-5,0,0,0,8.0,0:0,0,0,0,120.0,0:3,750000
8474736,Zac,Rinaldo,1990-06-15,C,L,2017-18,53,5,2,7,0.13,-7,56,8.93,44,35883.0,11:17,4,11,15,26.67,188,23,6,7,-1,0,0,0,84.0,0:1,0,0,0,2344.0,0:44,700000
8474739,Tommy,Wingels,1988-04-12,C,R,2017-18,75,9,8,17,0.23,-11,86,10.47,45,51687.0,11:29,211,244,455,46.37,179,41,21,19,2,1,0,1,1270.0,0:16,2,0,2,5705.0,1:16,750000
8474743,Zach,Redmond,1988-07-26,D,R,2017-18,3,0,0,0,0.0,1,7,0.0,2,2606.0,14:28,0,0,0,0.0,4,2,1,0,1,0,0,0,3.0,0:1,0,0,0,34.0,0:11,612500
8474749,Matt,Bartkowski,1988-06-04,D,L,2017-18,18,0,3,3,0.17,-3,21,0.0,4,14413.0,13:20,0,0,0,0.0,31,13,3,18,-15,0,0,0,10.0,0:0,0,0,0,1033.0,0:57,612500
8474774,Dalton,Prout,1990-03-13,D,R,2017-18,4,0,0,0,0.0,-2,5,0.0,13,3357.0,13:59,0,0,0,0.0,7,3,0,4,-4,0,0,0,4.0,0:1,0,0,0,145.0,0:36,1575000
8474818,Jordie,Benn,1987-07-26,D,L,2017-18,77,4,11,15,0.19,-2,106,3.77,34,87647.0,18:58,0,0,0,0.0,90,153,20,74,-54,0,0,0,112.0,0:1,0,0,0,10150.0,2:11,1100000
8474849,Antoine,Roussel,1989-11-21,LW,L,2017-18,73,5,12,17,0.23,1,85,5.88,126,54451.0,12:25,22,16,38,57.89,104,42,16,23,-7,0,0,0,336.0,0:4,0,0,0,4266.0,0:58,2000000
8474870,Tyler,Johnson,1990-07-29,C,R,2017-18,81,21,29,50,0.62,3,186,11.29,24,82580.0,16:59,360,359,719,50.07,48,47,39,23,16,4,9,13,11089.0,2:16,2,0,2,7334.0,1:30,5000000
8474884,Mike,Hoffman,1989-11-24,LW,L,2017-18,82,22,34,56,0.68,-20,257,8.56,32,90562.0,18:24,22,18,40,55.0,31,34,51,69,-18,8,13,21,15219.0,3:5,0,0,0,224.0,0:2,5187500
8475098,Tyler,Bozak,1986-03-19,C,R,2017-18,81,11,32,43,0.53,6,154,7.14,28,76023.0,15:38,627,542,1169,53.64,43,28,37,42,-5,3,10,13,10631.0,2:11,0,0,0,60.0,0:0,4200000
8475147,Jordan,Schroeder,1990-09-29,LW,R,2017-18,21,1,1,2,0.1,-4,20,5.0,4,9421.0,7:28,39,24,63,61.9,14,2,5,2,3,0,0,0,140.0,0:6,0,0,0,29.0,0:1,650000
8475149,Marcus,Johansson,1990-10-06,LW,L,2017-18,29,5,9,14,0.48,-11,42,11.9,14,27825.0,15:59,36,38,74,48.65,8,9,15,21,-6,1,2,3,5031.0,2:53,0,0,0,161.0,0:5,4583333
8475151,Kyle,Palmieri,1991-02-01,RW,R,2017-18,62,24,20,44,0.71,-1,181,13.26,30,64392.0,17:18,25,50,75,33.33,94,50,33,19,14,11,12,23,10326.0,2:46,0,0,0,2630.0,0:42,4650000
8475157,Landon,Ferraro,1991-08-08,C,R,2017-18,2,1,0,1,0.5,1,3,33.33,0,530.0,4:25,0,0,0,0.0,1,0,0,0,0,0,0,0,3.0,0:1,0,0,0,0.0,0:0,700000
8475158,Ryan,O'Reilly,1991-02-07,C,L,2017-18,81,24,37,61,0.75,-23,230,10.43,2,101170.0,20:49,1274,850,2124,59.98,42,48,65,39,26,15,8,23,17495.0,3:35,0,4,4,7568.0,1:33,7500000
8475160,Kyle,Clifford,1991-01-13,LW,L,2017-18,50,6,4,10,0.2,-4,81,7.41,48,31648.0,10:32,1,8,9,11.11,127,8,8,6,2,0,0,0,324.0,0:6,0,0,0,111.0,0:2,1600000
8475163,Alex,Chiasson,1990-10-01,RW,R,2017-18,61,9,9,18,0.3,1,59,15.25,26,43062.0,11:45,11,30,41,26.83,57,29,29,16,13,1,0,1,2254.0,0:36,1,2,3,6092.0,1:39,660000
8475164,Jakob,Silfverberg,1990-10-13,RW,R,2017-18,77,17,23,40,0.52,6,187,9.09,18,82977.0,17:57,18,35,53,33.96,52,61,40,43,-3,2,6,8,7820.0,1:41,1,1,2,7850.0,1:41,3750000
8475166,John,Tavares,1990-09-20,C,L,2017-18,82,37,47,84,1.02,-12,257,14.4,26,98032.0,19:55,913,813,1726,52.9,30,34,49,78,-29,12,18,30,15570.0,3:9,2,1,3,7673.0,1:33,5500000
8475167,Victor,Hedman,1990-12-18,D,L,2017-18,77,17,46,63,0.82,32,216,7.87,54,119430.0,25:51,1,1,2,50.0,139,110,46,67,-21,2,24,26,15708.0,3:24,0,2,2,11943.0,2:35,7875000
8475168,Matt,Duchene,1991-01-16,C,L,2017-18,82,27,32,59,0.72,-22,190,14.21,18,90194.0,18:19,717,637,1354,52.95,60,49,47,40,7,9,4,13,13189.0,2:40,0,0,0,1242.0,0:15,6000000
8475169,Evander,Kane,1991-08-02,LW,L,2017-18,78,29,25,54,0.69,-9,307,9.45,82,91617.0,19:34,120,150,270,44.44,159,34,40,50,-10,3,6,9,12078.0,2:34,4,0,4,3305.0,0:42,5250000
8475170,Brayden,Schenn,1991-08-22,C,L,2017-18,82,28,42,70,0.85,10,210,13.33,56,97049.0,19:43,660,714,1374,48.03,154,37,56,42,14,8,11,19,15737.0,3:11,0,0,0,2689.0,0:32,5125000
8475171,Oliver,Ekman-Larsson,1991-07-17,D,L,2017-18,82,14,28,42,0.51,-28,202,6.93,44,116515.0,23:40,0,1,1,0.0,160,79,29,53,-24,6,9,15,14998.0,3:2,0,0,0,8210.0,1:40,5500000
8475172,Nazem,Kadri,1990-10-06,C,L,2017-18,80,32,23,55,0.69,2,211,15.17,42,80445.0,16:45,546,547,1093,49.95,94,26,42,48,-6,12,7,19,10026.0,2:5,0,0,0,42.0,0:0,4500000
8475175,Magnus,Paajarvi,1991-04-12,LW,L,2017-18,79,8,4,12,0.15,-11,126,6.35,12,59015.0,12:27,2,6,8,25.0,104,42,25,12,13,0,0,0,280.0,0:3,0,0,0,6605.0,1:23,800000
8475176,Ryan,Ellis,1991-01-03,D,R,2017-18,44,9,23,32,0.73,26,110,8.18,6,61661.0,23:21,0,0,0,0.0,27,84,33,33,0,2,3,5,5818.0,2:12,0,3,3,7180.0,2:43,2500000
8475177,Calvin,de Haan,1991-05-09,D,L,2017-18,33,1,11,12,0.36,11,44,2.27,8,37124.0,18:44,0,0,0,0.0,45,65,14,24,-10,0,0,0,178.0,0:5,0,0,0,4674.0,2:21,3300000
8475178,Zack,Kassian,1991-01-24,RW,R,2017-18,74,7,12,19,0.26,-8,86,8.14,92,51812.0,11:40,5,19,24,20.83,129,9,26,33,-7,0,1,1,406.0,0:5,0,2,2,6553.0,1:28,1950000
8475179,Dmitry,Kulikov,1990-10-29,D,L,2017-18,62,3,8,11,0.18,6,48,6.25,22,63508.0,17:4,0,0,0,0.0,69,78,11,53,-42,0,0,0,226.0,0:3,0,0,0,9385.0,2:31,4333333
8475180,Peter,Holland,1991-01-14,C,L,2017-18,23,1,3,4,0.17,-10,30,3.33,7,17103.0,12:23,107,120,227,47.14,14,12,7,11,-4,0,0,0,148.0,0:6,0,1,1,1711.0,1:14,675000
8475181,Nick,Leddy,1991-03-20,D,L,2017-18,80,10,32,42,0.52,-42,153,6.54,20,107621.0,22:25,0,0,0,0.0,95,104,21,57,-36,4,10,14,15691.0,3:16,0,0,0,3292.0,0:41,5500000
8475184,Chris,Kreider,1991-04-30,LW,L,2017-18,58,16,21,37,0.64,-2,137,11.68,44,54352.0,15:37,25,35,60,41.67,103,24,18,39,-21,7,5,12,8989.0,2:34,0,0,0,84.0,0:1,4625000
8475185,Jacob,Josefson,1991-03-02,C,L,2017-18,39,2,2,4,0.1,-4,35,5.71,6,26621.0,11:22,141,179,320,44.06,26,33,7,8,-1,0,0,0,165.0,0:4,0,0,0,3609.0,1:32,700000
8475186,John,Moore,1990-11-19,D,L,2017-18,81,7,11,18,0.22,3,141,4.96,47,97245.0,20:0,0,0,0,0.0,135,105,17,48,-31,0,2,2,1800.0,0:22,1,0,1,8856.0,1:49,1666667
8475188,Brayden,McNabb,1991-01-21,D,L,2017-18,76,5,10,15,0.2,26,88,5.68,52,91892.0,20:9,0,0,0,0.0,225,176,30,40,-10,0,0,0,340.0,0:4,0,0,0,12391.0,2:43,1700000
8475191,Reilly,Smith,1991-04-01,RW,L,2017-18,67,22,38,60,0.9,31,162,13.58,24,72056.0,17:55,4,9,13,30.77,40,24,54,47,7,7,7,14,9484.0,2:21,1,1,2,6699.0,1:39,5000000
8475193,Tomas,Tatar,1990-12-01,LW,L,2017-18,82,20,14,34,0.41,-19,174,11.49,34,80026.0,16:15,2,13,15,13.33,67,29,45,45,0,9,4,13,10892.0,2:12,0,0,0,103.0,0:1,5300000
8475197,Tyson,Barrie,1991-07-26,D,R,2017-18,68,14,43,57,0.84,-15,178,7.87,22,92604.0,22:41,0,0,0,0.0,40,79,20,38,-18,7,23,30,15223.0,3:43,0,0,0,758.0,0:11,5500000
8475200,Dmitry,Orlov,1991-07-23,D,L,2017-18,82,10,21,31,0.38,10,125,8.0,22,113794.0,23:7,0,0,0,0.0,128,116,54,51,3,0,4,4,5710.0,1:9,0,0,0,9740.0,1:58,5100000
8475204,Brandon,Pirri,1991-04-10,RW,L,2017-18,2,3,0,3,1.5,3,11,27.27,0,2114.0,17:37,1,1,2,50.0,2,0,2,1,1,0,0,0,281.0,2:20,0,0,0,0.0,0:0,650000
8475208,Brian,Dumoulin,1991-09-06,D,L,2017-18,80,5,13,18,0.22,-5,102,4.9,30,98964.0,20:37,0,0,0,0.0,101,132,35,43,-8,0,0,0,1069.0,0:13,0,0,0,12154.0,2:31,4100000
8475209,Richard,Panik,1991-02-07,RW,L,2017-18,72,14,21,35,0.49,7,136,10.29,38,65652.0,15:11,4,8,12,33.33,137,37,26,14,12,4,2,6,8204.0,1:53,0,0,0,779.0,0:10,2800000
8475218,Mattias,Ekholm,1990-05-24,D,L,2017-18,81,10,24,34,0.42,25,135,7.41,46,114586.0,23:34,0,1,1,0.0,75,117,38,70,-32,5,8,13,9097.0,1:52,1,0,1,14028.0,2:53,3750000
8475220,Marcus,Foligno,1991-08-10,LW,L,2017-18,77,8,15,23,0.3,2,79,10.13,72,50187.0,10:51,9,10,19,47.37,185,44,20,17,3,1,1,2,1228.0,0:15,0,0,0,19.0,0:0,2875000
8475222,Sami,Vatanen,1991-06-03,D,R,2017-18,72,4,28,32,0.44,-7,145,2.76,40,96773.0,22:24,0,0,0,0.0,92,105,18,52,-34,1,12,13,10995.0,2:32,0,1,1,7458.0,1:43,4875000
8475224,Jordan,Szwarz,1991-05-14,RW,R,2017-18,12,0,3,3,0.25,-4,19,0.0,2,8287.0,11:30,28,42,70,40.0,9,8,3,1,2,0,1,1,511.0,0:42,0,0,0,217.0,0:18,650000
8475225,Craig,Smith,1989-09-05,RW,R,2017-18,79,25,26,51,0.65,20,229,10.92,24,72909.0,15:22,40,54,94,42.55,60,35,61,28,33,9,5,14,11100.0,2:20,0,0,0,38.0,0:0,4250000
8475227,Chris,Wideman,1990-01-07,D,R,2017-18,16,3,5,8,0.5,5,24,12.5,6,11094.0,11:33,0,0,0,0.0,17,9,0,9,-9,2,0,2,2041.0,2:7,0,0,0,50.0,0:3,800000
8475231,Casey,Cizikas,1991-02-27,C,L,2017-18,64,7,10,17,0.27,-12,74,9.46,23,50746.0,13:12,473,418,891,53.09,128,53,33,23,10,0,0,0,278.0,0:4,1,0,1,8839.0,2:18,3350000
8475233,David,Savard,1990-10-22,D,R,2017-18,81,4,12,16,0.2,2,145,2.76,32,94187.0,19:22,0,0,0,0.0,144,143,24,27,-3,0,0,0,862.0,0:10,0,1,1,10752.0,2:12,4250000
8475235,Nicolas,Deslauriers,1991-02-22,LW,L,2017-18,58,10,4,14,0.24,7,77,12.99,55,40350.0,11:35,4,2,6,66.67,238,30,14,3,11,0,0,0,78.0,0:1,0,1,1,3672.0,1:3,775000
8475236,Cody,Eakin,1991-05-24,C,L,2017-18,80,11,16,27,0.34,-6,107,10.28,22,69768.0,14:32,479,440,919,52.12,63,45,60,31,29,0,0,0,2191.0,0:27,1,2,3,7759.0,1:36,3850000
8475246,Kevin,Connauton,1990-02-23,D,L,2017-18,73,11,10,21,0.29,3,102,10.78,20,66472.0,15:10,0,0,0,0.0,116,72,13,32,-19,0,0,0,783.0,0:10,0,0,0,2490.0,0:34,1000000
8475254,Gabriel,Dumont,1990-10-06,C,R,2017-18,30,1,1,2,0.07,1,38,2.63,6,16276.0,9:2,41,62,103,39.81,62,16,5,3,2,0,0,0,56.0,0:1,0,0,0,1612.0,0:53,650000
8475263,Wade,Megan,1990-07-22,C,L,2017-18,1,0,0,0,0.0,0,1,0.0,0,501.0,8:21,1,1,2,50.0,0,0,0,0,0,0,0,0,0.0,0:0,0,0,0,105.0,1:45,650000
8475268,Gabriel,Bourque,1990-09-23,LW,L,2017-18,58,5,6,11,0.19,-6,44,11.36,12,37947.0,10:54,7,16,23,30.43,123,59,12,2,10,0,0,0,39.0,0:0,0,0,0,6587.0,1:53,750000
8475278,Byron,Froese,1991-03-12,C,R,2017-18,48,3,8,11,0.23,0,49,6.12,26,33349.0,11:34,156,196,352,44.32,54,42,19,11,8,0,0,0,114.0,0:2,0,0,0,3424.0,1:11,650000
8475279,Ben,Chiarot,1991-05-09,D,L,2017-18,57,2,12,14,0.25,15,57,3.51,32,52244.0,15:16,0,0,0,0.0,105,75,10,34,-24,0,0,0,180.0,0:3,0,0,0,4521.0,1:19,1400000
8475287,Erik,Haula,1991-03-23,LW,L,2017-18,76,29,26,55,0.72,-16,175,16.57,37,79224.0,17:22,489,479,968,50.52,85,42,44,37,7,12,7,19,10861.0,2:22,0,0,0,2429.0,0:31,2750000
8475310,Curtis,McKenzie,1991-02-22,LW,L,2017-18,7,0,2,2,0.29,3,11,0.0,11,3403.0,8:6,0,1,1,0.0,8,1,3,2,1,0,0,0,262.0,0:37,0,0,0,0.0,0:0,700000
8475314,Anders,Lee,1990-07-03,LW,L,2017-18,82,40,22,62,0.76,-25,208,19.23,44,84953.0,17:16,11,5,16,68.75,102,38,26,35,-9,14,8,22,15072.0,3:3,0,0,0,67.0,0:0,3750000
8475323,Marcus,Kruger,1990-05-27,C,L,2017-18,48,1,5,6,0.12,-6,30,3.33,28,31211.0,10:50,159,128,287,55.4,56,16,10,11,-1,0,0,0,291.0,0:6,0,0,0,3412.0,1:11,3083333
8475324,Nick,Jensen,1990-09-21,D,R,2017-18,81,0,15,15,0.19,-8,107,0.0,27,79002.0,16:15,0,0,0,0.0,71,88,25,54,-29,0,1,1,346.0,0:4,0,0,0,9348.0,1:55,812500
8475325,Jordan,Nolan,1989-06-23,C,L,2017-18,69,4,4,8,0.12,-13,50,8.0,69,40562.0,9:47,1,3,4,25.0,123,17,10,15,-5,0,0,0,327.0,0:4,0,0,0,205.0,0:2,950000
8475328,Ben,Sexton,1991-06-06,C,R,2017-18,2,0,0,0,0.0,-1,1,0.0,0,1233.0,10:16,3,2,5,60.0,6,0,0,1,-1,0,0,0,0.0,0:0,0,0,0,0.0,0:0,725000
8475343,Nic,Dowd,1990-05-27,C,R,2017-18,56,3,1,4,0.07,-10,51,5.88,28,35401.0,10:32,202,194,396,51.01,81,30,16,15,1,1,0,1,64.0,0:1,0,0,0,3809.0,1:8,640000
8475423,Darren,Archibald,1990-02-09,RW,L,2017-18,27,4,5,9,0.33,-1,28,14.29,14,24072.0,14:51,0,1,1,0.0,80,14,5,1,4,0,0,0,65.0,0:2,1,0,1,4527.0,2:47,650000
8475430,Brandon,Manning,1990-06-04,D,L,2017-18,65,7,12,19,0.29,0,111,6.31,56,70013.0,17:57,0,0,0,0.0,113,76,17,34,-17,0,1,1,1095.0,0:16,0,0,0,4923.0,1:15,975000
8475436,Mike,Liambas,1989-02-16,LW,L,2017-18,7,0,1,1,0.14,0,3,0.0,21,2221.0,5:17,0,2,2,0.0,15,1,1,0,1,0,0,0,14.0,0:2,0,0,0,0.0,0:0,650000
8475455,Brenden,Dillon,1990-11-13,D,L,2017-18,81,5,17,22,0.27,-7,88,5.68,60,84174.0,17:19,0,0,0,0.0,197,107,11,29,-18,0,0,0,182.0,0:2,0,0,0,6992.0,1:26,3270000
8475462,Radko,Gudas,1990-06-05,D,R,2017-18,70,2,14,16,0.23,0,142,1.41,83,71826.0,17:6,0,0,0,0.0,170,123,7,50,-43,0,0,0,236.0,0:3,0,1,1,7881.0,1:52,3350000
8475613,Nate,Prosser,1986-05-07,D,R,2017-18,57,3,6,9,0.16,8,27,11.11,19,46041.0,13:27,0,0,0,0.0,60,84,11,17,-6,0,0,0,148.0,0:2,1,0,1,4477.0,1:18,650000
8475625,Matt,Irwin,1987-11-29,D,L,2017-18,50,2,6,8,0.16,2,62,3.23,8,40296.0,13:25,0,0,0,0.0,78,54,10,16,-6,0,0,0,71.0,0:1,0,0,0,1829.0,0:36,650000
8475690,Christopher,Tanev,1989-12-20,D,R,2017-18,42,2,9,11,0.26,7,31,6.45,8,49833.0,19:46,0,0,0,0.0,21,70,15,15,0,0,0,0,480.0,0:11,0,2,2,7739.0,3:4,4450000
8475692,Mats,Zuccarello,1987-09-01,RW,L,2017-18,80,16,37,53,0.66,-10,178,8.99,36,90834.0,18:55,21,59,80,26.25,62,67,69,58,11,1,16,17,13221.0,2:45,0,0,0,5353.0,1:6,4500000
8475714,Calle,Jarnkrok,1991-09-25,C,R,2017-18,68,16,19,35,0.51,20,105,15.24,12,64812.0,15:53,266,253,519,51.25,36,31,22,10,12,1,3,4,2760.0,0:40,2,0,2,9305.0,2:16,2000000
8475715,Oscar,Lindberg,1991-10-29,C,L,2017-18,63,9,2,11,0.17,-11,81,11.11,14,44512.0,11:46,99,88,187,52.94,72,27,23,24,-1,0,0,0,580.0,0:9,0,0,0,3180.0,0:50,1700000
8475718,Justin,Holl,1992-01-30,D,R,2017-18,2,2,0,2,1.0,5,2,100.0,0,2083.0,17:21,0,0,0,0.0,2,3,0,1,-1,0,0,0,0.0,0:0,0,0,0,152.0,1:16,650000
8475722,Jason,Zucker,1992-01-16,LW,L,2017-18,82,33,31,64,0.78,8,222,14.86,44,83448.0,16:57,4,14,18,22.22,80,47,54,37,17,7,9,16,10779.0,2:11,1,1,2,2904.0,0:35,2000000
8475726,Tyler,Toffoli,1992-04-24,C,R,2017-18,82,24,23,47,0.57,9,251,9.56,16,79304.0,16:7,9,16,25,36.0,75,17,26,36,-10,6,6,12,9417.0,1:54,0,0,0,2307.0,0:28,4600000
8475727,Ryan,Spooner,1992-01-30,C,L,2017-18,59,13,28,41,0.69,6,107,12.15,4,54133.0,15:17,91,119,210,43.33,66,16,15,36,-21,1,6,7,8666.0,2:26,0,0,0,132.0,0:2,2825000
8475728,Johan,Larsson,1992-07-25,C,L,2017-18,80,4,13,17,0.21,-30,86,4.65,49,67751.0,14:6,348,291,639,54.46,117,47,42,25,17,0,0,0,665.0,0:8,1,1,2,9437.0,1:57,1475000
8475729,Mark,Alt,1991-10-18,D,R,2017-18,15,0,0,0,0.0,-1,11,0.0,2,11204.0,12:26,0,0,0,0.0,17,18,3,4,-1,0,0,0,5.0,0:0,0,0,0,612.0,0:40,650000
8475730,Stephen,Johns,1992-04-18,D,R,2017-18,75,8,7,15,0.2,9,121,6.61,41,78951.0,17:32,0,0,0,0.0,201,155,25,44,-19,0,0,0,2766.0,0:36,0,1,1,10007.0,2:13,725000
8475735,Greg,McKegg,1992-06-17,C,L,2017-18,26,2,2,4,0.15,-4,21,9.52,8,15100.0,9:40,115,118,233,49.36,19,10,3,3,0,0,0,0,210.0,0:8,1,0,1,1745.0,1:7,650000
8475736,Connor,Brickley,1992-02-25,C,L,2017-18,44,4,8,12,0.27,-6,62,6.45,19,31392.0,11:53,3,13,16,18.75,82,28,10,17,-7,0,0,0,260.0,0:5,0,0,0,2312.0,0:52,750000
8475738,Jordan,Weal,1992-04-15,C,R,2017-18,69,8,13,21,0.3,-10,102,7.84,12,53613.0,12:57,53,63,116,45.69,17,25,19,15,4,3,0,3,6282.0,1:31,0,0,0,43.0,0:0,1750000
8475739,Michael,Bournival,1992-05-31,LW,L,2017-18,5,0,0,0,0.0,0,5,0.0,0,2804.0,9:20,0,0,0,0.0,8,5,1,0,1,0,0,0,0.0,0:0,0,0,0,0.0,0:0,650000
8475744,Evgeny,Kuznetsov,1992-05-19,C,L,2017-18,79,27,56,83,1.05,3,187,14.44,48,89168.0,18:48,450,568,1018,44.2,50,26,44,66,-22,7,23,30,16354.0,3:27,1,0,1,275.0,0:3,7800000
8475745,Charlie,Coyle,1992-03-02,C,R,2017-18,66,11,26,37,0.56,8,117,9.4,18,65471.0,16:31,240,220,460,52.17,76,63,29,26,3,0,3,3,5445.0,1:22,1,0,1,4036.0,1:1,3200000
8475747,Patrik,Nemeth,1992-02-08,D,L,2017-18,68,3,12,15,0.22,27,73,4.11,41,81014.0,19:51,0,3,3,0.0,66,185,14,25,-11,0,0,0,173.0,0:2,0,2,2,13551.0,3:19,945000
8475750,Jon,Merrill,1992-02-03,D,L,2017-18,34,1,2,3,0.09,7,30,3.33,22,32815.0,16:5,0,0,0,0.0,35,42,7,18,-11,0,0,0,166.0,0:4,0,0,0,826.0,0:24,1137500
8475752,Tyler,Pitlick,1991-11-01,C,R,2017-18,80,14,13,27,0.34,9,129,10.85,34,65662.0,13:40,13,34,47,27.66,122,57,25,28,-3,0,0,0,422.0,0:5,0,1,1,8299.0,1:43,1000000
8475753,Justin,Faulk,1992-03-20,D,R,2017-18,76,8,23,31,0.41,-26,211,3.79,48,101541.0,22:16,0,0,0,0.0,128,90,63,66,-3,3,16,19,13376.0,2:56,0,0,0,2455.0,0:32,4833333
8475754,Brock,Nelson,1991-10-15,C,L,2017-18,82,19,16,35,0.43,-4,138,13.77,43,72464.0,14:43,389,416,805,48.32,50,52,34,29,5,4,4,8,8950.0,1:49,0,0,0,3274.0,0:39,2500000
8475755,Alex,Petrovic,1992-03-03,D,R,2017-18,67,2,11,13,0.19,-2,60,3.33,98,58920.0,14:39,0,0,0,0.0,142,74,17,33,-16,0,0,0,96.0,0:1,0,0,0,1663.0,0:24,1850000
8475758,Devante,Smith-Pelly,1992-06-14,RW,R,2017-18,75,7,9,16,0.21,-6,103,6.8,38,55570.0,12:20,16,17,33,48.48,151,62,16,18,-2,0,0,0,131.0,0:1,0,0,0,4372.0,0:58,1300000
8475760,Nick,Bjugstad,1992-07-17,C,R,2017-18,82,19,30,49,0.6,5,230,8.26,41,74389.0,15:7,152,146,298,51.01,95,19,52,49,3,1,6,7,7488.0,1:31,0,0,0,60.0,0:0,4100000
8475761,Beau,Bennett,1991-11-27,RW,R,2017-18,6,0,0,0,0.0,-2,6,0.0,0,3889.0,10:48,1,2,3,33.33,9,1,2,0,2,0,0,0,288.0,0:48,0,0,0,0.0,0:0,650000
8475762,Derek,Forbort,1992-03-04,D,L,2017-18,78,1,17,18,0.23,18,78,1.28,49,97288.0,20:47,0,0,0,0.0,142,156,19,79,-60,0,0,0,547.0,0:7,0,0,0,12657.0,2:42,650000
8475763,Kevin,Hayes,1992-05-08,C,L,2017-18,76,25,19,44,0.58,1,172,14.53,18,79131.0,17:21,562,550,1112,50.54,40,36,52,63,-11,6,2,8,5113.0,1:7,2,0,2,10222.0,2:14,2600000
8475764,Cam,Fowler,1991-12-05,D,L,2017-18,67,8,24,32,0.48,3,122,6.56,28,99911.0,24:51,1,1,2,50.0,21,108,27,47,-20,1,9,10,10463.0,2:36,1,1,2,9619.0,2:23,4000000
8475765,Vladimir,Tarasenko,1991-12-13,RW,L,2017-18,80,33,33,66,0.82,15,306,10.78,17,91474.0,19:3,1,3,4,25.0,89,37,32,32,0,6,10,16,16321.0,3:24,0,0,0,658.0,0:8,7500000
8475766,Austin,Watson,1992-01-13,LW,R,2017-18,76,14,5,19,0.25,2,96,14.58,123,56232.0,12:19,27,16,43,62.79,187,78,29,27,2,0,0,0,134.0,0:1,4,1,5,10135.0,2:13,1100000
8475768,Jaden,Schwartz,1992-06-25,LW,L,2017-18,62,24,35,59,0.95,15,157,15.29,26,72141.0,19:23,30,43,73,41.1,52,30,45,17,28,6,5,11,11975.0,3:13,1,0,1,2408.0,0:38,5350000
8475772,Riley,Sheahan,1991-12-07,C,L,2017-18,81,11,21,32,0.4,4,109,10.09,8,71291.0,14:40,560,473,1033,54.21,52,50,34,27,7,1,1,2,2061.0,0:25,0,1,1,11856.0,2:26,2075000
8475780,Chris,Wagner,1991-05-27,RW,R,2017-18,79,7,9,16,0.2,-10,93,7.53,37,62938.0,13:16,230,240,470,48.94,253,49,16,21,-5,1,2,3,1757.0,0:22,2,0,2,10660.0,2:14,637500
8475784,Jeff,Skinner,1992-05-16,LW,L,2017-18,82,24,25,49,0.6,-27,277,8.66,34,82203.0,16:42,26,34,60,43.33,35,24,93,62,31,4,5,9,10334.0,2:6,0,0,0,41.0,0:0,5725000
8475786,Zach,Hyman,1992-06-09,C,R,2017-18,82,15,25,40,0.49,22,148,10.14,37,85400.0,17:21,72,96,168,42.86,117,55,36,31,5,0,0,0,750.0,0:9,1,1,2,13039.0,2:39,2250000
8475788,Alexander,Burmistrov,1991-10-21,C,L,2017-18,24,2,4,6,0.25,-5,18,11.11,12,17247.0,11:58,87,94,181,48.07,20,4,5,4,1,1,1,2,909.0,0:37,0,0,0,1020.0,0:42,900000
8475790,Erik,Gudbranson,1992-01-07,D,R,2017-18,52,2,3,5,0.1,-7,53,3.77,35,57473.0,18:25,0,0,0,0.0,126,81,5,28,-23,0,0,0,134.0,0:2,0,0,0,7925.0,2:32,3500000
8475791,Taylor,Hall,1991-11-14,LW,L,2017-18,76,39,54,93,1.22,14,278,14.03,34,87286.0,19:8,72,76,148,48.65,72,44,81,69,12,13,24,37,13260.0,2:54,1,0,1,459.0,0:6,6000000
8475792,Brett,Connolly,1992-05-02,RW,R,2017-18,70,15,12,27,0.39,-6,67,22.39,30,50412.0,12:0,14,17,31,45.16,72,24,17,19,-2,4,1,5,6042.0,1:26,0,0,0,62.0,0:0,1500000
8475793,Ryan,Johansen,1992-07-31,C,R,2017-18,79,15,39,54,0.68,13,129,11.63,78,87921.0,18:32,810,651,1461,55.44,87,35,46,41,5,1,14,15,14436.0,3:2,0,2,2,4956.0,1:2,8000000
8475794,Tyler,Seguin,1992-01-31,C,R,2017-18,82,40,38,78,0.95,14,335,11.94,43,102870.0,20:54,790,650,1440,54.86,74,44,38,36,2,14,11,25,15510.0,3:9,1,1,2,7599.0,1:32,5750000
8475796,Mark,Pysyk,1992-01-11,D,R,2017-18,82,3,13,16,0.2,-8,106,2.83,20,92305.0,18:45,0,0,0,0.0,102,123,35,63,-28,0,0,0,454.0,0:5,0,0,0,10168.0,2:4,2733333
8475798,Mikael,Granlund,1992-02-26,RW,L,2017-18,77,21,46,67,0.87,13,193,10.88,18,86771.0,18:46,69,56,125,55.2,47,45,33,35,-2,7,12,19,11532.0,2:29,1,2,3,8853.0,1:54,5750000
8475799,Nino,Niederreiter,1992-09-08,RW,L,2017-18,63,18,14,32,0.51,14,133,13.53,36,56705.0,15:0,15,18,33,45.45,58,20,26,21,5,7,1,8,8410.0,2:13,0,0,0,238.0,0:3,5250000
8475807,Joakim,Nordstrom,1992-02-25,LW,L,2017-18,75,2,5,7,0.09,-11,97,2.06,6,47573.0,10:34,36,41,77,46.75,107,41,27,20,7,0,0,0,296.0,0:3,0,0,0,7692.0,1:42,1275000
8475808,Michael,Chaput,1992-04-09,C,L,2017-18,9,0,0,0,0.0,-4,2,0.0,5,5285.0,9:47,43,31,74,58.11,16,2,2,0,2,0,0,0,23.0,0:2,0,0,0,669.0,1:14,687500
8475810,Bryan,Rust,1992-05-11,RW,R,2017-18,69,13,25,38,0.55,11,123,10.57,26,66443.0,16:2,8,23,31,25.81,97,40,31,32,-1,2,2,4,3160.0,0:45,2,1,3,5790.0,1:23,640000
8475820,Joonas,Donskoi,1992-04-13,RW,R,2017-18,66,14,18,32,0.48,10,129,10.85,26,59293.0,14:58,5,7,12,41.67,28,28,46,33,13,1,4,5,6430.0,1:37,0,0,0,108.0,0:1,1900000
8475832,Tom,Kuhnhackl,1992-01-21,RW,L,2017-18,69,2,6,8,0.12,-6,63,3.17,6,41489.0,10:1,2,10,12,16.67,139,50,15,10,5,0,1,1,325.0,0:4,0,1,1,8816.0,2:7,625000
8475834,Marcus,Sorensen,1992-04-07,LW,L,2017-18,32,5,2,7,0.22,-5,25,20.0,5,19486.0,10:8,2,2,4,50.0,26,15,11,6,5,0,0,0,60.0,0:1,0,0,0,1551.0,0:48,700000
8475841,Tim,Heed,1991-01-27,D,R,2017-18,29,3,8,11,0.38,0,51,5.88,8,27874.0,16:1,0,0,0,0.0,8,35,15,21,-6,2,3,5,4966.0,2:51,0,0,0,60.0,0:2,650000
8475844,Kenny,Agostino,1992-04-30,LW,L,2017-18,5,0,1,1,0.2,-1,11,0.0,4,3613.0,12:2,0,1,1,0.0,4,1,1,0,1,0,1,1,918.0,3:3,0,0,0,0.0,0:0,875000
8475848,Brendan,Gallagher,1992-05-06,RW,R,2017-18,82,31,23,54,0.66,-13,278,11.15,34,79494.0,16:9,85,97,182,46.7,90,41,42,27,15,8,9,17,12040.0,2:26,1,0,1,1215.0,0:14,3750000
8475855,Jesper,Fast,1991-12-02,RW,R,2017-18,71,13,20,33,0.46,-10,80,16.25,26,63396.0,14:52,14,24,38,36.84,130,44,22,27,-5,0,0,0,232.0,0:3,0,2,2,8158.0,1:54,1850000
8475857,Kevin,Gravel,1992-03-06,D,L,2017-18,16,0,3,3,0.19,-3,20,0.0,2,13472.0,14:2,0,0,0,0.0,16,15,0,7,-7,0,1,1,643.0,0:40,0,0,0,207.0,0:12,650000
8475868,Anthony,Bitetto,1990-07-15,D,L,2017-18,32,1,2,3,0.09,-1,25,4.0,27,25804.0,13:26,0,0,0,0.0,40,31,7,16,-9,0,0,0,108.0,0:3,0,0,0,328.0,0:10,612500
8475869,Brandon,Davidson,1991-08-21,D,L,2017-18,51,4,3,7,0.14,-13,63,6.35,23,51464.0,16:49,0,0,0,0.0,105,89,13,44,-31,0,0,0,186.0,0:3,0,1,1,5355.0,1:45,1425000
8475878,Freddie,Hamilton,1992-01-01,C,R,2017-18,16,0,1,1,0.06,0,12,0.0,2,8621.0,8:58,28,44,72,38.89,35,0,2,5,-3,0,0,0,10.0,0:0,0,1,1,301.0,0:18,612500
8475902,Zach,Trotman,1990-08-26,D,R,2017-18,3,0,0,0,0.0,-3,6,0.0,0,2301.0,12:47,0,0,0,0.0,1,2,0,0,0,0,0,0,197.0,1:5,0,0,0,0.0,0:0,650000
8475906,John,Klingberg,1992-08-14,D,R,2017-18,82,8,59,67,0.82,12,204,3.92,26,118447.0,24:4,0,0,0,0.0,44,109,31,93,-62,1,22,23,17958.0,3:39,0,0,0,5506.0,1:7,4250000
8475907,Micheal,Ferland,1992-04-20,LW,L,2017-18,77,21,20,41,0.53,5,144,14.58,24,69389.0,15:1,22,35,57,38.6,171,30,35,33,2,6,0,6,8562.0,1:51,0,0,0,141.0,0:1,1750000
8475913,Mark,Stone,1992-05-13,RW,R,2017-18,58,20,42,62,1.07,9,132,15.15,10,71942.0,20:40,33,28,61,54.1,53,39,59,57,2,1,10,11,10776.0,3:5,1,1,2,4165.0,1:11,3500000
8475949,Marek,Hrivik,1991-08-28,LW,R,2017-18,3,0,0,0,0.0,1,2,0.0,0,1531.0,8:30,0,1,1,0.0,4,1,1,4,-3,0,0,0,20.0,0:6,0,0,0,0.0,0:0,650000
8475982,Erik,Burgdoerfer,1988-12-11,D,R,2017-18,2,0,1,1,0.5,2,2,0.0,0,1610.0,13:25,0,0,0,0.0,5,2,0,0,0,0,0,0,0.0,0:0,0,0,0,0.0,0:0,650000
8476166,Taylor,Fedun,1988-06-04,D,R,2017-18,7,0,1,1,0.14,-1,8,0.0,2,6167.0,14:41,0,0,0,0.0,4,10,0,4,-4,0,0,0,316.0,0:45,0,0,0,322.0,0:46,650000
8476177,Matt,Read,1986-06-14,RW,R,2017-18,19,1,0,1,0.05,-2,16,6.25,2,12428.0,10:54,4,8,12,33.33,21,11,5,4,1,0,0,0,53.0,0:2,0,0,0,1320.0,1:9,3625000
8476191,Kevan,Miller,1987-11-15,D,R,2017-18,68,1,15,16,0.24,16,64,1.56,70,79392.0,19:27,0,0,0,0.0,164,111,26,27,-1,0,0,0,306.0,0:4,0,2,2,9101.0,2:13,2500000
8476195,Cory,Conacher,1989-12-14,C,L,2017-18,36,8,4,12,0.33,0,45,17.78,24,21588.0,9:59,4,12,16,25.0,32,14,5,5,0,1,0,1,884.0,0:24,0,0,0,9.0,0:0,650000
8476207,Brian,Gibbons,1988-02-26,LW,L,2017-18,59,12,14,26,0.44,10,72,16.67,20,51084.0,14:25,22,29,51,43.14,35,58,35,10,25,0,0,0,245.0,0:4,3,2,5,9898.0,2:47,650000
8476283,Alex,Broadhurst,1993-03-07,C,L,2017-18,2,0,0,0,0.0,0,1,0.0,2,1205.0,10:2,0,0,0,0.0,0,0,2,2,0,0,0,0,50.0,0:25,0,0,0,0.0,0:0,650000
8476285,Matthew,Peca,1993-04-27,C,L,2017-18,10,2,3,5,0.5,6,17,11.76,0,8202.0,13:40,78,59,137,56.93,11,8,1,5,-4,0,0,0,65.0,0:6,0,0,0,703.0,1:10,650000
8476288,Ryan,Dzingel,1992-03-09,LW,L,2017-18,79,23,18,41,0.52,-17,136,16.91,35,78186.0,16:29,24,32,56,42.86,60,19,27,34,-7,4,4,8,10204.0,2:9,0,0,0,117.0,0:1,1800000
8476292,Ondrej,Palat,1991-03-28,LW,L,2017-18,56,11,24,35,0.62,16,109,10.09,6,57107.0,16:59,7,24,31,22.58,80,48,34,41,-7,4,5,9,7114.0,2:7,1,0,1,3732.0,1:6,5300000
8476293,Scott,Wilson,1992-04-24,C,L,2017-18,69,6,8,14,0.2,-20,98,6.12,8,50536.0,12:12,10,9,19,52.63,128,33,14,14,0,0,1,1,1116.0,0:16,0,0,0,3974.0,0:57,625000
8476302,Frank,Corrado,1993-03-26,D,R,2017-18,5,0,0,0,0.0,-1,6,0.0,2,3450.0,11:30,0,0,0,0.0,5,6,2,1,1,0,0,0,0.0,0:0,0,0,0,0.0,0:0,650000
8476303,Rob,O'Gara,1993-07-06,D,L,2017-18,30,0,3,3,0.1,-7,21,0.0,6,27923.0,15:30,0,0,0,0.0,42,44,4,7,-3,0,0,0,1.0,0:0,0,0,0,2546.0,1:24,925000
8476310,Lukas,Sedlak,1993-02-25,C,L,2017-18,53,4,4,8,0.15,-3,50,8.0,21,29893.0,9:24,191,180,371,51.48,77,26,13,10,3,0,0,0,142.0,0:2,0,0,0,1995.0,0:37,825000
8476312,Josh,Manson,1991-10-07,D,R,2017-18,80,7,30,37,0.46,34,117,5.98,62,97697.0,20:21,0,1,1,0.0,180,99,48,60,-12,0,0,0,452.0,0:5,0,1,1,11736.0,2:26,825000
8476322,Chase,Balisy,1992-02-02,C,L,2017-18,8,0,0,0,0.0,-2,6,0.0,0,4712.0,9:49,11,19,30,36.67,4,2,5,2,3,0,0,0,0.0,0:0,0,0,0,730.0,1:31,650000
8476323,Max,McCormick,1992-05-01,LW,L,2017-18,30,3,2,5,0.17,-5,33,9.09,37,15032.0,8:21,9,12,21,42.86,56,8,5,9,-4,0,0,0,0.0,0:0,0,0,0,584.0,0:19,650000
8476326,Josh,Archibald,1992-10-06,RW,R,2017-18,42,5,6,11,0.26,-2,42,11.9,25,30102.0,11:56,25,40,65,38.46,86,16,7,4,3,0,0,0,407.0,0:9,0,0,0,2242.0,0:53,675000
8476329,Travis,Boyd,1993-09-14,C,L,2017-18,8,0,1,1,0.12,2,2,0.0,2,4236.0,8:49,18,18,36,50.0,2,1,0,0,0,0,0,0,5.0,0:0,0,0,0,0.0,0:0,650000
8476331,Dylan,DeMelo,1993-05-01,D,R,2017-18,63,0,19,19,0.3,-1,67,0.0,34,53698.0,14:12,0,0,0,0.0,75,70,13,16,-3,0,3,3,1728.0,0:27,0,0,0,1073.0,0:17,650000
8476336,Iiro,Pakarinen,1991-08-25,RW,R,2017-18,40,2,1,3,0.08,1,50,4.0,6,24464.0,10:11,1,5,6,16.67,72,17,13,13,0,0,0,0,257.0,0:6,0,0,0,3409.0,1:25,725000
8476344,Tyler,Graovac,1993-04-27,C,L,2017-18,5,0,0,0,0.0,-3,1,0.0,2,2022.0,6:44,1,2,3,33.33,5,1,3,0,3,0,0,0,9.0,0:1,0,0,0,34.0,0:6,625000
8476346,Johnny,Gaudreau,1993-08-13,LW,L,2017-18,80,24,59,83,1.04,2,227,10.57,26,93234.0,19:25,1,4,5,20.0,16,18,44,100,-56,3,21,24,16993.0,3:32,0,0,0,112.0,0:1,6750000
8476356,Tobias,Rieder,1993-01-10,C,L,2017-18,78,12,13,25,0.32,-13,114,10.53,6,68537.0,14:38,22,24,46,47.83,96,41,18,8,10,2,1,3,1425.0,0:18,0,0,0,5597.0,1:11,2225000
8476368,Fredrik,Claesson,1992-11-24,D,L,2017-18,64,1,6,7,0.11,-7,60,1.67,35,58920.0,15:20,0,0,0,0.0,158,84,15,33,-18,0,0,0,211.0,0:3,0,0,0,5004.0,1:18,650000
8476370,Blake,Pietila,1993-02-20,LW,L,2017-18,2,0,0,0,0.0,0,1,0.0,0,1135.0,9:27,0,0,0,0.0,5,0,2,1,1,0,0,0,0.0,0:0,0,0,0,0.0,0:0,667500
8476372,Nick,Seeler,1993-06-03,D,L,2017-18,22,0,4,4,0.18,10,17,0.0,21,19186.0,14:32,0,0,0,0.0,20,25,2,6,-4,0,0,0,65.0,0:2,0,0,0,784.0,0:35,717500
8476374,Sean,Kuraly,1993-01-20,C,L,2017-18,75,6,8,14,0.19,-5,134,4.48,40,55120.0,12:14,335,386,721,46.46,143,22,32,28,4,0,0,0,309.0,0:4,0,1,1,5301.0,1:10,808750
8476381,Andrew,Shaw,1991-07-20,RW,R,2017-18,51,10,10,20,0.39,-8,94,10.64,53,48377.0,15:48,177,149,326,54.29,80,26,19,28,-9,5,2,7,7124.0,2:19,0,0,0,369.0,0:7,3900000
8476386,Shane,Prince,1992-11-16,LW,L,2017-18,14,1,1,2,0.14,-3,20,5.0,11,10082.0,12:0,5,6,11,45.45,10,3,6,6,0,0,0,0,826.0,0:59,0,0,0,12.0,0:0,850000
8476389,Vincent,Trocheck,1993-07-11,C,R,2017-18,82,31,44,75,0.91,-9,287,10.8,54,105112.0,21:21,853,724,1577,54.09,145,55,65,84,-19,13,14,27,17113.0,3:28,3,1,4,8888.0,1:48,4750000
8476392,Adam,Lowry,1993-03-29,C,L,2017-18,45,8,13,21,0.47,9,70,11.43,8,40213.0,14:53,375,296,671,55.89,124,28,21,4,17,1,1,2,2091.0,0:46,0,0,0,5499.0,2:2,1125000
8476393,Nick,Cousins,1993-07-20,C,L,2017-18,71,12,7,19,0.27,-7,119,10.08,31,54795.0,12:51,84,140,224,37.5,117,39,18,24,-6,1,0,1,1384.0,0:19,0,0,0,132.0,0:1,1000000
8476396,Steven,Fogarty,1993-04-19,C,R,2017-18,1,0,0,0,0.0,0,1,0.0,2,736.0,12:16,0,0,0,0.0,2,0,0,1,-1,0,0,0,0.0,0:0,0,0,0,27.0,0:27,750000
8476397,Keegan,Lowe,1993-03-29,D,L,2017-18,2,0,0,0,0.0,-1,4,0.0,0,1668.0,13:54,0,0,0,0.0,1,1,1,1,0,0,0,0,0.0,0:0,0,0,0,139.0,1:9,650000
8476399,Blake,Coleman,1991-11-28,C,L,2017-18,79,13,12,25,0.32,7,146,8.9,50,68235.0,14:23,252,285,537,46.93,216,57,68,21,47,0,0,0,466.0,0:5,3,0,3,10158.0,2:8,660000
8476400,Logan,Shaw,1992-10-05,RW,R,2017-18,72,4,10,14,0.19,-7,105,3.81,12,51313.0,11:52,92,111,203,45.32,110,46,24,21,3,0,0,0,292.0,0:4,0,1,1,7138.0,1:39,650000
8476401,Daniel,Catenacci,1993-03-09,C,L,2017-18,1,0,0,0,0.0,-1,1,0.0,0,663.0,11:3,0,0,0,0.0,1,1,0,0,0,0,0,0,0.0,0:0,0,0,0,0.0,0:0,650000
8476403,Klas,Dahlbeck,1991-07-06,D,L,2017-18,33,1,4,5,0.15,-6,43,2.33,21,32402.0,16:21,0,0,0,0.0,74,34,7,14,-7,0,0,0,116.0,0:3,0,0,0,2118.0,1:4,850000
8476404,Andy,Andreoff,1991-05-17,LW,L,2017-18,45,3,6,9,0.2,-6,47,6.38,50,25352.0,9:23,24,29,53,45.28,77,11,3,7,-4,0,0,0,109.0,0:2,0,0,0,73.0,0:1,677500
8476406,Nick,Shore,1992-09-26,C,R,2017-18,64,5,14,19,0.3,-3,74,6.76,16,54407.0,14:10,352,386,738,47.7,55,20,23,23,0,0,1,1,929.0,0:14,0,0,0,6426.0,1:40,925000
8476407,Andy,Welinski,1993-04-27,D,R,2017-18,7,0,2,2,0.29,-1,6,0.0,0,6793.0,16:10,0,0,0,0.0,4,8,1,5,-4,0,0,0,435.0,1:2,0,0,0,199.0,0:28,925000
8476409,Alan,Quine,1993-02-25,C,L,2017-18,21,0,3,3,0.14,-2,15,0.0,4,14787.0,11:44,40,63,103,38.83,32,9,5,6,-1,0,0,0,109.0,0:5,0,0,0,404.0,0:19,612500
8476410,Josh,Leivo,1993-05-26,LW,R,2017-18,16,1,3,4,0.25,0,25,4.0,6,10145.0,10:34,6,3,9,66.67,2,5,9,6,3,0,0,0,1804.0,1:52,0,0,0,0.0,0:0,612500
8476415,Kyle,Rau,1992-10-24,C,L,2017-18,3,0,1,1,0.33,0,4,0.0,0,1985.0,11:1,0,0,0,0.0,7,0,1,0,1,0,0,0,0.0,0:0,0,0,0,0.0,0:0,700000
8476419,Jean-Gabriel,Pageau,1992-11-11,C,R,2017-18,78,14,15,29,0.37,-14,147,9.52,36,78338.0,16:44,580,553,1133,51.19,131,69,30,41,-11,1,1,2,4837.0,1:2,1,0,1,9297.0,1:59,3100000
8476422,Mike,Reilly,1993-07-13,D,L,2017-18,57,2,16,18,0.32,-5,65,3.08,26,51172.0,14:57,0,0,0,0.0,41,37,8,32,-24,0,6,6,5583.0,1:37,0,0,0,279.0,0:4,725000
8476423,Reid,Boucher,1993-09-08,C,L,2017-18,20,3,2,5,0.25,-12,37,8.11,0,13651.0,11:22,1,2,3,33.33,13,3,8,4,4,1,1,2,1286.0,1:4,0,0,0,35.0,0:1,687500
8476427,Ty,Rattie,1993-02-05,RW,R,2017-18,14,5,4,9,0.64,1,32,15.62,2,12996.0,15:28,0,0,0,0.0,11,4,2,4,-2,0,0,0,1303.0,1:33,0,0,0,0.0,0:0,700000
8476428,Rocco,Grimaldi,1993-02-08,C,R,2017-18,6,1,2,3,0.5,0,7,14.29,0,3471.0,9:38,0,1,1,0.0,3,5,5,3,2,0,0,0,53.0,0:8,0,0,0,0.0,0:0,750000
8476429,Scott,Mayfield,1992-10-14,D,R,2017-18,47,2,10,12,0.26,-6,58,3.45,45,50322.0,17:50,0,0,0,0.0,77,73,5,37,-32,0,0,0,194.0,0:4,0,0,0,4227.0,1:29,625000
8476430,Tomas,Jurco,1992-12-28,LW,L,2017-18,29,6,4,10,0.34,1,44,13.64,12,21954.0,12:37,4,12,16,25.0,22,12,9,6,3,0,0,0,418.0,0:14,0,0,0,281.0,0:9,800000
8476431,Adam,Clendening,1992-10-26,D,R,2017-18,5,0,2,2,0.4,-1,4,0.0,2,4780.0,15:56,0,0,0,0.0,2,6,2,4,-2,0,0,0,104.0,0:20,0,0,0,39.0,0:7,650000
8476432,Boone,Jenner,1993-06-15,C,L,2017-18,75,13,19,32,0.43,1,187,6.95,39,74076.0,16:27,268,215,483,55.49,205,83,34,17,17,2,1,3,5931.0,1:19,0,0,0,4099.0,0:54,2900000
8476436,Dmitrij,Jaskin,1993-03-23,RW,L,2017-18,76,6,11,17,0.22,6,124,4.84,14,56765.0,12:26,2,11,13,15.38,207,46,36,17,19,0,1,1,2200.0,0:28,0,0,0,213.0,0:2,1000000
8476437,Victor,Rask,1993-03-01,C,L,2017-18,71,14,17,31,0.44,0,126,11.11,12,65523.0,15:22,393,323,716,54.89,62,29,48,39,9,4,7,11,9004.0,2:6,0,0,0,55.0,0:0,4000000
8476438,Brandon,Saad,1992-10-27,LW,L,2017-18,82,18,17,35,0.43,-10,237,7.59,14,86120.0,17:30,56,65,121,46.28,29,32,45,16,29,1,0,1,10477.0,2:7,0,0,0,8430.0,1:42,6000000
8476439,Brett,Ritchie,1993-07-01,RW,R,2017-18,71,7,7,14,0.2,1,117,5.98,42,46175.0,10:50,0,1,1,0.0,172,10,9,16,-7,2,1,3,6163.0,1:26,0,0,0,0.0,0:0,1750000
8476440,Markus,Granlund,1993-04-16,C,L,2017-18,53,8,4,12,0.23,-10,93,8.6,8,51694.0,16:15,73,106,179,40.78,47,12,22,8,14,2,1,3,3608.0,1:8,2,0,2,7684.0,2:24,900000
8476441,Joel,Edmundson,1993-06-28,D,L,2017-18,69,7,10,17,0.25,-1,124,5.65,57,85865.0,20:44,0,0,0,0.0,116,150,17,28,-11,0,0,0,1351.0,0:19,0,0,0,9258.0,2:14,1050000
8476442,Matt,Nieto,1992-11-05,LW,L,2017-18,74,15,11,26,0.35,6,84,17.86,14,66196.0,14:54,4,9,13,30.77,27,56,21,12,9,0,0,0,389.0,0:5,1,0,1,10117.0,2:16,1000000
8476443,Xavier,Ouellet,1993-07-29,D,L,2017-18,45,0,7,7,0.16,-3,57,0.0,6,37416.0,13:51,0,0,0,0.0,36,43,6,15,-9,0,0,0,76.0,0:1,0,0,0,3366.0,1:14,1250000
8476447,Miikka,Salomaki,1993-03-09,RW,L,2017-18,58,2,6,8,0.14,-8,51,3.92,34,35773.0,10:16,5,7,12,41.67,114,35,14,8,6,0,0,0,135.0,0:2,0,0,0,822.0,0:14,612500
8476448,William,Karlsson,1993-01-08,C,L,2017-18,82,43,35,78,0.95,49,184,23.37,12,92087.0,18:43,402,435,837,48.03,48,45,78,46,32,8,8,16,11840.0,2:24,4,1,5,8131.0,1:39,1000000
8476449,Scott,Harrington,1993-03-10,D,L,2017-18,32,2,3,5,0.16,0,28,7.14,8,25535.0,13:17,0,0,0,0.0,35,44,7,3,4,0,0,0,53.0,0:1,0,1,1,1620.0,0:50,675000
8476450,Ryan,Sproul,1993-01-13,D,R,2017-18,16,1,4,5,0.31,-6,15,6.67,6,15716.0,16:22,0,0,0,0.0,6,17,5,8,-3,0,1,1,198.0,0:12,0,0,0,583.0,0:36,625000
8476453,Nikita,Kucherov,1993-06-17,RW,L,2017-18,80,39,61,100,1.25,15,279,13.98,42,95143.0,19:49,3,2,5,60.0,31,15,66,79,-13,8,28,36,16841.0,3:30,0,0,0,24.0,0:0,4766667
8476454,Ryan,Nugent-Hopkins,1993-04-12,C,L,2017-18,62,24,24,48,0.77,10,151,15.89,20,67295.0,18:5,374,393,767,48.76,44,39,46,45,1,4,5,9,7295.0,1:57,2,1,3,6021.0,1:37,6000000
8476455,Gabriel,Landeskog,1992-11-23,LW,L,2017-18,78,25,37,62,0.79,16,183,13.66,37,94270.0,20:8,215,203,418,51.44,149,51,54,31,23,8,9,17,16782.0,3:35,0,1,1,5242.0,1:7,5571429
8476456,Jonathan,Huberdeau,1993-06-04,LW,L,2017-18,82,27,42,69,0.84,-2,204,13.24,32,94495.0,19:12,21,23,44,47.73,41,42,54,88,-34,7,12,19,16682.0,3:23,0,0,0,488.0,0:5,5900000
8476457,Adam,Larsson,1992-11-12,D,R,2017-18,63,4,9,13,0.21,10,92,4.35,34,82904.0,21:55,0,0,0,0.0,239,140,26,52,-26,0,0,0,309.0,0:4,0,0,0,9060.0,2:23,4166666
8476458,Ryan,Strome,1993-07-11,C,R,2017-18,82,13,21,34,0.41,-4,147,8.84,33,74883.0,15:13,297,374,671,44.26,43,17,41,45,-4,2,4,6,9543.0,1:56,0,1,1,3726.0,0:45,2500000
8476459,Mika,Zibanejad,1993-04-18,C,R,2017-18,72,27,20,47,0.65,-23,212,12.74,14,77609.0,17:57,654,633,1287,50.82,92,64,49,63,-14,14,7,21,12880.0,2:58,0,1,1,5048.0,1:10,5350000
8476460,Mark,Scheifele,1993-03-15,C,R,2017-18,60,23,37,60,1.0,19,125,18.4,18,74442.0,20:40,594,565,1159,51.25,57,31,47,33,14,8,8,16,11228.0,3:7,2,1,3,4219.0,1:10,6125000
8476461,Sean,Couturier,1992-12-07,C,L,2017-18,82,31,45,76,0.93,34,227,13.66,31,106231.0,21:35,529,472,1001,52.85,74,44,48,37,11,7,7,14,15872.0,3:13,0,0,0,9313.0,1:53,4333333
8476462,Dougie,Hamilton,1993-06-17,D,R,2017-18,82,17,27,44,0.54,1,270,6.3,64,105932.0,21:31,1,2,3,33.33,83,80,31,72,-41,6,6,12,13095.0,2:39,0,0,0,2468.0,0:30,5750000
8476463,Jonas,Brodin,1993-07-12,D,L,2017-18,73,6,15,21,0.29,23,77,7.79,30,94627.0,21:36,0,0,0,0.0,34,139,16,22,-6,0,3,3,3428.0,0:46,0,0,0,10525.0,2:24,4166667
8476464,Duncan,Siemens,1993-09-07,D,L,2017-18,16,1,1,2,0.12,-5,14,7.14,23,11826.0,12:19,0,0,0,0.0,22,21,2,5,-3,0,0,0,2.0,0:0,0,0,0,2498.0,2:36,750000
8476465,Ryan,Murphy,1993-03-31,D,R,2017-18,21,2,3,5,0.24,8,25,8.0,16,23954.0,19:0,0,0,0,0.0,5,19,1,12,-11,1,0,1,1839.0,1:27,0,0,0,379.0,0:18,787500
8476466,Sven,Baertschi,1992-10-05,LW,L,2017-18,53,14,15,29,0.55,3,82,17.07,20,49624.0,15:36,1,6,7,14.29,19,29,19,17,2,7,2,9,6454.0,2:1,0,0,0,24.0,0:0,1850000
8476467,Jamie,Oleksiak,1992-12-21,D,L,2017-18,68,5,12,17,0.25,6,81,6.17,87,67975.0,16:39,0,0,0,0.0,174,76,19,37,-18,1,0,1,1081.0,0:15,0,0,0,7674.0,1:52,964688
8476468,J.T.,Miller,1993-03-14,C,L,2017-18,82,23,35,58,0.71,-4,143,16.08,40,83740.0,17:1,437,368,805,54.29,124,26,43,72,-29,11,7,18,11088.0,2:15,0,0,0,1711.0,0:20,2750000
8476469,Joel,Armia,1993-05-31,RW,R,2017-18,79,12,17,29,0.37,3,128,9.38,22,59731.0,12:36,7,8,15,46.67,86,39,48,16,32,0,4,4,7072.0,1:29,1,1,2,5346.0,1:7,925000
8476470,Nathan,Beaulieu,1992-12-05,D,L,2017-18,59,1,8,9,0.15,-19,67,1.49,36,56453.0,15:56,0,0,0,0.0,45,65,6,30,-24,0,1,1,3158.0,0:53,0,0,0,908.0,0:15,2400000
8476472,Oscar,Klefbom,1993-07-20,D,L,2017-18,66,5,16,21,0.32,-12,203,2.46,18,90475.0,22:50,0,0,0,0.0,49,136,27,43,-16,1,5,6,10926.0,2:45,1,0,1,8924.0,2:15,4167000
8476473,Connor,Murphy,1993-03-26,D,R,2017-18,76,2,12,14,0.18,-3,109,1.83,34,74663.0,16:22,0,0,0,0.0,138,101,15,33,-18,0,0,0,430.0,0:5,0,0,0,5113.0,1:7,3850000
8476474,Stefan,Noesen,1993-02-12,RW,R,2017-18,72,13,14,27,0.38,12,127,10.24,36,57398.0,13:17,20,35,55,36.36,112,41,33,15,18,0,0,0,1479.0,0:20,0,0,0,400.0,0:5,660000
8476476,Joe,Morrow,1992-12-09,D,L,2017-18,56,6,10,16,0.29,-4,83,7.23,26,56223.0,16:43,0,0,0,0.0,79,67,13,48,-35,1,4,5,2129.0,0:38,0,0,0,2167.0,0:38,650000
8476479,Phillip,Danault,1993-02-24,C,L,2017-18,52,8,17,25,0.48,0,94,8.51,34,51754.0,16:35,380,340,720,52.78,59,38,38,20,18,0,2,2,3176.0,1:1,1,0,1,5751.0,1:50,912500
8476480,Vladislav,Namestnikov,1992-11-22,C,L,2017-18,81,22,26,48,0.59,6,155,14.19,45,83046.0,17:5,285,337,622,45.82,79,44,27,24,3,9,7,16,14793.0,3:2,0,0,0,363.0,0:4,1937500
8476483,Rickard,Rakell,1993-05-05,C,R,2017-18,77,34,35,69,0.9,6,230,14.78,14,89705.0,19:25,105,121,226,46.46,115,30,32,53,-21,8,10,18,12595.0,2:43,0,0,0,533.0,0:6,3789444
8476495,Seth,Griffith,1993-01-04,C,R,2017-18,21,2,1,3,0.14,-6,15,13.33,6,13313.0,10:33,0,3,3,0.0,10,4,2,6,-4,0,1,1,818.0,0:38,0,0,0,3.0,0:0,650000
8476525,Colin,Miller,1992-10-29,D,R,2017-18,82,10,31,41,0.5,-4,177,5.65,53,95171.0,19:20,1,0,1,100.0,165,64,35,56,-21,5,12,17,12042.0,2:26,0,1,1,4799.0,0:58,1000000
8476539,Jonathan,Marchessault,1990-12-27,C,R,2017-18,77,27,48,75,0.97,36,268,10.07,40,80871.0,17:30,264,343,607,43.49,99,26,59,48,11,6,10,16,11365.0,2:27,0,0,0,95.0,0:1,750000
8476617,Tomas,Hyka,1993-03-23,RW,R,2017-18,10,1,2,3,0.3,2,15,6.67,0,7232.0,12:3,0,0,0,0.0,6,3,5,4,1,0,1,1,899.0,1:29,0,0,0,0.0,0:0,710000
8476619,Zack,Mitchell,1993-01-07,RW,R,2017-18,23,3,2,5,0.22,-2,17,17.65,4,14544.0,10:32,15,16,31,48.39,26,10,11,0,11,1,0,1,112.0,0:4,0,0,0,840.0,0:36,660000
8476624,Barclay,Goodrow,1993-02-26,RW,L,2017-18,47,7,7,14,0.3,1,57,12.28,28,30693.0,10:53,154,108,262,58.78,68,30,20,9,11,0,0,0,481.0,0:10,1,0,1,2438.0,0:51,650000
8476779,Brad,Hunt,1988-08-24,D,L,2017-18,45,3,15,18,0.4,-5,80,3.75,6,44947.0,16:38,0,1,1,0.0,19,36,22,11,11,2,10,12,6448.0,2:23,0,0,0,190.0,0:4,650000
8476792,Torey,Krug,1991-04-12,D,L,2017-18,76,14,45,59,0.78,0,197,7.11,36,93030.0,20:24,0,0,0,0.0,79,73,35,71,-36,5,19,24,15638.0,3:25,1,0,1,1669.0,0:21,5250000
8476806,J.T.,Brown,1990-07-02,RW,R,2017-18,47,2,5,7,0.15,-5,40,5.0,24,25580.0,9:4,51,66,117,43.59,71,23,11,11,0,0,0,0,123.0,0:2,0,0,0,615.0,0:13,1250000
8476807,Matt,Tennyson,1990-04-23,D,R,2017-18,15,0,0,0,0.0,-8,25,0.0,8,16175.0,17:58,0,0,0,0.0,13,11,1,6,-5,0,0,0,1590.0,1:46,0,0,0,607.0,0:40,650000
8476822,Luke,Glendening,1989-04-28,RW,R,2017-18,69,11,8,19,0.28,-14,88,12.5,17,54644.0,13:11,394,285,679,58.03,137,83,16,10,6,1,0,1,313.0,0:4,2,1,3,11248.0,2:43,1800000
8476826,Yanni,Gourde,1991-12-15,C,L,2017-18,82,25,39,64,0.78,34,136,18.38,50,79497.0,16:9,158,206,364,43.41,57,42,52,35,17,7,6,13,9223.0,1:52,1,1,2,5261.0,1:4,1000000
8476850,Ryan,Murray,1993-09-27,D,L,2017-18,44,1,11,12,0.27,4,34,2.94,8,48672.0,18:26,0,0,0,0.0,31,75,11,18,-7,0,0,0,726.0,0:16,0,0,0,5335.0,2:1,2825000
8476851,Alex,Galchenyuk,1994-02-12,LW,L,2017-18,82,19,32,51,0.62,-31,213,8.92,22,79872.0,16:14,49,60,109,44.95,33,37,29,56,-27,9,15,24,14401.0,2:55,0,0,0,117.0,0:1,4900000
8476853,Morgan,Rielly,1994-03-09,D,L,2017-18,76,6,46,52,0.68,-4,182,3.3,14,98495.0,21:35,0,2,2,0.0,48,84,34,79,-45,1,24,25,10011.0,2:11,0,0,0,5203.0,1:8,5000000
8476854,Hampus,Lindholm,1994-01-20,D,L,2017-18,69,13,18,31,0.45,16,131,9.92,34,94143.0,22:44,0,0,0,0.0,93,97,24,63,-39,3,5,8,7326.0,1:46,0,0,0,9844.0,2:22,5205556
8476855,Nail,Yakupov,1993-10-06,RW,L,2017-18,58,9,7,16,0.28,2,94,9.57,26,37717.0,10:50,0,2,2,0.0,60,9,17,16,1,3,1,4,6516.0,1:52,0,0,0,0.0,0:0,875000
8476856,Matt,Dumba,1994-07-25,D,R,2017-18,82,14,36,50,0.61,15,176,7.95,41,117169.0,23:48,2,0,2,100.0,136,112,22,52,-30,2,10,12,11543.0,2:20,0,1,1,9004.0,1:49,2550000
8476857,Pontus,Aberg,1993-09-23,LW,R,2017-18,53,4,12,16,0.3,9,70,5.71,10,38692.0,12:10,4,8,12,33.33,24,8,12,20,-8,0,1,1,1139.0,0:21,0,0,0,54.0,0:1,650000
8476858,Phillip,Di Giuseppe,1993-10-09,LW,L,2017-18,49,5,8,13,0.27,0,64,7.81,17,30876.0,10:30,0,1,1,0.0,88,14,16,13,3,0,0,0,369.0,0:7,0,0,0,17.0,0:0,725000
8476867,Brendan,Gaunce,1994-03-25,C,L,2017-18,37,4,2,6,0.16,0,55,7.27,10,29548.0,13:18,38,46,84,45.24,48,11,16,16,0,1,0,1,101.0,0:2,0,0,0,4072.0,1:50,750000
8476869,Brady,Skjei,1994-03-26,D,L,2017-18,82,4,21,25,0.3,-27,153,2.61,39,103443.0,21:1,0,0,0,0.0,127,119,27,62,-35,0,6,6,5918.0,1:12,1,0,1,7495.0,1:31,925000
8476870,Stefan,Matteau,1994-02-23,C,L,2017-18,8,0,1,1,0.12,0,8,0.0,0,3937.0,8:12,1,1,2,50.0,8,1,5,3,2,0,0,0,128.0,0:16,0,0,0,0.0,0:0,650000
8476871,Tanner,Pearson,1992-08-10,LW,L,2017-18,82,15,25,40,0.49,11,180,8.33,27,78561.0,15:58,36,37,73,49.32,116,36,25,39,-14,2,3,5,8870.0,1:48,0,0,0,5047.0,1:1,3750000
8476872,Scott,Laughton,1994-05-30,C,L,2017-18,81,10,10,20,0.25,-10,108,9.26,42,54043.0,11:7,314,290,604,51.99,126,27,22,23,-1,0,0,0,364.0,0:4,1,0,1,5105.0,1:3,962500
8476873,Mark,Jankowski,1994-09-13,C,L,2017-18,72,17,8,25,0.35,-7,118,14.41,33,57698.0,13:21,395,415,810,48.77,35,51,33,20,13,2,1,3,3516.0,0:48,2,0,2,4582.0,1:3,925000
8476874,Olli,Maatta,1994-08-22,D,L,2017-18,82,7,22,29,0.35,-1,164,4.27,28,92279.0,18:45,0,0,0,0.0,131,115,17,50,-33,0,8,8,6489.0,1:19,0,0,0,6992.0,1:25,4083333
8476875,Mike,Matheson,1994-02-27,D,L,2017-18,81,10,17,27,0.33,-1,167,5.99,61,103699.0,21:20,0,0,0,0.0,53,137,68,92,-24,1,3,4,5411.0,1:6,0,1,1,8709.0,1:47,925000
8476877,Jordan,Schmaltz,1993-10-08,D,R,2017-18,13,0,1,1,0.08,0,5,0.0,6,8558.0,10:58,0,0,0,0.0,4,12,0,4,-4,0,0,0,317.0,0:24,0,0,0,0.0,0:0,925000
8476878,Zemgus,Girgensons,1994-01-05,C,L,2017-18,71,7,8,15,0.21,-12,113,6.19,26,58404.0,13:42,23,40,63,36.51,134,32,18,12,6,0,0,0,374.0,0:5,2,0,2,6915.0,1:37,1600000
8476879,Cody,Ceci,1993-12-21,D,R,2017-18,82,5,14,19,0.23,-27,143,3.5,12,114830.0,23:20,0,0,0,0.0,163,171,18,40,-22,0,5,5,3132.0,0:38,0,0,0,13614.0,2:46,2800000
8476880,Tom,Wilson,1994-03-29,RW,R,2017-18,78,14,21,35,0.45,10,123,11.38,187,74828.0,15:59,25,29,54,46.3,250,51,40,44,-4,0,1,1,324.0,0:4,1,0,1,8083.0,1:43,2000000
8476881,Tomas,Hertl,1993-11-12,C,L,2017-18,79,22,25,47,0.59,-2,175,12.57,41,85801.0,18:6,587,569,1156,50.78,84,71,60,45,15,6,7,13,11832.0,2:29,1,2,3,7152.0,1:30,3000000
8476882,Teuvo,Teravainen,1994-09-11,LW,L,2017-18,82,23,41,64,0.78,8,185,12.43,14,83085.0,16:53,15,34,49,30.61,26,22,47,33,14,5,15,20,13157.0,2:40,0,0,0,56.0,0:0,2860000
8476884,Derrick,Pouliot,1994-01-16,D,L,2017-18,71,3,19,22,0.31,-22,78,3.85,39,76048.0,17:51,0,0,0,0.0,79,118,24,67,-43,1,8,9,6738.0,1:34,0,1,1,929.0,0:13,800000
8476885,Jacob,Trouba,1994-02-26,D,R,2017-18,55,3,21,24,0.44,9,144,2.08,34,72263.0,21:53,0,0,0,0.0,84,100,28,54,-26,0,3,3,4860.0,1:28,0,1,1,8299.0,2:30,2812500
8476886,Slater,Koekkoek,1994-02-18,D,L,2017-18,35,4,4,8,0.23,4,43,9.3,18,23594.0,11:14,0,0,0,0.0,36,24,3,6,-3,0,0,0,116.0,0:3,0,0,0,967.0,0:27,800000
8476887,Filip,Forsberg,1994-08-13,LW,R,2017-18,67,26,38,64,0.96,27,179,14.53,38,70246.0,17:28,4,5,9,44.44,86,37,49,65,-16,13,8,21,11642.0,2:53,0,1,1,2275.0,0:33,6000000
8476889,Radek,Faksa,1994-01-09,C,L,2017-18,79,17,16,33,0.42,21,118,14.41,36,72386.0,15:16,556,521,1077,51.62,101,56,38,16,22,0,0,0,1125.0,0:14,2,0,2,9422.0,1:59,2200000
8476890,Patrick,Sieloff,1994-05-15,D,L,2017-18,1,1,0,1,1.0,-2,3,33.33,0,671.0,11:11,0,0,0,0.0,1,1,0,0,0,0,0,0,0.0,0:0,0,0,0,0.0,0:0,650000
8476891,Matt,Grzelcyk,1994-01-05,D,L,2017-18,61,3,12,15,0.25,21,82,3.66,22,61271.0,16:44,0,0,0,0.0,45,42,26,24,2,0,2,2,4070.0,1:6,0,0,0,307.0,0:5,858750
8476892,Colton,Parayko,1993-05-12,D,R,2017-18,82,6,29,35,0.43,-7,212,2.83,13,111263.0,22:36,0,0,0,0.0,120,141,54,43,11,2,7,9,9543.0,1:56,0,0,0,9369.0,1:54,5500000
8476894,Brendan,Leipsic,1994-05-19,LW,L,2017-18,58,5,17,22,0.38,-4,95,5.26,14,45714.0,13:8,8,6,14,57.14,32,22,39,33,6,0,0,0,2903.0,0:50,0,0,0,30.0,0:0,650000
8476897,Oskar,Sundqvist,1994-03-23,C,R,2017-18,42,1,4,5,0.12,-5,41,2.44,14,26401.0,10:28,144,179,323,44.58,47,14,20,6,14,0,0,0,1094.0,0:26,0,0,0,2478.0,0:59,675000
8476902,Esa,Lindell,1994-05-23,D,L,2017-18,80,7,20,27,0.34,19,137,5.11,24,105977.0,22:4,0,0,0,0.0,92,123,19,50,-31,2,6,8,7573.0,1:34,0,0,0,9136.0,1:54,2200000
8476905,Chandler,Stephenson,1994-04-22,C,L,2017-18,67,6,12,18,0.27,13,36,16.67,8,47713.0,11:52,40,33,73,54.79,26,33,24,16,8,0,0,0,581.0,0:8,0,0,0,5240.0,1:18,650000
8476906,Shayne,Gostisbehere,1993-04-20,D,L,2017-18,78,13,52,65,0.83,10,221,5.88,25,100411.0,21:27,0,0,0,0.0,53,116,23,52,-29,7,26,33,16878.0,3:36,0,0,0,371.0,0:4,4500000
8476913,Devin,Shore,1994-07-19,C,L,2017-18,82,11,21,32,0.39,-28,123,8.94,14,75908.0,15:25,88,102,190,46.32,71,57,31,19,12,2,9,11,8993.0,1:49,1,1,2,6935.0,1:24,870000
8476915,Jujhar,Khaira,1994-08-13,LW,L,2017-18,69,11,10,21,0.3,-7,73,15.07,47,52609.0,12:42,174,209,383,45.43,128,39,26,32,-6,0,1,1,1439.0,0:20,1,1,2,6180.0,1:29,675000
8476917,Adam,Pelech,1994-08-16,D,L,2017-18,78,3,16,19,0.24,7,106,2.83,28,90203.0,19:16,0,0,0,0.0,100,142,32,47,-15,0,2,2,1534.0,0:19,0,1,1,10587.0,2:15,1600000
8476918,Jimmy,Vesey,1993-05-26,LW,L,2017-18,79,17,11,28,0.35,-18,136,12.5,20,67930.0,14:19,15,17,32,46.88,83,34,46,46,0,1,2,3,6966.0,1:28,0,0,0,791.0,0:10,925000
8476919,Chris,Tierney,1994-07-01,C,L,2017-18,82,17,23,40,0.49,0,118,14.41,8,78719.0,15:59,488,468,956,51.05,26,45,50,55,-5,3,4,7,4878.0,0:59,2,2,4,7684.0,1:33,735000
8476921,Jordan,Martinook,1992-07-25,LW,L,2017-18,81,6,9,15,0.19,-23,112,5.36,45,68126.0,14:1,39,68,107,36.45,128,42,32,8,24,0,0,0,792.0,0:9,0,1,1,8941.0,1:50,1800000
8476923,Damon,Severson,1994-08-07,D,R,2017-18,76,9,15,24,0.32,-8,121,7.44,42,89740.0,19:40,0,0,0,0.0,107,62,26,50,-24,0,4,4,7464.0,1:38,0,0,0,1726.0,0:22,4166666
8476924,Martin,Frk,1993-10-05,RW,R,2017-18,68,11,14,25,0.37,-14,99,11.11,14,41972.0,10:17,0,2,2,0.0,77,10,9,21,-12,5,4,9,8796.0,2:9,0,0,0,7.0,0:0,650000
8476925,Colton,Sissons,1993-11-05,C,R,2017-18,81,9,18,27,0.33,2,120,7.5,42,78218.0,16:5,517,418,935,55.29,136,49,25,30,-5,1,6,7,9424.0,1:56,0,3,3,11246.0,2:18,625000
8476931,Jake,McCabe,1993-10-12,D,L,2017-18,53,3,9,12,0.23,-11,53,5.66,26,62013.0,19:30,0,1,1,0.0,110,79,14,26,-12,1,0,1,1883.0,0:35,0,0,0,6124.0,1:55,1600000
8476934,Brock,McGinn,1994-02-02,LW,L,2017-18,80,16,14,30,0.38,-12,159,10.06,22,69584.0,14:29,17,20,37,45.95,137,17,38,34,4,2,1,3,1618.0,0:20,1,0,1,5764.0,1:12,887500
8476941,Connor,Carrick,1994-04-13,D,R,2017-18,47,4,8,12,0.26,5,55,7.27,27,42680.0,15:8,0,0,0,0.0,42,53,10,21,-11,1,1,2,855.0,0:18,0,0,0,93.0,0:1,750000
8476948,Charles,Hudon,1994-06-23,LW,L,2017-18,72,10,20,30,0.42,-12,179,5.59,38,60605.0,14:1,88,131,219,40.18,126,38,37,25,12,3,5,8,6536.0,1:30,0,1,1,18.0,0:0,650000
8476952,Dominic,Toninato,1994-03-09,C,L,2017-18,37,0,2,2,0.05,0,25,0.0,12,17533.0,7:53,83,116,199,41.71,24,14,3,4,-1,0,0,0,80.0,0:2,0,0,0,450.0,0:12,925000
8476953,Trevor,Carrick,1994-07-04,D,L,2017-18,1,0,0,0,0.0,0,1,0.0,2,452.0,7:32,0,0,0,0.0,0,0,0,0,0,0,0,0,0.0,0:0,0,0,0,0.0,0:0,670000
8476955,Taylor,Leier,1994-02-15,LW,L,2017-18,39,1,4,5,0.13,-7,48,2.08,6,24542.0,10:29,3,2,5,60.0,10,19,11,1,10,0,0,0,658.0,0:16,0,0,0,2738.0,1:10,806558
8476958,Jaccob,Slavin,1994-05-01,D,L,2017-18,82,8,22,30,0.37,1,154,5.19,10,111132.0,22:35,0,0,0,0.0,47,154,77,40,37,1,1,2,2997.0,0:36,0,0,0,12824.0,2:36,742500
8476960,Andreas,Athanasiou,1994-08-06,LW,L,2017-18,71,16,17,33,0.46,-15,170,9.41,16,65238.0,15:18,106,149,255,41.57,24,28,38,36,2,1,2,3,7388.0,1:44,0,0,0,1605.0,0:22,1387500
8476966,Gemel,Smith,1994-04-16,C,L,2017-18,46,6,5,11,0.24,6,42,14.29,17,26031.0,9:25,43,51,94,45.74,33,13,12,5,7,0,0,0,131.0,0:2,0,0,0,324.0,0:7,650000
8476967,Brett,Kulak,1994-01-06,D,L,2017-18,71,2,6,8,0.11,-3,73,2.74,27,55319.0,12:59,0,0,0,0.0,45,49,17,24,-7,0,0,0,181.0,0:2,0,0,0,1095.0,0:15,650000
8476971,Kevin,Roy,1993-05-20,LW,L,2017-18,25,6,1,7,0.28,3,26,23.08,6,20473.0,13:38,0,9,9,0.0,11,7,13,7,6,1,0,1,1751.0,1:10,0,0,0,28.0,0:1,925000
8476975,Cedric,Paquette,1993-08-13,C,L,2017-18,56,5,4,9,0.16,-5,64,7.81,41,34279.0,10:12,234,265,499,46.89,112,32,8,6,2,0,1,1,273.0,0:4,0,0,0,1808.0,0:32,812500
8476979,Erik,Gustafsson,1992-03-14,D,L,2017-18,35,5,11,16,0.46,1,71,7.04,6,38966.0,18:33,0,1,1,0.0,30,45,12,23,-11,0,4,4,2976.0,1:25,0,0,0,61.0,0:1,650000
8476981,Josh,Anderson,1994-05-07,RW,R,2017-18,63,19,11,30,0.48,-1,188,10.11,42,68183.0,18:2,26,36,62,41.94,109,24,41,20,21,1,3,4,5147.0,1:21,0,0,0,3720.0,0:59,1850000
8476982,Danny,O'Regan,1994-01-30,C,R,2017-18,21,0,4,4,0.19,-2,17,0.0,2,12560.0,9:58,58,62,120,48.33,5,6,8,6,2,0,1,1,812.0,0:38,0,0,0,241.0,0:11,858750
8476983,Paul,LaDue,1992-09-06,D,R,2017-18,12,3,1,4,0.33,5,13,23.08,6,10059.0,13:58,0,0,0,0.0,12,11,1,4,-3,1,0,1,590.0,0:49,0,0,0,99.0,0:8,874125
8476988,Matt,Benning,1994-05-25,D,R,2017-18,73,6,15,21,0.29,5,111,5.41,49,75696.0,17:16,0,0,0,0.0,149,82,18,61,-43,0,2,2,3893.0,0:53,0,1,1,2349.0,0:32,925000
8476994,Vinnie,Hinostroza,1994-04-03,LW,R,2017-18,50,7,18,25,0.5,5,86,8.14,10,41459.0,13:49,39,50,89,43.82,26,17,27,16,11,1,4,5,4302.0,1:26,0,0,0,5.0,0:0,717500
8477009,Jake,Dotchin,1994-03-24,D,R,2017-18,48,3,8,11,0.23,17,48,6.25,38,47476.0,16:29,0,0,0,0.0,95,61,4,33,-29,0,0,0,271.0,0:5,0,1,1,1690.0,0:35,812500
8477010,Joseph,Blandisi,1994-07-18,LW,L,2017-18,3,0,0,0,0.0,2,4,0.0,2,2102.0,11:40,0,0,0,0.0,2,2,1,0,1,0,0,0,13.0,0:4,0,0,0,0.0,0:0,680000
8477015,Connor,Brown,1994-01-14,RW,R,2017-18,82,14,14,28,0.34,0,119,11.76,18,73866.0,15:0,59,93,152,38.82,23,28,45,26,19,1,1,2,5747.0,1:10,1,0,1,9008.0,1:49,2100000
8477018,Ben,Hutton,1993-04-20,D,L,2017-18,61,0,6,6,0.1,-9,103,0.0,23,67397.0,18:24,0,1,1,0.0,40,68,26,43,-17,0,2,2,3510.0,0:57,0,1,1,5833.0,1:35,2800000
8477021,Alexander,Kerfoot,1994-08-11,C,L,2017-18,79,19,24,43,0.54,-7,81,23.46,28,63714.0,13:26,207,285,492,42.07,42,35,30,24,6,5,12,17,11763.0,2:28,0,0,0,15.0,0:0,925000
8477034,Jaycob,Megna,1992-12-10,D,L,2017-18,14,0,1,1,0.07,-4,7,0.0,2,13199.0,15:42,0,0,0,0.0,6,30,4,5,-1,0,0,0,159.0,0:11,0,0,0,1727.0,2:3,650000
8477043,Christian,Djoos,1994-08-06,D,L,2017-18,63,3,11,14,0.22,13,60,5.0,10,53050.0,14:2,0,0,0,0.0,22,55,13,33,-20,0,0,0,906.0,0:14,0,0,0,251.0,0:3,650000
8477046,Joakim,Ryan,1993-06-17,D,L,2017-18,62,3,9,12,0.19,13,79,3.8,8,62315.0,16:45,0,0,0,0.0,33,98,14,16,-2,0,0,0,603.0,0:9,0,1,1,1111.0,0:17,650000
8477070,Liam,O'Brien,1994-07-29,C,L,2017-18,3,0,0,0,0.0,0,1,0.0,5,1245.0,6:55,0,2,2,0.0,4,0,1,0,1,0,0,0,0.0,0:0,0,0,0,0.0,0:0,650000
8477073,Kurtis,MacDermid,1994-03-25,D,L,2017-18,34,1,3,4,0.12,-4,19,5.26,57,23672.0,11:36,0,0,0,0.0,77,27,3,23,-20,0,0,0,746.0,0:21,0,0,0,510.0,0:15,650000
8477085,Ashton,Sautner,1994-05-27,D,L,2017-18,5,0,2,2,0.4,4,3,0.0,2,4008.0,13:21,0,0,0,0.0,9,5,0,0,0,0,0,0,0.0,0:0,0,0,0,0.0,0:0,675000
8477205,Andrej,Sustr,1990-11-29,D,R,2017-18,44,2,5,7,0.16,-5,45,4.44,18,33895.0,12:50,0,0,0,0.0,9,33,6,16,-10,0,0,0,135.0,0:3,0,0,0,1211.0,0:27,1950000
8477213,Tim,Schaller,1990-11-16,C,L,2017-18,82,12,10,22,0.27,-5,133,9.02,42,65339.0,13:16,76,90,166,45.78,132,59,31,25,6,0,0,0,422.0,0:5,3,0,3,9304.0,1:53,775000
8477215,Danny,DeKeyser,1990-03-07,D,L,2017-18,65,6,6,12,0.18,2,65,9.23,28,79256.0,20:19,0,0,0,0.0,76,125,6,31,-25,0,0,0,624.0,0:9,0,0,0,8611.0,2:12,5000000
8477220,Nate,Schmidt,1991-07-16,D,L,2017-18,76,5,31,36,0.47,19,103,4.85,16,101419.0,22:14,0,1,1,0.0,41,121,57,57,0,1,10,11,7972.0,1:44,0,0,0,8629.0,1:53,2225000
8477240,Carter,Rowney,1989-05-10,RW,R,2017-18,44,2,3,5,0.11,-13,21,9.52,4,24675.0,9:20,164,146,310,52.9,74,24,5,6,-1,0,0,0,112.0,0:2,1,0,1,5889.0,2:13,612500
8477244,Chad,Ruhwedel,1990-05-07,D,R,2017-18,44,2,3,5,0.11,-8,67,2.99,16,41516.0,15:43,0,0,0,0.0,67,43,11,9,2,0,0,0,389.0,0:8,0,0,0,1470.0,0:33,650000
8477290,Michael,Raffl,1988-12-01,LW,L,2017-18,76,13,9,22,0.29,9,96,13.54,28,60441.0,13:15,39,27,66,59.09,90,50,28,24,4,1,0,1,971.0,0:12,0,0,0,4895.0,1:4,2350000
8477337,John,Gilmour,1993-05-17,D,L,2017-18,28,2,3,5,0.18,-11,61,3.28,14,28856.0,17:10,0,0,0,0.0,27,27,11,29,-18,1,0,1,2029.0,1:12,0,0,0,590.0,0:21,742500
8477341,Andreas,Johnsson,1994-11-21,LW,L,2017-18,9,2,1,3,0.33,-2,19,10.53,0,6318.0,11:42,2,4,6,33.33,5,5,4,5,-1,0,1,1,696.0,1:17,0,0,0,386.0,0:42,750833
8477346,MacKenzie,Weegar,1994-01-07,D,R,2017-18,60,2,6,8,0.13,5,58,3.45,32,52460.0,14:34,0,0,0,0.0,108,69,25,53,-28,0,0,0,1377.0,0:22,0,0,0,508.0,0:8,675000
8477353,Tyler,Motte,1995-03-10,C,L,2017-18,46,5,2,7,0.15,-4,64,7.81,6,30979.0,11:13,6,16,22,27.27,93,27,15,5,10,0,0,0,108.0,0:2,0,0,0,2418.0,0:52,925000
8477355,Will,Butcher,1995-01-06,D,L,2017-18,81,5,39,44,0.54,1,88,5.68,8,78072.0,16:3,0,0,0,0.0,21,62,20,36,-16,3,20,23,12864.0,2:38,0,0,0,240.0,0:2,925000
8477359,Tucker,Poolman,1993-06-08,D,R,2017-18,24,1,1,2,0.08,2,27,3.7,0,18091.0,12:33,0,0,0,0.0,20,18,5,14,-9,0,0,0,54.0,0:2,0,0,0,79.0,0:3,925000
8477369,Carson,Soucy,1994-07-27,D,L,2017-18,3,0,0,0,0.0,-2,4,0.0,2,2672.0,14:50,0,0,0,0.0,4,3,1,0,1,0,0,0,4.0,0:1,0,0,0,113.0,0:37,925000
8477380,Jonny,Brodzinski,1993-06-19,C,L,2017-18,35,4,2,6,0.17,4,53,7.55,6,19961.0,9:30,4,6,10,40.0,35,9,5,6,-1,0,0,0,533.0,0:15,0,0,0,55.0,0:1,650000
8477392,Hudson,Fasching,1995-07-28,RW,R,2017-18,5,0,0,0,0.0,-1,1,0.0,2,2910.0,9:42,0,0,0,0.0,7,2,0,0,0,0,0,0,684.0,2:16,0,0,0,0.0,0:0,925000
8477399,Tyrell,Goulbourne,1994-01-26,LW,L,2017-18,9,0,0,0,0.0,-2,2,0.0,2,3015.0,5:35,0,0,0,0.0,15,2,1,0,1,0,0,0,0.0,0:0,0,0,0,0.0,0:0,677500
8477401,John,Hayden,1995-02-14,RW,R,2017-18,47,4,9,13,0.28,-4,56,7.14,54,30526.0,10:49,12,12,24,50.0,118,23,18,8,10,0,0,0,660.0,0:14,1,0,1,2406.0,0:51,925000
8477402,Pavel,Buchnevich,1995-04-17,RW,L,2017-18,74,14,29,43,0.58,-3,136,10.29,20,66663.0,15:0,12,34,46,26.09,51,35,39,43,-4,5,12,17,11854.0,2:40,0,0,0,272.0,0:3,925000
8477404,Jake,Guentzel,1994-10-06,C,L,2017-18,82,22,26,48,0.59,-9,171,12.87,42,81112.0,16:29,65,65,130,50.0,142,46,36,18,18,7,5,12,8692.0,1:46,0,0,0,1114.0,0:13,734167
8477406,Mattias,Janmark,1992-12-08,C,L,2017-18,81,19,15,34,0.42,-14,136,13.97,24,82261.0,16:55,71,109,180,39.44,15,41,32,33,-1,4,1,5,7500.0,1:32,2,0,2,6797.0,1:23,700000
8477407,Anthony,Duclair,1995-08-26,LW,L,2017-18,56,11,12,23,0.41,-5,97,11.34,16,44632.0,13:17,1,1,2,50.0,46,26,21,8,13,3,0,3,5726.0,1:42,0,0,0,60.0,0:1,1200000
8477413,Sven,Andrighetto,1993-03-21,RW,L,2017-18,50,8,14,22,0.44,-15,111,7.21,10,43459.0,14:29,7,15,22,31.82,38,18,22,15,7,3,6,9,7307.0,2:26,0,0,0,293.0,0:5,1400000
8477415,Anton,Slepyshev,1994-05-13,LW,R,2017-18,50,6,6,12,0.24,-4,73,8.22,8,35431.0,11:48,1,6,7,14.29,61,18,25,18,7,0,0,0,381.0,0:7,0,0,0,175.0,0:3,925000
8477416,Oliver,Bjorkstrand,1995-04-10,RW,R,2017-18,82,11,29,40,0.49,4,163,6.75,9,70318.0,14:17,1,7,8,12.5,64,43,26,25,1,3,6,9,8538.0,1:44,0,0,0,32.0,0:0,655833
8477417,Peter,Cehlarik,1995-08-02,LW,L,2017-18,6,1,1,2,0.33,2,3,33.33,2,5016.0,13:56,2,2,4,50.0,3,3,0,1,-1,0,0,0,726.0,2:1,0,0,0,0.0,0:0,742500
8477425,Miles,Wood,1995-09-13,LW,L,2017-18,76,19,13,32,0.42,-6,170,11.18,84,56813.0,12:27,2,1,3,66.67,75,22,24,36,-12,3,0,3,4347.0,0:57,0,0,0,34.0,0:0,925000
8477426,Nick,Paul,1995-03-20,LW,L,2017-18,11,1,0,1,0.09,-4,11,9.09,0,5212.0,7:53,1,3,4,25.0,16,4,2,4,-2,0,0,0,0.0,0:0,0,0,0,76.0,0:6,670000
8477428,Justin,Auger,1994-05-14,RW,R,2017-18,2,0,0,0,0.0,-1,1,0.0,0,959.0,7:59,0,0,0,0.0,2,2,0,0,0,0,0,0,0.0,0:0,0,0,0,0.0,0:0,650000
8477429,Andrew,Copp,1994-07-08,C,L,2017-18,82,9,19,28,0.34,17,96,9.38,14,67569.0,13:44,296,275,571,51.84,99,51,29,30,-1,0,0,0,432.0,0:5,2,1,3,9548.0,1:56,1000000
8477433,Ben,Harpur,1995-01-12,D,L,2017-18,41,0,1,1,0.02,-21,26,0.0,21,36620.0,14:53,0,0,0,0.0,71,35,8,19,-11,0,0,0,36.0,0:0,0,0,0,4237.0,1:43,653333
8477444,Andre,Burakovsky,1995-02-09,LW,L,2017-18,56,12,13,25,0.45,3,84,14.29,27,46497.0,13:50,18,15,33,54.55,40,26,23,34,-11,2,2,4,4021.0,1:11,0,0,0,0.0,0:0,3000000
8477446,Michael,McCarron,1995-03-07,RW,R,2017-18,18,0,1,1,0.06,-1,15,0.0,32,9463.0,8:45,60,63,123,48.78,61,14,3,5,-2,0,0,0,93.0,0:5,0,0,0,3.0,0:0,863333
8477447,Shea,Theodore,1995-08-03,D,L,2017-18,61,6,23,29,0.48,5,144,4.17,14,74489.0,20:21,0,0,0,0.0,29,70,25,42,-17,1,8,9,9342.0,2:33,0,0,0,1692.0,0:27,863333
8477448,Marko,Dano,1994-11-30,C,L,2017-18,23,2,1,3,0.13,-2,22,9.09,6,9918.0,7:11,1,1,2,50.0,26,7,3,4,-1,0,0,0,221.0,0:9,0,0,0,77.0,0:3,850000
8477450,Jason,Dickinson,1995-07-04,C,L,2017-18,27,0,2,2,0.07,-2,16,0.0,17,13825.0,8:32,69,73,142,48.59,45,5,5,5,0,0,0,0,78.0,0:2,0,0,0,56.0,0:2,894167
8477451,Ryan,Hartman,1994-09-20,RW,R,2017-18,78,11,20,31,0.4,1,129,8.53,72,61131.0,13:3,93,110,203,45.81,113,38,26,20,6,1,1,2,3097.0,0:39,0,0,0,1425.0,0:18,863333
8477452,Ian,McCoshen,1995-08-05,D,L,2017-18,38,3,1,4,0.11,-10,26,11.54,25,34373.0,15:4,0,0,0,0.0,71,43,3,31,-28,0,0,0,45.0,0:1,0,0,0,2503.0,1:5,925000
8477453,Chris,Bigras,1995-02-22,D,L,2017-18,15,0,1,1,0.07,-2,8,0.0,2,12474.0,13:51,0,0,0,0.0,12,15,1,8,-7,0,0,0,327.0,0:21,0,0,0,1475.0,1:38,843333
8477454,Adam,Erne,1995-04-20,LW,L,2017-18,23,3,1,4,0.17,-1,29,10.34,11,13964.0,10:7,5,3,8,62.5,37,8,4,4,0,0,0,0,106.0,0:4,0,0,0,24.0,0:1,874167
8477455,Jacob,de la Rose,1995-05-20,LW,L,2017-18,55,4,8,12,0.22,-2,53,7.55,29,39090.0,11:50,206,262,468,44.02,127,36,20,19,1,0,0,0,59.0,0:1,1,0,1,3054.0,0:55,725000
8477456,J.T.,Compher,1995-04-08,LW,R,2017-18,69,13,10,23,0.33,-29,131,9.92,20,66239.0,15:59,273,332,605,45.12,45,65,16,13,3,4,3,7,9054.0,2:11,2,0,2,5803.0,1:24,925000
8477458,Valentin,Zykov,1995-05-15,LW,R,2017-18,10,3,4,7,0.7,4,18,16.67,2,8224.0,13:42,0,1,1,0.0,3,1,5,4,1,0,0,0,606.0,1:0,0,0,0,0.0,0:0,705000
8477460,Laurent,Dauphin,1995-03-27,C,L,2017-18,2,0,0,0,0.0,-1,1,0.0,2,867.0,7:13,5,4,9,55.56,1,2,0,0,0,0,0,0,0.0,0:0,0,0,0,0.0,0:0,745000
8477461,Remi,Elie,1995-04-16,LW,L,2017-18,72,6,8,14,0.19,4,70,8.57,18,44297.0,10:15,5,9,14,35.71,101,20,20,25,-5,0,0,0,237.0,0:3,0,0,0,960.0,0:13,728333
8477462,Robert,Hagg,1995-02-08,D,L,2017-18,70,3,6,9,0.13,5,89,3.37,32,76183.0,18:8,0,0,0,0.0,238,100,8,36,-28,0,0,0,333.0,0:4,0,0,0,6780.0,1:36,894167
8477463,Steven,Santini,1995-03-07,D,R,2017-18,36,2,8,10,0.28,0,56,3.57,21,43792.0,20:16,0,1,1,0.0,113,73,4,13,-9,0,0,0,65.0,0:1,0,1,1,6666.0,3:5,925000
8477464,Nic,Petan,1995-03-22,LW,L,2017-18,15,2,0,2,0.13,0,16,12.5,6,7572.0,8:24,12,13,25,48.0,4,4,6,4,2,0,0,0,547.0,0:36,0,0,0,0.0,0:0,758333
8477467,Gustav,Olofsson,1994-12-01,D,L,2017-18,41,0,8,8,0.2,0,22,0.0,14,31424.0,12:46,0,0,0,0.0,23,44,5,12,-7,0,0,0,156.0,0:3,0,0,0,665.0,0:16,725000
8477471,Dillon,Heatherington,1995-05-09,D,L,2017-18,6,0,1,1,0.17,3,6,0.0,26,3906.0,10:51,0,0,0,0.0,7,2,0,1,-1,0,0,0,0.0,0:0,0,0,0,207.0,0:34,770833
8477472,Carl,Dahlstrom,1995-01-28,D,L,2017-18,11,0,3,3,0.27,-2,12,0.0,0,11559.0,17:30,1,0,1,100.0,6,9,2,7,-5,0,0,0,14.0,0:1,0,0,0,948.0,1:26,750833
8477473,Justin,Bailey,1995-07-01,RW,R,2017-18,12,3,1,4,0.33,-2,19,15.79,2,8120.0,11:16,0,2,2,0.0,19,9,4,2,2,0,0,0,45.0,0:3,0,0,0,547.0,0:45,670000
8477474,Madison,Bowey,1995-04-22,D,R,2017-18,51,0,12,12,0.24,-3,47,0.0,24,41963.0,13:42,0,0,0,0.0,48,42,11,38,-27,0,0,0,56.0,0:1,0,0,0,876.0,0:17,703333
8477476,Artturi,Lehkonen,1995-07-04,LW,L,2017-18,66,12,9,21,0.32,-11,164,7.32,20,65288.0,16:29,11,19,30,36.67,71,23,27,19,8,3,1,4,7666.0,1:56,1,0,1,6067.0,1:31,839166
8477478,William,Carrier,1994-12-20,LW,L,2017-18,37,1,2,3,0.08,-3,52,1.92,19,19627.0,8:50,0,0,0,0.0,113,10,15,6,9,0,0,0,230.0,0:6,0,0,0,39.0,0:1,689167
8477479,Tyler,Bertuzzi,1995-02-24,LW,L,2017-18,48,7,17,24,0.5,-7,83,8.43,39,41472.0,14:24,1,7,8,12.5,53,38,13,14,-1,1,1,2,4105.0,1:25,0,0,0,313.0,0:6,661667
8477488,Brett,Pesce,1994-11-15,D,R,2017-18,65,3,16,19,0.29,-6,88,3.41,18,81526.0,20:54,0,1,1,0.0,57,101,38,24,14,0,0,0,1110.0,0:17,0,0,0,9175.0,2:21,809167
8477491,Nicholas,Baptiste,1995-08-04,RW,R,2017-18,33,4,2,6,0.18,-4,45,8.89,14,19734.0,9:58,2,7,9,22.22,16,3,4,8,-4,0,1,1,1608.0,0:48,0,0,0,350.0,0:10,718333
8477492,Nathan,MacKinnon,1995-09-01,C,R,2017-18,74,39,58,97,1.31,11,284,13.73,55,88379.0,19:54,485,672,1157,41.92,38,22,36,41,-5,12,20,32,16020.0,3:36,0,1,1,1359.0,0:18,6300000
8477493,Aleksander,Barkov,1995-09-02,C,L,2017-18,79,27,51,78,0.99,9,256,10.55,14,104612.0,22:4,908,789,1697,53.51,30,67,82,63,19,5,12,17,16030.0,3:22,5,0,5,8310.0,1:45,5900000
8477494,Jonathan,Drouin,1995-03-28,LW,L,2017-18,77,13,33,46,0.6,-28,164,7.93,30,81309.0,17:35,447,604,1051,42.53,55,27,56,58,-2,4,18,22,15129.0,3:16,0,0,0,508.0,0:6,5500000
8477495,Seth,Jones,1994-10-03,D,R,2017-18,78,16,41,57,0.73,10,249,6.43,30,115137.0,24:36,0,0,0,0.0,92,124,67,55,12,7,17,24,12643.0,2:42,0,0,0,8502.0,1:49,5400000
8477496,Elias,Lindholm,1994-12-02,C,R,2017-18,81,16,28,44,0.54,-8,153,10.46,18,86959.0,17:53,432,361,793,54.48,98,41,48,34,14,6,3,9,12736.0,2:37,0,1,1,6529.0,1:20,2700000
8477497,Sean,Monahan,1994-10-12,C,L,2017-18,74,31,33,64,0.86,3,202,15.35,24,82948.0,18:40,709,698,1407,50.39,35,17,51,42,9,9,10,19,16109.0,3:37,0,0,0,1230.0,0:16,6375000
8477498,Darnell,Nurse,1995-02-04,D,L,2017-18,82,6,20,26,0.32,15,194,3.09,67,109469.0,22:14,0,0,0,0.0,161,153,28,72,-44,0,0,0,2365.0,0:28,0,0,0,10970.0,2:13,863333
8477499,Rasmus,Ristolainen,1994-10-27,D,R,2017-18,73,6,35,41,0.56,-25,182,3.3,48,116067.0,26:29,0,0,0,0.0,206,111,12,47,-35,1,22,23,16134.0,3:41,0,0,0,12106.0,2:45,5400000
8477500,Bo,Horvat,1995-04-05,C,L,2017-18,64,22,22,44,0.69,-1,158,13.92,10,74301.0,19:20,712,612,1324,53.78,35,29,22,25,-3,10,3,13,10337.0,2:41,1,0,1,6075.0,1:34,5500000
8477502,Samuel,Morin,1995-07-12,D,L,2017-18,2,0,0,0,0.0,1,1,0.0,4,1897.0,15:48,0,0,0,0.0,7,1,1,1,0,0,0,0,0.0,0:0,0,0,0,292.0,2:26,863333
8477503,Max,Domi,1995-03-02,LW,L,2017-18,82,9,36,45,0.55,-8,150,6.0,73,82158.0,16:41,185,227,412,44.9,49,28,40,62,-22,1,8,9,12800.0,2:36,0,0,0,242.0,0:2,863333
8477504,Josh,Morrissey,1995-03-28,D,L,2017-18,81,7,19,26,0.32,15,102,6.86,47,99403.0,20:27,1,1,2,50.0,139,168,22,48,-26,0,1,1,1591.0,0:19,0,0,0,11783.0,2:25,863333
8477505,Alexander,Wennberg,1994-09-22,C,L,2017-18,66,8,27,35,0.53,22,74,10.81,12,71800.0,18:7,350,424,774,45.22,28,46,36,15,21,3,2,5,10178.0,2:34,0,1,1,4037.0,1:1,4900000
8477506,Ryan,Pulock,1994-10-06,D,R,2017-18,68,10,22,32,0.47,-4,184,5.43,14,75096.0,18:24,0,0,0,0.0,113,86,25,35,-10,5,6,11,6812.0,1:40,0,0,0,446.0,0:6,863333
8477507,Nikita,Zadorov,1995-04-16,D,L,2017-18,77,7,13,20,0.26,4,94,7.45,103,89929.0,19:27,0,0,0,0.0,278,106,13,36,-23,0,1,1,659.0,0:8,0,0,0,9576.0,2:4,2150000
8477508,Curtis,Lazar,1995-02-02,C,R,2017-18,65,2,10,12,0.18,-8,65,3.08,23,38443.0,9:51,48,73,121,39.67,130,26,9,18,-9,0,0,0,298.0,0:4,0,0,0,1679.0,0:25,950000
8477509,Mirco,Mueller,1995-03-21,D,L,2017-18,28,0,4,4,0.14,1,19,0.0,4,28015.0,16:40,0,0,0,0.0,15,42,13,11,2,0,0,0,197.0,0:7,0,2,2,3436.0,2:2,850000
8477510,Kerby,Rychel,1994-10-07,LW,L,2017-18,4,1,1,2,0.5,-2,7,14.29,2,2647.0,11:1,2,2,4,50.0,13,2,1,1,0,0,0,0,183.0,0:45,0,0,0,0.0,0:0,863333
8477511,Anthony,Mantha,1994-09-16,RW,L,2017-18,80,24,24,48,0.6,-1,190,12.63,52,83010.0,17:17,17,35,52,32.69,91,36,36,67,-31,9,3,12,10636.0,2:12,0,0,0,93.0,0:1,863333
8477512,Frederik,Gauthier,1995-04-26,C,L,2017-18,9,1,0,1,0.11,-4,12,8.33,0,4721.0,8:44,27,28,55,49.09,12,5,3,5,-2,0,0,0,28.0,0:3,0,0,0,710.0,1:18,863333
8477527,Ross,Johnston,1994-02-18,LW,L,2017-18,24,3,3,6,0.25,0,19,15.79,62,13442.0,9:20,1,4,5,20.0,46,11,7,2,5,0,0,0,50.0,0:2,0,0,0,30.0,0:1,666667
8477529,Colby,Cave,1994-12-26,C,L,2017-18,3,0,0,0,0.0,0,2,0.0,2,2062.0,11:27,10,14,24,41.67,3,2,1,0,1,0,0,0,0.0,0:0,0,0,0,207.0,1:9,655000
8477541,Dakota,Mermis,1994-01-05,D,L,2017-18,9,0,0,0,0.0,-2,7,0.0,0,5932.0,10:59,0,0,0,0.0,5,6,0,1,-1,0,0,0,55.0,0:6,0,0,0,3.0,0:0,626667
8477573,Nathan,Walker,1994-02-07,LW,L,2017-18,9,1,0,1,0.11,0,6,16.67,6,5101.0,9:26,0,0,0,0.0,18,1,0,1,-1,0,0,0,74.0,0:8,0,0,0,172.0,0:19,650000
8477591,Josh,Jooris,1990-07-14,RW,R,2017-18,40,3,3,6,0.15,-7,50,6.0,16,23437.0,9:45,75,88,163,46.01,51,11,12,3,9,0,0,0,211.0,0:5,0,0,0,2182.0,0:54,775000
8477634,Trevor,Murphy,1995-07-17,D,L,2017-18,8,1,2,3,0.38,5,5,20.0,0,6833.0,14:14,0,0,0,0.0,6,9,3,3,0,0,0,0,368.0,0:46,0,0,0,30.0,0:3,640000
8477642,Rinat,Valiev,1995-05-11,D,L,2017-18,2,0,0,0,0.0,0,2,0.0,2,1417.0,11:48,0,0,0,0.0,0,2,1,1,0,0,0,0,102.0,0:51,0,0,0,18.0,0:9,778333
8477810,Joel,Hanley,1991-06-08,D,L,2017-18,5,0,0,0,0.0,0,2,0.0,0,3339.0,11:7,0,0,0,0.0,1,4,0,0,0,0,0,0,17.0,0:3,0,0,0,12.0,0:2,725000
8477839,Conor,Sheary,1992-06-08,LW,L,2017-18,79,18,12,30,0.38,2,142,12.68,10,66110.0,13:56,4,7,11,36.36,29,31,36,37,-1,2,1,3,5629.0,1:11,0,0,0,69.0,0:0,3000000
8477845,Trevor,van Riemsdyk,1991-07-24,D,R,2017-18,79,3,13,16,0.2,9,111,2.7,20,80818.0,17:3,0,0,0,0.0,25,113,45,19,26,0,0,0,944.0,0:11,0,0,0,6263.0,1:19,825000
8477846,Ryan,Carpenter,1991-01-18,C,R,2017-18,52,9,6,15,0.29,1,85,10.59,11,39310.0,12:35,200,198,398,50.25,76,17,17,17,0,0,0,0,1143.0,0:21,1,0,1,4202.0,1:20,650000
8477850,Christian,Folin,1991-02-09,D,R,2017-18,65,3,10,13,0.2,1,58,5.17,30,61063.0,15:39,0,0,0,0.0,167,106,8,34,-26,0,0,0,210.0,0:3,0,1,1,4203.0,1:4,850000
8477851,Jordan,Oesterle,1992-06-25,D,L,2017-18,55,5,10,15,0.27,-11,99,5.05,8,67701.0,20:30,0,0,0,0.0,62,97,15,46,-31,1,2,3,3532.0,1:4,0,0,0,2233.0,0:40,650000
8477901,Daniel,Carr,1991-11-01,LW,L,2017-18,38,6,10,16,0.42,2,52,11.54,8,27665.0,12:8,3,14,17,17.65,30,16,12,12,0,2,1,3,2551.0,1:7,0,0,0,5.0,0:0,725000
8477903,Garnet,Hathaway,1991-11-23,RW,R,2017-18,59,4,9,13,0.22,3,68,5.88,88,40826.0,11:31,1,9,10,10.0,154,32,17,17,0,0,0,0,139.0,0:2,1,0,1,3907.0,1:6,650000
8477919,Frederick,Gaudreau,1993-05-01,C,R,2017-18,20,0,3,3,0.15,0,14,0.0,2,10993.0,9:9,69,70,139,49.64,8,8,5,2,3,0,0,0,10.0,0:0,0,0,0,137.0,0:6,666666
8477922,Melker,Karlsson,1990-07-18,C,R,2017-18,71,8,11,19,0.27,-5,76,10.53,26,56439.0,13:14,12,6,18,66.67,81,69,24,22,2,0,0,0,182.0,0:2,1,0,1,5939.0,1:23,2000000
8477929,Dennis,Rasmussen,1990-07-03,C,L,2017-18,27,1,3,4,0.15,4,19,5.26,8,14431.0,8:54,34,36,70,48.57,31,15,9,4,5,0,0,0,81.0,0:3,0,0,0,1782.0,1:6,725000
8477930,Pierre-Edouard,Bellemare,1985-03-06,LW,L,2017-18,72,6,10,16,0.22,5,92,6.52,14,53254.0,12:19,355,339,694,51.15,41,63,49,25,24,0,0,0,537.0,0:7,0,0,0,9276.0,2:8,1450000
8477931,Tomas,Nosek,1992-09-01,LW,L,2017-18,67,7,8,15,0.22,6,92,7.61,14,44590.0,11:5,35,30,65,53.85,53,24,36,14,22,0,0,0,438.0,0:6,1,1,2,6090.0,1:30,612500
8477932,Aaron,Ekblad,1996-02-07,D,R,2017-18,82,16,22,38,0.46,9,189,8.47,71,115074.0,23:23,0,0,0,0.0,69,121,40,99,-59,5,6,11,10463.0,2:7,0,0,0,11029.0,2:14,7500000
8477933,Sam,Reinhart,1995-11-06,C,R,2017-18,82,25,25,50,0.61,-24,188,13.3,26,84139.0,17:6,56,86,142,39.44,48,42,29,29,0,12,9,21,16219.0,3:17,0,0,0,56.0,0:0,894167
8477934,Leon,Draisaitl,1995-10-27,C,L,2017-18,78,25,45,70,0.9,-7,194,12.89,30,90419.0,19:19,672,526,1198,56.09,40,24,78,84,-6,6,5,11,13255.0,2:49,3,1,4,4735.0,1:0,8500000
8477935,Sam,Bennett,1996-06-20,C,L,2017-18,82,11,15,26,0.32,-18,157,7.01,59,70850.0,14:24,119,100,219,54.34,140,34,54,32,22,1,2,3,6665.0,1:21,0,0,0,3477.0,0:42,1950000
8477936,Michael,Dal Colle,1996-06-20,LW,L,2017-18,4,0,0,0,0.0,0,1,0.0,0,3205.0,13:21,0,0,0,0.0,1,1,1,0,1,0,0,0,282.0,1:10,0,0,0,0.0,0:0,863333
8477937,Jake,Virtanen,1996-08-17,RW,R,2017-18,75,10,10,20,0.27,-11,130,7.69,46,53939.0,11:59,7,15,22,31.82,156,29,51,32,19,0,0,0,1281.0,0:17,0,0,0,55.0,0:0,894167
8477938,Haydn,Fleury,1996-07-08,D,L,2017-18,67,0,8,8,0.12,-2,86,0.0,14,67516.0,16:47,0,0,0,0.0,85,94,21,34,-13,0,0,0,369.0,0:5,0,0,0,3620.0,0:54,863333
8477939,William,Nylander,1996-05-01,C,R,2017-18,82,20,41,61,0.74,20,184,10.87,10,82107.0,16:41,334,316,650,51.38,21,18,68,54,14,5,7,12,9926.0,2:1,0,0,0,111.0,0:1,894167
8477940,Nikolaj,Ehlers,1996-02-14,LW,L,2017-18,82,29,31,60,0.73,14,231,12.55,26,79116.0,16:4,5,4,9,55.56,39,27,38,58,-20,7,6,13,10003.0,2:1,0,0,0,79.0,0:0,894167
8477941,Nick,Ritchie,1995-12-05,LW,L,2017-18,76,10,17,27,0.36,3,122,8.2,72,60110.0,13:10,6,11,17,35.29,221,27,10,22,-12,1,2,3,1969.0,0:25,0,0,0,1573.0,0:20,894167
8477942,Kevin,Fiala,1996-07-22,LW,L,2017-18,80,23,25,48,0.6,20,187,12.3,26,72709.0,15:8,0,5,5,0.0,34,27,42,56,-14,4,9,13,11031.0,2:17,0,0,0,18.0,0:0,863333
8477943,Brendan,Perlini,1996-04-27,LW,L,2017-18,74,17,13,30,0.41,-2,129,13.18,28,64432.0,14:30,5,6,11,45.45,83,34,16,22,-6,5,6,11,7870.0,1:46,0,0,0,87.0,0:1,863333
8477944,Jakub,Vrana,1996-02-28,LW,L,2017-18,73,13,14,27,0.37,2,133,9.77,12,54744.0,12:29,13,12,25,52.0,31,16,28,37,-9,1,2,3,2934.0,0:40,0,0,0,16.0,0:0,863333
8477945,Julius,Honka,1995-12-03,D,R,2017-18,42,1,3,4,0.1,-1,42,2.38,14,32783.0,13:0,0,0,0,0.0,20,28,2,18,-16,0,1,1,3241.0,1:17,0,0,0,137.0,0:3,863333
8477946,Dylan,Larkin,1996-07-30,C,L,2017-18,82,16,47,63,0.77,-9,232,6.9,61,97630.0,19:50,656,658,1314,49.92,76,42,56,81,-25,1,7,8,10655.0,2:9,2,1,3,9773.0,1:59,925000
8477947,Sonny,Milano,1996-05-12,LW,L,2017-18,55,14,8,22,0.4,-8,69,20.29,10,38444.0,11:38,0,0,0,0.0,28,11,14,18,-4,0,4,4,5511.0,1:40,0,0,0,0.0,0:0,863333
8477948,Travis,Sanheim,1996-03-29,D,L,2017-18,49,2,8,10,0.2,-6,72,2.78,20,45815.0,15:35,0,0,0,0.0,27,35,8,36,-28,0,0,0,834.0,0:17,0,0,0,1188.0,0:24,863333
8477949,Alex,Tuch,1996-05-10,RW,R,2017-18,78,15,22,37,0.47,3,171,8.77,27,71382.0,15:15,70,95,165,42.42,99,42,57,29,28,4,6,10,10916.0,2:19,0,0,0,210.0,0:2,925000
8477951,Nick,Schmaltz,1996-02-23,C,R,2017-18,78,21,31,52,0.67,1,118,17.8,18,85322.0,18:13,321,480,801,40.07,13,39,86,31,55,4,9,13,12494.0,2:40,0,2,2,6179.0,1:19,925000
8477953,Kasperi,Kapanen,1996-07-23,RW,R,2017-18,38,7,2,9,0.24,-1,55,12.73,4,25640.0,11:14,1,6,7,14.29,57,9,12,6,6,0,0,0,74.0,0:1,1,0,1,2462.0,1:4,863333
8477955,Jared,McCann,1996-05-31,C,L,2017-18,68,9,19,28,0.41,11,143,6.29,30,54081.0,13:15,212,338,550,38.55,43,32,39,28,11,1,0,1,2690.0,0:39,0,1,1,2252.0,0:33,894167
8477956,David,Pastrnak,1996-05-25,RW,R,2017-18,82,35,45,80,0.98,10,246,14.23,37,88392.0,17:57,5,20,25,20.0,55,31,50,76,-26,13,13,26,15184.0,3:5,0,0,0,70.0,0:0,6666667
8477957,Nikita,Scherbak,1995-12-30,RW,L,2017-18,26,4,2,6,0.23,-5,39,10.26,8,20869.0,13:22,2,0,2,100.0,18,15,13,9,4,1,2,3,2274.0,1:27,1,0,1,42.0,0:1,863333
8477958,Nikolay,Goldobin,1995-10-07,RW,L,2017-18,38,8,6,14,0.37,-14,50,16.0,6,28120.0,12:20,1,1,2,50.0,12,7,10,12,-2,2,0,2,2160.0,0:56,0,0,0,18.0,0:0,863333
8477959,Joshua,Ho-Sang,1996-01-22,RW,R,2017-18,22,2,10,12,0.55,-7,18,11.11,4,18849.0,14:16,2,3,5,40.0,3,1,10,23,-13,0,1,1,2980.0,2:15,0,0,0,0.0,0:0,863333
8477960,Adrian,Kempe,1996-09-13,LW,L,2017-18,81,16,21,37,0.46,11,119,13.45,49,64789.0,13:19,263,420,683,38.51,91,18,26,30,-4,1,4,5,5398.0,1:6,0,0,0,394.0,0:4,894167
8477961,John,Quenneville,1996-04-16,C,L,2017-18,2,0,0,0,0.0,-3,5,0.0,0,1595.0,13:17,0,1,1,0.0,4,0,0,1,-1,0,0,0,22.0,0:11,0,0,0,0.0,0:0,811667
8477962,Brendan,Lemieux,1996-03-15,LW,L,2017-18,9,1,0,1,0.11,2,6,16.67,21,4288.0,7:56,0,0,0,0.0,12,1,1,2,-1,0,0,0,280.0,0:31,0,0,0,0.0,0:0,839167
8477964,Ivan,Barbashev,1995-12-14,C,L,2017-18,53,7,6,13,0.25,-1,45,15.56,4,38788.0,12:11,61,98,159,38.36,70,25,21,12,9,0,0,0,580.0,0:10,0,0,0,579.0,0:10,741667
8477969,Marcus,Pettersson,1996-05-08,D,L,2017-18,22,1,3,4,0.18,5,16,6.25,6,17963.0,13:36,0,0,0,0.0,18,27,2,14,-12,0,1,1,998.0,0:45,0,0,0,766.0,0:34,794167
8477973,Vladislav,Kamenev,1996-08-12,C,L,2017-18,3,0,0,0,0.0,-2,1,0.0,0,1588.0,8:49,7,11,18,38.89,3,0,0,1,-1,0,0,0,5.0,0:1,0,0,0,0.0,0:0,833333
8477981,Roland,McKeown,1996-01-20,D,R,2017-18,10,0,3,3,0.3,3,7,0.0,19,8046.0,13:24,0,0,0,0.0,3,5,1,3,-2,0,0,0,0.0,0:0,0,0,0,10.0,0:1,745000
8477986,Brandon,Montour,1994-04-11,D,R,2017-18,80,9,23,32,0.4,16,160,5.62,42,98255.0,20:28,0,0,0,0.0,96,83,20,51,-31,5,7,12,10795.0,2:14,1,1,2,5788.0,1:12,925000
8477987,Ryan,Donato,1996-04-09,C,L,2017-18,12,5,4,9,0.75,2,24,20.83,2,10581.0,14:41,12,4,16,75.0,6,2,3,3,0,2,2,4,1770.0,2:27,0,0,0,0.0,0:0,900000
8477989,Christian,Dvorak,1996-02-02,C,L,2017-18,78,15,22,37,0.47,-19,151,9.93,22,76909.0,16:26,585,554,1139,51.36,92,48,20,25,-5,2,5,7,8485.0,1:48,0,0,0,6039.0,1:17,839167
8477994,Dominic,Turgeon,1996-02-25,C,L,2017-18,5,0,0,0,0.0,-2,3,0.0,2,2770.0,9:14,7,14,21,33.33,3,8,3,2,1,0,0,0,14.0,0:2,0,0,0,570.0,1:54,686667
8477998,Warren,Foegele,1996-04-01,LW,L,2017-18,2,2,1,3,1.5,3,6,33.33,0,1431.0,11:55,0,0,0,0.0,5,1,1,0,1,0,0,0,0.0,0:0,0,0,0,246.0,2:3,746667
8478004,Brett,Lernout,1995-09-24,D,R,2017-18,18,0,1,1,0.06,-5,14,0.0,6,18063.0,16:43,0,0,0,0.0,56,18,4,11,-7,0,0,0,12.0,0:0,0,1,1,1328.0,1:13,653333
8478010,Brayden,Point,1996-03-13,C,R,2017-18,82,32,34,66,0.8,18,217,14.75,24,96529.0,19:37,557,617,1174,47.44,26,57,56,23,33,5,6,11,11336.0,2:18,3,2,5,9880.0,2:0,686667
8478020,Michael,Amadio,1996-05-13,C,R,2017-18,37,4,4,8,0.22,-2,28,14.29,8,20671.0,9:18,74,96,170,43.53,18,9,11,6,5,1,2,3,1786.0,0:48,0,0,0,46.0,0:1,717500
8478027,Lucas,Wallmark,1995-09-05,C,L,2017-18,11,1,0,1,0.09,-4,16,6.25,2,6266.0,9:29,38,31,69,55.07,13,1,4,4,0,0,0,0,61.0,0:5,0,0,0,190.0,0:17,683333
8478042,Viktor,Arvidsson,1993-04-08,LW,R,2017-18,78,29,32,61,0.78,20,247,11.74,36,83062.0,17:44,11,22,33,33.33,30,52,31,35,-4,3,5,8,11743.0,2:30,3,0,3,6241.0,1:20,4250000
8478046,Danton,Heinen,1995-07-05,C,L,2017-18,77,16,31,47,0.61,10,135,11.85,16,69402.0,15:1,10,13,23,43.48,45,33,42,26,16,2,10,12,9273.0,2:0,1,0,1,1341.0,0:17,872500
8478055,Gustav,Forsling,1996-06-12,D,L,2017-18,41,3,10,13,0.32,-2,82,3.66,8,47124.0,19:9,0,1,1,0.0,26,56,18,38,-20,1,3,4,2879.0,1:10,0,1,1,6183.0,2:30,872500
8478063,Shane,Gersich,1996-07-10,LW,L,2017-18,3,0,1,1,0.33,-1,4,0.0,0,1623.0,9:1,0,0,0,0.0,0,2,3,0,3,0,0,0,0.0,0:0,0,0,0,0.0,0:0,925000
8478067,Oskar,Lindblom,1996-08-15,LW,L,2017-18,23,2,4,6,0.26,4,36,5.56,8,20128.0,14:35,0,0,0,0.0,27,13,4,5,-1,0,1,1,2048.0,1:29,0,0,0,0.0,0:0,925000
8478073,Anton,Lindholm,1994-11-29,D,L,2017-18,48,0,4,4,0.08,4,22,0.0,14,37927.0,13:10,0,0,0,0.0,99,51,8,9,-1,0,0,0,53.0,0:1,0,0,0,4606.0,1:35,717500
8478075,Anders,Bjork,1996-08-05,LW,L,2017-18,30,4,8,12,0.4,2,30,13.33,6,22225.0,12:20,1,1,2,50.0,19,11,16,11,5,2,1,3,1772.0,0:59,0,0,0,9.0,0:0,925000
8478099,Kevin,Labanc,1995-12-12,RW,R,2017-18,77,11,28,39,0.51,-6,156,7.05,32,66303.0,14:21,5,11,16,31.25,31,23,28,29,-1,4,12,16,10313.0,2:13,0,0,0,105.0,0:1,717500
8478104,Sammy,Blais,1996-06-17,LW,L,2017-18,11,1,2,3,0.27,1,9,11.11,6,7110.0,10:46,0,0,0,0.0,15,2,1,5,-4,1,0,1,888.0,1:20,0,0,0,0.0,0:0,673333
8478106,Dylan,Sikura,1995-06-01,RW,L,2017-18,5,0,3,3,0.6,2,9,0.0,0,4020.0,13:24,0,1,1,0.0,0,2,3,0,3,0,0,0,240.0,0:48,0,0,0,0.0,0:0,925000
8478131,Ondrej,Kase,1995-11-08,RW,R,2017-18,66,20,18,38,0.58,18,146,13.7,14,55133.0,13:55,5,21,26,19.23,28,26,29,31,-2,1,2,3,5179.0,1:18,0,0,0,51.0,0:0,670000
8478146,Matthew,Highmore,1996-02-27,C,L,2017-18,13,2,0,2,0.15,-4,27,7.41,0,9479.0,12:9,1,4,5,20.0,9,7,1,4,-3,0,0,0,18.0,0:1,0,0,0,715.0,0:55,775833
8478176,Joe,Hicketts,1996-05-04,D,L,2017-18,5,0,3,3,0.6,5,2,0.0,2,5204.0,17:20,0,0,0,0.0,9,12,1,5,-4,0,1,1,714.0,2:22,0,0,0,473.0,1:34,636111
8478211,Dryden,Hunt,1995-11-24,LW,L,2017-18,11,0,1,1,0.09,-5,12,0.0,2,6971.0,10:33,1,3,4,25.0,22,4,3,4,-1,0,0,0,50.0,0:4,0,0,0,6.0,0:0,809167
8478233,Andrew,Mangiapane,1996-04-04,LW,L,2017-18,10,0,0,0,0.0,-3,7,0.0,2,5358.0,8:55,1,0,1,100.0,9,4,2,3,-1,0,0,0,15.0,0:1,0,0,0,0.0,0:0,705000
8478365,Danick,Martel,1994-12-12,LW,L,2017-18,4,0,0,0,0.0,-1,6,0.0,0,2452.0,10:13,0,0,0,0.0,2,9,1,0,1,0,0,0,0.0,0:0,0,0,0,0.0,0:0,680000
8478366,Frank,Vatrano,1994-03-14,C,L,2017-18,41,7,3,10,0.24,3,72,9.72,34,26664.0,10:50,10,9,19,52.63,51,15,11,12,-1,0,0,0,1737.0,0:42,0,0,0,0.0,0:0,792500
8478373,Nikita,Soshnikov,1993-10-14,RW,L,2017-18,15,1,1,2,0.13,-2,17,5.88,4,9916.0,11:1,0,1,1,0.0,24,2,3,2,1,0,0,0,113.0,0:7,0,0,0,565.0,0:37,736666
8478396,Noah,Hanifin,1997-01-25,D,L,2017-18,79,10,22,32,0.41,-20,165,6.06,21,89397.0,18:51,0,0,0,0.0,81,69,50,58,-8,1,6,7,8524.0,1:47,0,0,0,395.0,0:5,925000
8478397,Rasmus,Andersson,1996-10-27,D,R,2017-18,10,0,0,0,0.0,-1,8,0.0,4,9263.0,15:26,0,0,0,0.0,2,10,0,4,-4,0,0,0,937.0,1:33,0,0,0,166.0,0:16,755833
8478398,Kyle,Connor,1996-12-09,LW,L,2017-18,76,31,26,57,0.75,8,192,16.15,16,77096.0,16:54,2,5,7,28.57,18,26,39,34,5,7,4,11,12140.0,2:39,0,0,0,45.0,0:0,925000
8478400,Colin,White,1997-01-30,C,R,2017-18,21,2,4,6,0.29,1,24,8.33,8,16814.0,13:20,20,40,60,33.33,12,15,7,12,-5,0,0,0,829.0,0:39,0,0,0,49.0,0:2,925000
8478401,Pavel,Zacha,1997-04-06,C,L,2017-18,69,8,17,25,0.36,-3,112,7.14,30,59497.0,14:22,318,407,725,43.86,70,22,37,34,3,2,3,5,5410.0,1:18,1,0,1,4341.0,1:2,894167
8478402,Connor,McDavid,1997-01-13,C,L,2017-18,82,41,67,108,1.32,20,274,14.96,26,106034.0,21:33,376,533,909,41.36,28,46,111,67,44,5,15,20,14593.0,2:57,1,3,4,5356.0,1:5,925000
8478403,Jack,Eichel,1996-10-28,C,R,2017-18,67,25,39,64,0.96,-25,246,10.16,32,80976.0,20:8,347,489,836,41.51,52,35,38,61,-23,3,17,20,14975.0,3:43,0,2,2,3191.0,0:47,925000
8478407,Vince,Dunn,1996-10-29,D,L,2017-18,75,5,19,24,0.32,1,138,3.62,20,77539.0,17:13,1,0,1,100.0,29,59,29,38,-9,2,7,9,8976.0,1:59,0,0,0,361.0,0:4,722500
8478408,Travis,Dermott,1996-12-22,D,L,2017-18,37,1,12,13,0.35,16,54,1.85,8,35507.0,15:59,0,0,0,0.0,48,36,9,36,-27,0,0,0,199.0,0:5,0,0,0,857.0,0:23,863333
8478413,Jordan,Greenway,1997-02-16,LW,L,2017-18,6,0,1,1,0.17,0,4,0.0,0,4119.0,11:26,0,5,5,0.0,5,3,2,2,0,0,0,0,50.0,0:8,0,0,0,19.0,0:3,916666
8478414,Timo,Meier,1996-10-08,RW,L,2017-18,81,21,15,36,0.44,2,210,10.0,51,72257.0,14:52,71,75,146,48.63,105,48,48,40,8,3,1,4,6161.0,1:16,0,0,0,1090.0,0:13,894167
8478420,Mikko,Rantanen,1996-10-29,RW,L,2017-18,81,29,55,84,1.04,0,178,16.29,34,92159.0,18:57,60,57,117,51.28,32,40,45,30,15,12,23,35,18184.0,3:44,0,0,0,90.0,0:1,894167
8478421,A.J.,Greer,1996-12-14,LW,L,2017-18,17,0,3,3,0.18,2,13,0.0,29,7541.0,7:23,1,2,3,33.33,30,5,3,2,1,0,0,0,167.0,0:9,0,0,0,0.0,0:0,741666
8478425,Brendan,Guhle,1997-07-29,D,L,2017-18,18,0,5,5,0.28,-6,37,0.0,10,19554.0,18:6,0,0,0,0.0,10,8,1,9,-8,0,0,0,1001.0,0:55,0,0,0,450.0,0:25,697500
8478427,Sebastian,Aho,1997-07-26,RW,L,2017-18,78,29,36,65,0.83,4,200,14.5,24,83857.0,17:55,78,94,172,45.35,65,17,59,53,6,8,8,16,12520.0,2:40,0,0,0,168.0,0:2,925000
8478431,Evgeny,Svechnikov,1996-10-31,RW,L,2017-18,14,2,2,4,0.29,-2,15,13.33,8,7409.0,8:49,1,4,5,20.0,15,6,3,5,-2,0,0,0,0.0,0:0,0,0,0,0.0,0:0,863333
8478432,Christian,Fischer,1997-04-15,RW,R,2017-18,79,15,18,33,0.42,-17,154,9.74,14,65909.0,13:54,5,24,29,17.24,109,23,15,11,4,5,3,8,10236.0,2:9,0,0,0,101.0,0:1,821666
8478439,Travis,Konecny,1997-03-11,C,R,2017-18,81,24,23,47,0.58,17,177,13.56,46,72449.0,14:54,7,14,21,33.33,97,53,31,38,-7,1,2,3,6843.0,1:24,0,0,0,39.0,0:0,894167
8478440,Dylan,Strome,1997-03-07,C,L,2017-18,21,4,5,9,0.43,4,30,13.33,8,16313.0,12:56,92,122,214,42.99,7,12,12,2,10,1,0,1,1909.0,1:30,0,0,0,99.0,0:4,863333
8478443,Brandon,Carlo,1996-11-26,D,R,2017-18,76,0,6,6,0.08,10,76,0.0,45,87721.0,19:14,1,0,1,100.0,89,84,26,45,-19,0,0,0,221.0,0:2,0,1,1,12738.0,2:47,789167
8478444,Brock,Boeser,1997-02-25,RW,R,2017-18,62,29,26,55,0.89,-5,179,16.2,16,65072.0,17:29,10,29,39,25.64,29,24,26,28,-2,10,13,23,10876.0,2:55,0,0,0,146.0,0:2,925000
8478445,Mathew,Barzal,1997-05-26,C,R,2017-18,82,22,63,85,1.04,1,170,12.94,30,87407.0,17:45,355,479,834,42.57,21,31,65,88,-23,5,22,27,15582.0,3:10,0,0,0,163.0,0:1,863333
8478451,Ethan,Bear,1997-06-26,D,R,2017-18,18,1,3,4,0.22,-11,20,5.0,10,20123.0,18:37,0,0,0,0.0,14,28,5,18,-13,1,1,2,1974.0,1:49,0,0,0,211.0,0:11,720000
8478454,Noah,Juulsen,1997-04-02,D,R,2017-18,23,1,2,3,0.13,1,33,3.03,4,26804.0,19:25,0,0,0,0.0,58,34,6,22,-16,0,0,0,498.0,0:21,0,0,0,3240.0,2:20,863333
8478458,Jack,Roslovic,1997-01-29,C,R,2017-18,31,5,9,14,0.45,5,38,13.16,2,22919.0,12:19,18,21,39,46.15,20,9,14,12,2,0,0,0,2166.0,1:9,0,0,0,0.0,0:0,894166
8478460,Zach,Werenski,1997-07-19,D,L,2017-18,77,16,21,37,0.48,8,207,7.73,16,104301.0,22:34,0,0,0,0.0,58,92,32,42,-10,3,7,10,11223.0,2:25,0,0,0,3519.0,0:45,925000
8478462,Nicolas,Roy,1997-02-05,C,R,2017-18,1,0,0,0,0.0,-1,1,0.0,0,646.0,10:46,6,4,10,60.0,2,0,1,0,1,0,0,0,0.0,0:0,0,0,0,0.0,0:0,720000
8478463,Anthony,Beauvillier,1997-06-08,C,L,2017-18,71,21,15,36,0.51,2,132,15.91,16,61884.0,14:31,72,94,166,43.37,80,29,26,20,6,3,5,8,4024.0,0:56,0,0,0,3203.0,0:45,894167
8478466,Daniel,Sprong,1997-03-17,RW,R,2017-18,8,2,1,3,0.38,2,22,9.09,0,6710.0,13:58,0,0,0,0.0,9,4,0,2,-2,0,0,0,571.0,1:11,0,0,0,8.0,0:1,692500
8478469,Thomas,Chabot,1997-01-30,D,L,2017-18,63,9,16,25,0.4,-12,94,9.57,14,66191.0,17:30,0,0,0,0.0,44,64,27,36,-9,0,8,8,7093.0,1:52,0,0,0,573.0,0:9,863333
8478474,Lawson,Crouse,1997-06-23,LW,L,2017-18,11,1,0,1,0.09,-6,13,7.69,7,7220.0,10:56,3,8,11,27.27,29,6,2,3,-1,0,0,0,32.0,0:2,0,0,0,217.0,0:19,894167
8478483,Mitchell,Marner,1997-05-05,C,R,2017-18,82,22,47,69,0.84,-1,194,11.34,26,80629.0,16:23,50,45,95,52.63,31,25,85,50,35,8,19,27,10799.0,2:11,0,0,0,209.0,0:2,894167
8478488,Filip,Chlapik,1997-06-03,C,L,2017-18,20,1,3,4,0.2,-5,21,4.76,4,12087.0,10:4,50,60,110,45.45,19,14,9,5,4,0,1,1,731.0,0:36,0,0,0,8.0,0:0,728333
8478493,Joel,Eriksson Ek,1997-01-29,C,L,2017-18,75,6,10,16,0.21,2,124,4.84,22,57503.0,12:46,201,271,472,42.58,134,46,17,10,7,0,0,0,500.0,0:6,0,0,0,4886.0,1:5,894166
8478498,Jake,DeBrusk,1996-10-17,LW,L,2017-18,70,16,27,43,0.61,13,143,11.19,19,60359.0,14:22,13,17,30,43.33,70,26,31,21,10,2,7,9,7579.0,1:48,0,0,0,415.0,0:5,863333
8478500,Ivan,Provorov,1997-01-13,D,L,2017-18,82,17,24,41,0.5,17,203,8.37,20,118832.0,24:9,0,0,0,0.0,148,169,26,92,-66,2,3,5,8713.0,1:46,0,0,0,12698.0,2:34,894167
8478506,Gabriel,Carlsson,1997-01-02,D,L,2017-18,14,0,2,2,0.14,0,18,0.0,4,9517.0,11:19,0,0,0,0.0,10,10,2,4,-2,0,0,0,8.0,0:0,0,0,0,202.0,0:14,894166
8478512,Austin,Czarnik,1992-12-12,C,R,2017-18,10,0,4,4,0.4,-1,7,0.0,0,6547.0,10:54,14,14,28,50.0,4,0,2,2,0,0,1,1,301.0,0:30,0,0,0,316.0,0:31,675000
8478519,Anthony,Cirelli,1997-07-15,C,L,2017-18,18,5,6,11,0.61,11,26,19.23,6,14290.0,13:13,96,118,214,44.86,17,6,8,4,4,0,0,0,12.0,0:0,0,1,1,1551.0,1:26,728333
8478528,Tanner,Kero,1992-07-24,C,L,2017-18,8,1,2,3,0.38,1,7,14.29,0,5490.0,11:26,35,41,76,46.05,3,7,3,5,-2,0,0,0,23.0,0:2,0,0,0,1080.0,2:15,750000
8478541,Markus,Hannikainen,1993-03-26,LW,L,2017-18,33,3,3,6,0.18,-1,31,9.68,6,16577.0,8:22,3,1,4,75.0,31,15,10,4,6,0,0,0,90.0,0:2,0,1,1,975.0,0:29,675000
8478542,Evan,Rodrigues,1993-07-28,LW,R,2017-18,48,7,18,25,0.52,-10,91,7.69,14,40116.0,13:55,156,212,368,42.39,19,23,20,12,8,1,5,6,6007.0,2:5,0,0,0,772.0,0:16,650000
8478550,Artemi,Panarin,1991-10-30,LW,R,2017-18,81,27,55,82,1.01,23,228,11.84,26,97835.0,20:7,0,7,7,0.0,15,19,70,51,19,7,14,21,14316.0,2:56,0,0,0,107.0,0:1,6000000
8478561,Andreas,Martinsen,1990-06-13,LW,L,2017-18,9,1,0,1,0.11,-1,14,7.14,17,6826.0,12:38,0,0,0,0.0,35,4,2,3,-1,0,0,0,3.0,0:0,0,0,0,232.0,0:25,675000
8478567,Dean,Kukan,1993-07-08,D,L,2017-18,11,0,4,4,0.36,2,12,0.0,2,8159.0,12:21,0,0,0,0.0,2,10,0,3,-3,0,0,0,59.0,0:5,0,0,0,153.0,0:13,700000
8478569,Noel,Acciari,1991-12-01,C,R,2017-18,60,10,1,11,0.18,-6,66,15.15,9,46487.0,12:54,42,51,93,45.16,152,41,20,9,11,0,0,0,287.0,0:4,1,0,1,4928.0,1:22,725000
8478585,Derek,Ryan,1986-12-29,C,R,2017-18,80,15,23,38,0.48,-15,135,11.11,28,74909.0,15:36,531,409,940,56.49,52,27,54,48,6,3,4,7,9700.0,2:1,0,0,0,1776.0,0:22,1425000
8478842,Andrei,Mironov,1994-07-29,D,L,2017-18,10,1,2,3,0.3,2,3,33.33,12,6628.0,11:2,0,0,0,0.0,19,16,1,3,-2,0,0,0,0.0,0:0,0,0,0,850.0,1:25,925000
8478843,Denis,Malgin,1997-01-18,C,R,2017-18,51,11,11,22,0.43,4,79,13.92,6,42390.0,13:51,52,70,122,42.62,48,24,31,21,10,1,5,6,3770.0,1:13,0,0,0,24.0,0:0,690000
8478846,Christian,Wolanin,1995-03-17,D,L,2017-18,10,1,2,3,0.3,-4,14,7.14,0,8788.0,14:38,0,0,0,0.0,5,5,3,5,-2,0,0,0,842.0,1:24,0,0,0,46.0,0:4,925000
8478866,Dominik,Simon,1994-08-08,C,L,2017-18,33,4,8,12,0.36,2,36,11.11,16,22616.0,11:25,6,8,14,42.86,37,18,10,13,-3,0,0,0,1028.0,0:31,0,0,0,8.0,0:0,692500
8478873,Troy,Terry,1997-09-10,RW,R,2017-18,2,0,0,0,0.0,0,3,0.0,0,1225.0,10:12,0,0,0,0.0,0,2,0,0,0,0,0,0,18.0,0:9,0,0,0,0.0,0:0,925000
8478874,Adam,Gaudette,1996-10-03,C,R,2017-18,5,0,0,0,0.0,2,9,0.0,0,3836.0,12:47,6,10,16,37.5,2,3,1,4,-3,0,0,0,224.0,0:44,0,0,0,0.0,0:0,916667
8478906,Markus,Nutivaara,1994-06-06,D,L,2017-18,61,7,16,23,0.38,13,79,8.86,14,58664.0,16:1,0,0,0,0.0,42,40,9,19,-10,1,1,2,2043.0,0:33,0,0,0,171.0,0:2,817500
8478915,Sami,Niku,1996-10-10,D,L,2017-18,1,1,0,1,1.0,0,2,50.0,0,913.0,15:13,0,0,0,0.0,0,3,1,0,1,0,0,0,0.0,0:0,0,0,0,0.0,0:0,775000
8479066,Ryan,Lomberg,1994-12-09,LW,L,2017-18,7,0,1,1,0.14,0,5,0.0,15,2625.0,6:15,0,2,2,0.0,11,1,0,1,-1,0,0,0,7.0,0:1,0,0,0,0.0,0:0,710000
8479206,Tanner,Fritz,1991-08-20,C,R,2017-18,34,3,4,7,0.21,-3,27,11.11,8,25544.0,12:31,47,61,108,43.52,59,26,4,8,-4,0,0,0,1066.0,0:31,0,0,0,605.0,0:17,650000
8479250,Nick,Lappin,1992-11-01,RW,R,2017-18,6,1,0,1,0.17,2,7,14.29,4,3514.0,9:45,0,0,0,0.0,8,2,1,2,-1,0,0,0,18.0,0:3,0,0,0,0.0,0:0,842500
8479268,Casey,Nelson,1992-07-18,D,R,2017-18,37,3,5,8,0.22,-14,48,6.25,8,41692.0,18:46,0,0,0,0.0,31,37,8,23,-15,0,0,0,797.0,0:21,1,1,2,2249.0,1:0,650000
8479290,Kalle,Kossila,1993-04-14,C,L,2017-18,10,1,1,2,0.2,-4,9,11.11,0,5451.0,9:5,26,27,53,49.06,7,4,4,3,1,0,0,0,102.0,0:10,0,0,0,7.0,0:0,925000
8479291,Kevin,Rooney,1993-05-21,C,L,2017-18,1,0,0,0,0.0,0,3,0.0,0,706.0,11:46,1,2,3,33.33,2,0,1,0,1,0,0,0,19.0,0:19,0,0,0,14.0,0:14,650000
8479293,Brandon,Tanev,1991-12-31,LW,L,2017-18,61,8,10,18,0.3,13,79,10.13,18,46340.0,12:39,3,8,11,27.27,188,56,20,14,6,0,0,0,297.0,0:4,3,0,3,7172.0,1:57,700000
8479304,Kyle,Criscuolo,1992-05-05,C,R,2017-18,9,0,0,0,0.0,-4,5,0.0,4,4328.0,8:0,19,22,41,46.34,13,3,3,2,1,0,0,0,16.0,0:1,0,0,0,194.0,0:21,650000
8479314,Matthew,Tkachuk,1997-12-11,LW,L,2017-18,68,24,25,49,0.72,-1,188,12.77,61,70383.0,17:15,7,10,17,41.18,80,16,32,34,-2,10,7,17,12156.0,2:58,0,0,0,23.0,0:0,925000
8479316,Luke,Kunin,1997-12-04,C,R,2017-18,19,2,2,4,0.21,-3,32,6.25,13,14795.0,12:58,24,30,54,44.44,34,8,2,4,-2,0,0,0,59.0,0:3,1,0,1,1060.0,0:55,925000
8479318,Auston,Matthews,1997-09-17,C,L,2017-18,62,34,29,63,1.02,25,187,18.18,12,67437.0,18:7,375,313,688,54.51,16,61,59,59,0,5,8,13,7984.0,2:8,0,0,0,93.0,0:1,925000
8479325,Charlie,McAvoy,1997-12-21,D,R,2017-18,63,7,25,32,0.51,20,77,9.09,53,83717.0,22:8,0,0,0,0.0,133,80,22,44,-22,2,5,7,7514.0,1:59,0,0,0,3029.0,0:48,916667
8479337,Alex,DeBrincat,1997-12-18,RW,R,2017-18,82,28,24,52,0.63,6,181,15.47,6,72826.0,14:48,25,34,59,42.37,40,25,33,25,8,6,6,12,10027.0,2:2,0,0,0,713.0,0:8,778333
8479339,Patrik,Laine,1998-04-19,RW,R,2017-18,82,44,26,70,0.85,8,241,18.26,24,81085.0,16:28,11,32,43,25.58,74,43,29,51,-22,20,11,31,14793.0,3:0,0,0,0,6.0,0:0,925000
8479343,Clayton,Keller,1998-07-29,C,L,2017-18,82,23,42,65,0.79,-7,212,10.85,24,88986.0,18:5,37,41,78,47.44,7,28,42,50,-8,6,14,20,14827.0,3:0,0,1,1,660.0,0:8,885833
8479344,Jesse,Puljujarvi,1998-05-07,RW,R,2017-18,65,12,8,20,0.31,-1,136,8.82,14,52134.0,13:22,0,3,3,0.0,67,23,27,40,-13,2,0,2,2899.0,0:44,0,0,0,24.0,0:0,925000
8479345,Jakob,Chychrun,1998-03-31,D,L,2017-18,50,4,10,14,0.28,2,102,3.92,16,60750.0,20:15,0,0,0,0.0,74,72,19,27,-8,2,2,4,6110.0,2:2,0,0,0,597.0,0:11,925000
8479366,Logan,Brown,1998-03-05,C,L,2017-18,4,0,1,1,0.25,0,4,0.0,0,1951.0,8:7,4,8,12,33.33,1,1,2,4,-2,0,0,0,562.0,2:20,0,0,0,0.0,0:0,894166
8479370,Tyson,Jost,1998-03-14,C,L,2017-18,65,12,10,22,0.34,-10,113,10.62,26,57072.0,14:38,84,145,229,36.68,33,26,22,10,12,5,3,8,10099.0,2:35,0,0,0,958.0,0:14,885833
8479376,Victor,Mete,1998-06-07,D,L,2017-18,49,0,7,7,0.14,5,43,0.0,4,45824.0,15:35,0,0,0,0.0,1,71,6,53,-47,0,4,4,4130.0,1:24,0,0,0,370.0,0:7,748333
8479398,Samuel,Girard,1998-05-12,D,L,2017-18,73,4,19,23,0.32,-10,84,4.76,8,77300.0,17:38,0,0,0,0.0,46,69,13,31,-18,1,12,13,9500.0,2:10,0,0,0,80.0,0:1,728333
8479400,Pierre-Luc,Dubois,1998-06-24,C,L,2017-18,82,20,28,48,0.59,8,165,12.12,49,81842.0,16:38,461,591,1052,43.82,127,46,38,29,9,6,9,15,9541.0,1:56,0,0,0,761.0,0:9,894166
8479404,Henrik,Borgstrom,1997-08-06,C,L,2017-18,4,1,0,1,0.25,-1,6,16.67,0,3038.0,12:39,15,22,37,40.54,1,1,2,2,0,0,0,0,321.0,1:20,0,0,0,0.0,0:0,925000
8479407,Jesper,Bratt,1998-07-30,LW,L,2017-18,74,13,22,35,0.47,-16,100,13.0,18,67716.0,15:15,7,4,11,63.64,44,22,25,30,-5,4,8,12,9102.0,2:3,1,1,2,4733.0,1:3,749167
8479410,Mikhail,Sergachev,1998-06-25,D,L,2017-18,79,9,31,40,0.51,11,141,6.38,38,72808.0,15:21,0,0,0,0.0,90,64,21,60,-39,3,13,16,8769.0,1:51,0,0,0,68.0,0:0,894166
8479420,Tage,Thompson,1997-10-30,C,R,2017-18,41,3,6,9,0.22,-12,55,5.45,12,29334.0,11:55,1,9,10,10.0,39,9,20,11,9,0,1,1,2738.0,1:6,0,0,0,0.0,0:0,925000
8479423,Alexander,Nylander,1998-03-02,RW,R,2017-18,3,1,0,1,0.33,-3,2,50.0,0,2315.0,12:51,0,0,0,0.0,0,0,0,2,-2,0,0,0,117.0,0:39,0,0,0,0.0,0:0,894166
8479442,Troy,Stecher,1994-04-07,D,R,2017-18,68,1,10,11,0.16,-7,94,1.06,35,76751.0,18:48,0,1,1,0.0,111,75,22,27,-5,0,1,1,965.0,0:14,0,1,1,6189.0,1:31,925000
8479458,Nikita,Zaitsev,1991-10-29,D,R,2017-18,60,5,8,13,0.22,8,54,9.26,31,79983.0,22:13,0,0,0,0.0,113,134,21,76,-55,0,0,0,844.0,0:14,0,0,0,10604.0,2:56,4500000
8479465,Drake,Caggiula,1994-06-20,LW,L,2017-18,67,13,7,20,0.3,-13,104,12.5,37,54472.0,13:33,11,42,53,20.75,147,33,27,28,-1,3,0,3,3920.0,0:58,1,0,1,2972.0,0:44,925000
8479482,Michal,Kempny,1990-09-08,D,L,2017-18,53,3,7,10,0.19,14,82,3.66,26,50603.0,15:54,0,0,0,0.0,57,82,9,41,-32,0,0,0,255.0,0:4,0,0,0,2193.0,0:41,900000
8479483,Yohann,Auvitu,1989-07-27,D,L,2017-18,33,3,6,9,0.27,4,69,4.35,8,26840.0,13:33,0,0,0,0.0,18,26,8,17,-9,0,0,0,833.0,0:25,0,0,0,104.0,0:3,700000
8479511,Janne,Kuokkanen,1998-05-25,C,L,2017-18,4,0,0,0,0.0,-3,6,0.0,0,2655.0,11:3,0,0,0,0.0,1,1,3,2,1,0,0,0,0.0,0:0,0,0,0,0.0,0:0,842500
8479553,Maxim,Mamin,1995-01-13,C,L,2017-18,26,3,1,4,0.15,2,28,10.71,7,16412.0,10:31,0,1,1,0.0,51,9,14,12,2,0,0,0,139.0,0:5,0,0,0,0.0,0:0,757500
8479580,Dylan,Gambrell,1996-08-26,C,R,2017-18,3,0,0,0,0.0,-1,1,0.0,0,1900.0,10:33,9,9,18,50.0,0,2,0,0,0,0,0,0,0.0,0:0,0,0,0,0.0,0:0,925000
8479595,Blake,Hillman,1996-01-26,D,L,2017-18,4,1,0,1,0.25,-1,5,20.0,0,4327.0,18:1,0,0,0,0.0,5,8,0,0,0,0,0,0,5.0,0:1,1,0,1,384.0,1:36,925000
8479650,Vadim,Shipachyov,1987-03-12,C,L,2017-18,3,1,0,1,0.33,3,3,33.33,2,1906.0,10:35,12,9,21,57.14,1,0,0,0,0,0,0,0,179.0,0:59,0,0,0,0.0,0:0,4500000
8479755,Victor,Antipin,1992-12-06,D,L,2017-18,47,0,10,10,0.21,-9,40,0.0,18,43083.0,15:16,0,0,0,0.0,14,41,4,13,-9,0,1,1,2759.0,0:58,0,0,0,294.0,0:6,925000
8479944,Zach,Aston-Reese,1994-08-10,C,L,2017-18,16,4,2,6,0.38,2,20,20.0,2,10921.0,11:22,1,5,6,16.67,55,6,6,4,2,0,0,0,475.0,0:29,0,0,0,813.0,0:50,925000
8479968,Vinni,Lettieri,1995-02-06,C,R,2017-18,19,1,4,5,0.26,-12,28,3.57,0,13744.0,12:3,5,7,12,41.67,22,6,2,7,-5,0,1,1,1685.0,1:28,0,0,0,8.0,0:0,925000
8479974,Nolan,Patrick,1998-09-19,C,R,2017-18,73,13,17,30,0.41,1,127,10.24,30,60115.0,13:43,376,367,743,50.61,48,19,32,33,-1,5,3,8,7999.0,1:49,0,0,0,76.0,0:1,925000
8479977,Kailer,Yamamoto,1998-09-29,RW,R,2017-18,9,0,3,3,0.33,-2,23,0.0,2,8186.0,15:9,0,1,1,0.0,6,3,5,8,-3,0,1,1,751.0,1:23,0,0,0,23.0,0:2,925000
8479999,Casey,Mittelstadt,1998-11-22,C,L,2017-18,6,1,4,5,0.83,1,9,11.11,2,5047.0,14:1,17,19,36,47.22,2,2,0,5,-5,1,0,1,774.0,2:9,0,0,0,0.0,0:0,925000
8480002,Nico,Hischier,1999-01-04,C,L,2017-18,82,20,32,52,0.63,10,180,11.11,26,80242.0,16:18,422,561,983,42.93,56,39,56,26,30,1,5,6,10085.0,2:2,0,0,0,2563.0,0:31,925000
8480009,Eeli,Tolvanen,1999-04-22,RW,L,2017-18,3,0,0,0,0.0,0,3,0.0,0,2180.0,12:6,0,0,0,0.0,2,1,0,1,-1,0,0,0,137.0,0:45,0,0,0,0.0,0:0,925000
8480015,Owen,Tippett,1999-02-16,RW,R,2017-18,7,1,0,1,0.14,-6,17,5.88,0,4669.0,11:7,0,2,2,0.0,3,4,2,2,0,0,0,0,724.0,1:43,0,0,0,23.0,0:3,925000
8480072,Lias,Andersson,1998-10-13,C,L,2017-18,7,1,1,2,0.29,1,5,20.0,0,5017.0,11:56,19,28,47,40.43,9,3,4,0,4,0,0,0,18.0,0:2,0,0,0,187.0,0:26,925000
8480078,Filip,Chytil,1999-09-05,C,L,2017-18,9,1,2,3,0.33,-5,21,4.76,4,7349.0,13:36,28,48,76,36.84,3,1,1,3,-2,0,0,0,200.0,0:22,0,0,0,19.0,0:2,925000
8480113,Alex,Iafallo,1993-12-21,C,L,2017-18,75,9,16,25,0.33,10,129,6.98,12,67966.0,15:6,14,16,30,46.67,53,33,24,23,1,0,2,2,2445.0,0:32,0,0,0,1626.0,0:21,925000
8480143,Jakub,Jerabek,1991-05-12,D,L,2017-18,36,2,6,8,0.22,-2,33,6.06,6,35253.0,16:19,0,0,0,0.0,42,48,4,32,-28,0,0,0,179.0,0:4,0,0,0,538.0,0:14,925000
8480144,David,Kampf,1995-01-12,C,L,2017-18,46,4,7,11,0.24,-9,46,8.7,12,35327.0,12:47,291,258,549,53.01,29,23,14,8,6,0,0,0,229.0,0:4,0,0,0,4071.0,1:28,925000
8480145,Neal,Pionk,1995-07-29,D,R,2017-18,28,1,13,14,0.5,-1,54,1.85,12,37611.0,22:23,0,0,0,0.0,49,41,13,33,-20,0,5,5,2093.0,1:14,0,0,0,3947.0,2:20,925000
8480147,Oscar,Fantenberg,1991-10-07,D,L,2017-18,27,2,7,9,0.33,2,33,6.06,11,23105.0,14:15,0,0,0,0.0,43,17,3,7,-4,0,4,4,3162.0,1:57,0,0,0,428.0,0:15,925000
8480153,Victor,Ejdsell,1995-06-06,C,L,2017-18,6,0,1,1,0.17,-1,7,0.0,0,4794.0,13:19,20,40,60,33.33,6,6,2,0,2,0,0,0,276.0,0:46,0,0,0,0.0,0:0,833750
8480157,Calle,Rosen,1994-02-02,D,L,2017-18,4,0,1,1,0.25,-3,5,0.0,4,3069.0,12:47,0,0,0,0.0,1,0,2,1,1,0,0,0,102.0,0:25,0,0,0,1.0,0:0,925000
8480158,Andreas,Borgman,1995-06-18,D,L,2017-18,48,3,8,11,0.23,4,46,6.52,28,39420.0,13:41,0,0,0,0.0,121,36,13,36,-23,0,0,0,77.0,0:1,0,0,0,561.0,0:11,925000
8480164,Henrik,Haapala,1994-02-28,LW,L,2017-18,5,0,1,1,0.2,0,3,0.0,0,4110.0,13:42,0,0,0,0.0,5,3,0,4,-4,0,0,0,539.0,1:47,0,0,0,0.0,0:0,925000
8480172,Jan,Rutta,1990-07-29,D,R,2017-18,57,6,14,20,0.35,-1,71,8.45,24,65850.0,19:15,0,0,0,0.0,24,64,12,37,-25,2,2,4,1429.0,0:25,0,1,1,7686.0,2:14,925000
8480222,Sebastian,Aho,1996-02-17,D,L,2017-18,22,1,3,4,0.18,-5,24,4.17,6,21444.0,16:14,0,1,1,0.0,10,14,3,12,-9,1,0,1,1350.0,1:1,0,0,0,7.0,0:0,925000
8480330,Spencer,Foo,1994-05-19,RW,R,2017-18,4,2,0,2,0.5,1,16,12.5,0,3805.0,15:51,1,0,1,100.0,6,3,2,1,1,0,0,0,505.0,2:6,0,0,0,0.0,0:0,925000
8480761,Mitch,Reinke,1996-02-04,D,R,2017-18,1,0,0,0,0.0,0,1,0.0,0,785.0,13:5,0,0,0,0.0,0,2,0,0,0,0,0,0,0.0,0:0,0,0,0,0.0,0:0,925000
8464989,Matt,Cullen,1976-11-02,C,L,2018-19,71,7,13,20,0.28,6,87,8.05,14,49031.0,11:30,320,320,640,50.0,32,31,24,19,5,0,0,0,155.0,0:2,2,2,4,9480.0,2:13,650000
8465009,Zdeno,Chara,1977-03-18,D,L,2018-19,62,5,9,14,0.23,22,99,5.05,57,78409.0,21:4,0,0,0,0.0,81,88,28,44,-16,1,2,3,291.0,0:4,0,0,0,11345.0,3:2,5000000
8466138,Joe,Thornton,1979-07-02,C,L,2018-19,73,16,35,51,0.7,8,90,17.78,20,68102.0,15:32,356,319,675,52.74,17,14,43,42,1,3,12,15,8301.0,1:53,0,0,0,34.0,0:0,5000000
8466139,Patrick,Marleau,1979-09-15,C,L,2018-19,82,16,21,37,0.45,-6,161,9.94,28,80415.0,16:20,104,99,203,51.23,74,41,31,22,9,4,6,10,8691.0,1:45,0,0,0,375.0,0:4,6250000
8468493,Ron,Hainsey,1981-03-24,D,L,2018-19,81,5,18,23,0.28,30,81,6.17,21,98444.0,20:15,1,0,1,100.0,91,144,31,74,-43,0,0,0,215.0,0:2,1,0,1,13795.0,2:50,3000000
8468498,Brooks,Orpik,1980-09-26,D,L,2018-19,53,2,7,9,0.17,8,43,4.65,32,49809.0,15:39,0,0,0,0.0,131,78,5,31,-26,0,0,0,47.0,0:0,0,0,0,8297.0,2:36,5500000
8468508,Justin,Williams,1981-10-04,RW,R,2018-19,82,23,30,53,0.65,-4,237,9.7,44,85818.0,17:26,92,150,242,38.02,55,32,63,88,-25,9,5,14,13327.0,2:42,0,0,0,85.0,0:1,4500000
8468509,Niklas,Kronwall,1981-01-12,D,L,2018-19,79,3,24,27,0.34,-5,71,4.23,40,94577.0,19:57,0,0,0,0.0,84,96,12,59,-47,1,7,8,7827.0,1:39,0,0,0,5126.0,1:4,4750000
8468611,Matt,Hendricks,1981-06-17,C,L,2018-19,26,0,3,3,0.12,-2,23,0.0,19,13791.0,8:50,42,35,77,54.55,40,8,5,10,-5,0,0,0,72.0,0:2,0,0,0,1155.0,0:44,700000
8468674,Deryk,Engelland,1982-04-03,D,R,2018-19,74,2,10,12,0.16,-3,105,1.9,18,88257.0,19:52,0,0,0,0.0,165,152,26,24,2,0,0,0,336.0,0:4,0,0,0,14222.0,3:12,1500000
8469454,Ilya,Kovalchuk,1983-04-15,RW,R,2018-19,64,16,18,34,0.53,-26,141,11.35,10,62333.0,16:13,16,20,36,44.44,28,19,21,43,-22,4,5,9,10719.0,2:47,0,0,0,18.0,0:0,6666666
8469455,Jason,Spezza,1983-06-13,C,R,2018-19,76,8,19,27,0.36,-13,121,6.61,29,60512.0,13:16,470,337,807,58.24,16,30,26,53,-27,2,10,12,10045.0,2:12,0,0,0,121.0,0:1,7500000
8469459,Mikko,Koivu,1983-03-12,C,L,2018-19,48,8,21,29,0.6,-2,89,8.99,22,52696.0,18:17,488,406,894,54.59,13,32,35,10,25,2,10,12,6809.0,2:21,0,1,1,4636.0,1:36,5500000
8469465,Dan,Hamhuis,1982-12-13,D,L,2018-19,57,0,5,5,0.09,-2,39,0.0,28,54881.0,16:2,0,0,0,0.0,38,61,12,40,-28,0,0,0,93.0,0:1,0,0,0,5732.0,1:40,1250000
8469506,Jason,Pominville,1982-11-30,RW,R,2018-19,73,16,15,31,0.42,-4,134,11.94,4,54592.0,12:27,18,17,35,51.43,18,20,13,20,-7,1,1,2,3780.0,0:51,0,0,0,34.0,0:0,5600000
8469521,Tomas,Plekanec,1982-10-31,C,L,2018-19,3,1,0,1,0.33,0,8,12.5,0,1958.0,10:52,19,19,38,50.0,1,1,0,0,0,0,0,0,17.0,0:5,0,0,0,260.0,1:26,2250000
8470047,Valtteri,Filppula,1984-03-20,C,L,2018-19,72,17,14,31,0.43,19,78,21.79,16,61667.0,14:16,398,413,811,49.08,12,34,36,27,9,0,0,0,2735.0,0:37,1,0,1,7983.0,1:50,2750000
8470110,Trevor,Daley,1983-10-09,D,L,2018-19,44,2,6,8,0.18,-3,47,4.26,12,48997.0,18:33,0,0,0,0.0,14,53,10,43,-33,0,0,0,248.0,0:5,1,0,1,6895.0,2:36,3166666
8470144,Frans,Nielsen,1984-04-24,C,L,2018-19,72,10,25,35,0.49,-7,120,8.33,14,72018.0,16:40,450,473,923,48.75,79,44,18,35,-17,0,8,8,9589.0,2:13,0,1,1,5927.0,1:22,5250000
8470151,Jay,Bouwmeester,1983-09-27,D,L,2018-19,78,3,14,17,0.22,-3,82,3.66,40,97019.0,20:43,0,0,0,0.0,61,127,25,42,-17,0,0,0,267.0,0:3,0,0,0,10263.0,2:11,5400000
8470187,Johnny,Boychuk,1984-01-19,D,R,2018-19,74,3,16,19,0.26,10,157,1.91,25,83604.0,18:49,0,0,0,0.0,144,120,10,56,-46,1,2,3,2993.0,0:40,0,1,1,6702.0,1:30,6000000
8470257,Alexander,Steen,1984-03-01,LW,L,2018-19,65,10,17,27,0.42,2,114,8.77,14,61781.0,15:50,11,18,29,37.93,55,50,34,16,18,2,3,5,4997.0,1:16,1,1,2,7606.0,1:57,5750000
8470281,Duncan,Keith,1983-07-16,D,L,2018-19,82,6,34,40,0.49,13,141,4.26,70,113246.0,23:1,0,0,0,0.0,42,144,33,73,-40,0,3,3,6803.0,1:22,0,1,1,9982.0,2:1,5538462
8470318,Jonathan,Ericsson,1984-03-02,D,L,2018-19,52,3,2,5,0.1,-10,48,6.25,35,53725.0,17:13,0,0,0,0.0,98,56,9,40,-31,0,0,0,33.0,0:0,0,0,0,7265.0,2:19,4250000
8470543,Chris,Kunitz,1979-09-26,LW,L,2018-19,56,5,5,10,0.18,-7,44,11.36,23,30438.0,9:3,2,5,7,28.57,85,15,13,18,-5,0,0,0,682.0,0:12,0,0,0,189.0,0:3,1000000
8470595,Eric,Staal,1984-10-29,C,L,2018-19,81,22,30,52,0.64,-7,215,10.23,34,88089.0,18:7,642,615,1257,51.07,41,28,49,39,10,7,8,15,13675.0,2:48,0,1,1,1253.0,0:15,3500000
8470598,Thomas,Vanek,1984-01-19,LW,R,2018-19,64,16,20,36,0.56,-12,108,14.81,26,54188.0,14:6,7,18,25,28.0,38,13,20,41,-21,4,7,11,9883.0,2:34,0,0,0,59.0,0:0,3000000
8470600,Ryan,Suter,1985-01-21,D,L,2018-19,82,7,40,47,0.57,-8,136,5.15,41,131325.0,26:41,1,0,1,100.0,78,109,25,30,-5,3,12,15,15068.0,3:3,1,1,2,11341.0,2:18,7538462
8470601,Braydon,Coburn,1985-02-27,D,L,2018-19,74,4,19,23,0.31,4,113,3.54,34,71529.0,16:6,0,0,0,0.0,96,62,17,22,-5,0,0,0,167.0,0:2,0,0,0,4586.0,1:1,3700000
8470602,Dion,Phaneuf,1985-04-10,D,L,2018-19,67,1,5,6,0.09,-21,80,1.25,53,60296.0,14:59,0,0,0,0.0,128,79,6,30,-24,0,0,0,2611.0,0:38,0,0,0,2987.0,0:44,7000000
8470604,Jeff,Carter,1985-01-01,C,R,2018-19,76,13,20,33,0.43,-20,174,7.47,42,82800.0,18:9,607,577,1184,51.27,80,30,23,40,-17,5,8,13,11234.0,2:27,1,1,2,5718.0,1:15,5272727
8470606,Dustin,Brown,1984-11-04,RW,R,2018-19,72,22,29,51,0.71,-17,180,12.22,24,88154.0,20:24,1,16,17,5.88,150,29,31,44,-13,9,3,12,11113.0,2:34,1,1,2,7349.0,1:42,5875000
8470607,Brent,Seabrook,1985-04-20,D,R,2018-19,78,5,23,28,0.36,-6,165,3.03,41,89373.0,19:5,0,0,0,0.0,124,180,19,72,-53,2,8,10,7626.0,1:37,0,1,1,9896.0,2:6,6875000
8470610,Zach,Parise,1984-07-28,LW,L,2018-19,74,28,33,61,0.82,-2,229,12.23,26,82887.0,18:40,9,25,34,26.47,49,71,22,25,-3,10,6,16,12881.0,2:54,0,2,2,5186.0,1:10,7538462
8470611,Eric,Fehr,1985-09-07,C,R,2018-19,72,7,8,15,0.21,-8,67,10.45,30,47705.0,11:2,364,345,709,51.34,40,48,32,12,20,0,0,0,133.0,0:1,0,1,1,8148.0,1:53,1000000
8470612,Ryan,Getzlaf,1985-05-10,C,R,2018-19,67,14,34,48,0.72,-19,133,10.53,58,78240.0,19:27,551,463,1014,54.34,150,74,60,79,-19,1,10,11,10824.0,2:41,0,0,0,2528.0,0:37,8250000
8470613,Brent,Burns,1985-03-09,D,R,2018-19,82,16,67,83,1.01,13,300,5.33,34,123488.0,25:5,0,1,1,0.0,90,105,88,118,-30,7,21,28,16145.0,3:16,1,4,5,9877.0,2:0,8000000
8470616,Ryan,Kesler,1984-08-31,C,R,2018-19,60,5,3,8,0.13,-19,86,5.81,44,59395.0,16:29,582,463,1045,55.69,93,56,18,26,-8,1,2,3,6239.0,1:43,0,0,0,8104.0,2:15,6875000
8470619,Brian,Boyle,1984-12-18,C,L,2018-19,73,18,6,24,0.33,-14,123,14.63,38,58848.0,13:26,170,163,333,51.05,145,50,22,17,5,7,2,9,11525.0,2:37,1,1,2,6763.0,1:32,2550000
8470621,Corey,Perry,1985-05-16,RW,R,2018-19,31,6,4,10,0.32,-16,59,10.17,27,27570.0,14:49,0,2,2,0.0,21,14,12,11,1,2,2,4,3392.0,1:49,0,0,0,18.0,0:0,8625000
8470622,Patrick,Eaves,1984-05-01,RW,R,2018-19,7,0,0,0,0.0,-4,6,0.0,4,5829.0,13:52,0,0,0,0.0,14,1,1,3,-2,0,0,0,656.0,1:33,0,0,0,5.0,0:0,3150000
8470626,Loui,Eriksson,1985-07-17,LW,L,2018-19,81,11,18,29,0.36,-11,107,10.28,22,68356.0,14:3,2,4,6,33.33,3,28,29,10,19,1,2,3,6177.0,1:16,0,0,0,5782.0,1:11,6000000
8470638,Patrice,Bergeron,1985-07-24,C,R,2018-19,65,32,47,79,1.22,23,205,15.61,30,72022.0,18:28,786,603,1389,56.59,43,60,42,27,15,9,18,27,12721.0,3:15,4,3,7,6598.0,1:41,6875000
8470642,Shea,Weber,1985-08-14,D,R,2018-19,58,14,19,33,0.57,15,166,8.43,28,81723.0,23:29,0,0,0,0.0,129,110,17,67,-50,5,1,6,8847.0,2:32,0,0,0,9800.0,2:48,7857143
8470655,David,Backes,1984-05-01,RW,R,2018-19,70,7,13,20,0.29,0,129,5.43,31,54763.0,13:2,176,133,309,56.96,140,30,33,26,7,2,5,7,6960.0,1:39,0,0,0,719.0,0:10,6000000
8470755,Brad,Richardson,1985-02-04,C,L,2018-19,66,19,8,27,0.41,6,128,14.84,22,63220.0,15:57,577,474,1051,54.9,63,55,27,21,6,0,0,0,997.0,0:15,3,3,6,10082.0,2:32,1250000
8470760,Marc,Methot,1985-06-21,D,L,2018-19,9,0,0,0,0.0,-3,3,0.0,6,9148.0,16:56,0,0,0,0.0,15,10,0,2,-2,0,0,0,4.0,0:0,0,0,0,883.0,1:38,4900000
8470775,Nate,Thompson,1984-10-05,C,L,2018-19,78,5,8,13,0.17,-1,71,7.04,17,60856.0,13:0,409,351,760,53.82,87,44,31,23,8,0,0,0,1262.0,0:16,0,0,0,8575.0,1:49,1650000
8470794,Joe,Pavelski,1984-07-11,C,R,2018-19,75,38,26,64,0.85,-4,188,20.21,22,85698.0,19:2,526,463,989,53.19,69,61,41,45,-4,12,9,21,13291.0,2:57,1,0,1,3223.0,0:42,6000000
8470803,Kyle,Brodziak,1984-05-25,C,R,2018-19,70,6,3,9,0.13,-14,74,8.11,33,49106.0,11:41,399,368,767,52.02,92,46,33,17,16,0,0,0,449.0,0:6,1,0,1,7012.0,1:40,1150000
8470834,Dustin,Byfuglien,1985-03-27,D,R,2018-19,42,4,27,31,0.74,4,115,3.48,69,61384.0,24:21,0,0,0,0.0,77,51,21,39,-18,1,15,16,7713.0,3:3,0,0,0,4539.0,1:48,7600000
8470966,Mark,Giordano,1983-10-03,D,L,2018-19,78,17,57,74,0.95,39,221,7.69,69,113439.0,24:14,0,0,0,0.0,58,144,73,65,8,3,18,21,15494.0,3:18,4,2,6,12479.0,2:39,6750000
8471214,Alex,Ovechkin,1985-09-17,LW,R,2018-19,81,51,38,89,1.1,7,338,15.09,40,101677.0,20:55,1,4,5,20.0,223,41,47,70,-23,18,10,28,21441.0,4:24,0,0,0,37.0,0:0,9538462
8471215,Evgeni,Malkin,1986-07-31,C,L,2018-19,68,21,51,72,1.06,-25,187,11.23,89,76720.0,18:48,381,453,834,45.68,54,33,64,84,-20,9,17,26,13915.0,3:24,0,0,0,155.0,0:2,9500000
8471217,Andrew,Ladd,1985-12-12,LW,L,2018-19,26,3,8,11,0.42,3,34,8.82,16,21594.0,13:50,2,3,5,40.0,37,8,9,14,-5,0,0,0,908.0,0:34,0,1,1,634.0,0:24,5500000
8471218,Blake,Wheeler,1986-08-31,RW,R,2018-19,82,20,71,91,1.11,0,231,8.66,60,101892.0,20:42,31,57,88,35.23,81,53,42,33,9,2,31,33,17684.0,3:35,2,1,3,5486.0,1:6,5600000
8471226,Drew,Stafford,1985-10-30,RW,R,2018-19,57,5,8,13,0.23,-7,77,6.49,18,41948.0,12:15,16,23,39,41.03,50,19,15,17,-2,1,1,2,3026.0,0:53,0,0,0,135.0,0:2,810000
8471228,Alexander,Radulov,1986-07-05,RW,L,2018-19,70,29,43,72,1.03,22,209,13.88,54,83088.0,19:46,6,10,16,37.5,60,83,43,74,-31,7,16,23,13017.0,3:5,0,0,0,130.0,0:1,6250000
8471233,Travis,Zajac,1985-05-13,C,R,2018-19,80,19,27,46,0.57,-25,120,15.83,20,92500.0,19:16,841,605,1446,58.16,66,38,63,33,30,5,7,12,12691.0,2:38,2,0,2,13049.0,2:43,5750000
8471242,Mike,Green,1985-10-12,D,R,2018-19,43,5,21,26,0.6,-1,92,5.43,28,55928.0,21:40,0,0,0,0.0,60,56,16,49,-33,0,3,3,5036.0,1:57,0,0,0,461.0,0:10,5375000
8471260,Blake,Comeau,1986-02-18,LW,R,2018-19,77,7,11,18,0.23,-7,102,6.86,42,72656.0,15:43,25,32,57,43.86,208,40,39,36,3,0,0,0,233.0,0:3,0,0,0,9597.0,2:4,2400000
8471262,Carl,Soderberg,1985-10-12,C,L,2018-19,82,23,26,49,0.6,-5,188,12.23,26,85849.0,17:26,528,542,1070,49.35,99,67,49,26,23,2,8,10,8510.0,1:43,3,0,3,12215.0,2:28,4750000
8471273,Brandon,Dubinsky,1986-04-29,C,L,2018-19,61,6,8,14,0.23,-16,63,9.52,36,45221.0,12:21,427,321,748,57.09,147,28,16,7,9,0,0,0,298.0,0:4,0,1,1,4738.0,1:17,5850000
8471274,Alex,Goligoski,1985-07-30,D,L,2018-19,76,3,24,27,0.36,-7,102,2.94,16,94925.0,20:49,1,0,1,100.0,79,154,19,59,-40,1,6,7,8420.0,1:50,0,2,2,7137.0,1:33,5475000
8471276,David,Krejci,1986-04-28,C,R,2018-19,81,20,53,73,0.9,7,139,14.39,16,85916.0,17:40,530,565,1095,48.4,28,24,54,44,10,6,10,16,10936.0,2:15,0,0,0,827.0,0:10,7250000
8471284,Andrej,Sekera,1986-06-08,D,L,2018-19,24,0,4,4,0.17,3,28,0.0,6,23744.0,16:29,0,0,0,0.0,17,21,6,13,-7,0,1,1,743.0,0:30,0,0,0,1895.0,1:18,5500000
8471303,Alexander,Edler,1986-04-21,D,L,2018-19,56,10,24,34,0.61,3,128,7.81,54,82555.0,24:34,0,0,0,0.0,127,166,13,38,-25,4,13,17,10483.0,3:7,0,1,1,8935.0,2:39,5000000
8471339,Ryan,Callahan,1985-03-21,RW,R,2018-19,52,7,10,17,0.33,7,76,9.21,14,34754.0,11:8,6,15,21,28.57,89,25,22,8,14,1,0,1,354.0,0:6,0,1,1,3180.0,1:1,5800000
8471392,Roman,Polak,1986-04-28,D,R,2018-19,77,1,8,9,0.12,6,77,1.3,69,88557.0,19:10,0,0,0,0.0,191,152,18,49,-31,0,0,0,160.0,0:2,0,0,0,12203.0,2:38,1300000
8471426,Troy,Brouwer,1985-08-17,RW,R,2018-19,75,12,9,21,0.28,-6,86,13.95,47,57100.0,12:41,19,32,51,37.25,177,38,23,44,-21,0,0,0,1307.0,0:17,1,0,1,7462.0,1:39,4500000
8471436,Matt,Hunwick,1985-05-21,D,L,2018-19,14,0,2,2,0.14,-7,10,0.0,4,13178.0,15:41,0,0,0,0.0,6,9,2,5,-3,0,0,0,33.0,0:2,0,0,0,1082.0,1:17,2250000
8471490,Adam,Cracknell,1985-07-15,RW,R,2018-19,2,0,0,0,0.0,-1,3,0.0,0,1252.0,10:26,0,0,0,0.0,6,0,0,1,-1,0,0,0,0.0,0:0,0,0,0,20.0,0:10,650000
8471657,Cody,McLeod,1984-06-26,LW,L,2018-19,38,1,0,1,0.03,-13,22,4.55,67,14786.0,6:29,0,1,1,0.0,112,10,5,1,4,0,0,0,11.0,0:0,0,0,0,2.0,0:0,750000
8471669,Paul,Stastny,1985-12-27,C,L,2018-19,50,13,29,42,0.84,14,103,12.62,30,54312.0,18:6,463,384,847,54.66,35,15,36,18,18,1,3,4,6125.0,2:2,1,1,2,3286.0,1:5,6500000
8471675,Sidney,Crosby,1987-08-07,C,L,2018-19,79,35,65,100,1.27,18,220,15.91,36,99501.0,20:59,1012,814,1826,55.42,85,43,54,67,-13,12,17,29,15197.0,3:12,0,2,2,2687.0,0:34,8700000
8471676,Bobby,Ryan,1987-03-17,RW,R,2018-19,78,15,27,42,0.54,-29,160,9.38,35,73393.0,15:40,8,18,26,30.77,77,49,50,48,2,7,9,16,11065.0,2:21,0,0,0,417.0,0:5,7250000
8471677,Jack,Johnson,1987-01-13,D,L,2018-19,82,1,12,13,0.16,-4,86,1.16,41,94850.0,19:16,0,0,0,0.0,233,147,14,32,-18,1,1,2,1608.0,0:19,0,2,2,11144.0,2:15,3250000
8471685,Anze,Kopitar,1987-08-24,C,L,2018-19,81,22,38,60,0.74,-20,156,14.1,30,108410.0,22:18,1002,817,1819,55.09,59,66,57,58,-1,1,18,19,13794.0,2:50,2,0,2,9554.0,1:57,10000000
8471686,Marc,Staal,1987-01-13,D,L,2018-19,79,3,10,13,0.16,-9,84,3.57,32,92052.0,19:25,0,0,0,0.0,94,119,28,68,-40,0,0,0,143.0,0:1,0,0,0,13702.0,2:53,5700000
8471691,Martin,Hanzal,1987-02-20,C,L,2018-19,7,1,1,2,0.29,-4,14,7.14,4,5403.0,12:51,45,31,76,59.21,14,4,2,3,-1,1,0,1,808.0,1:55,0,0,0,513.0,1:13,4750000
8471698,T.J.,Oshie,1986-12-23,RW,R,2018-19,69,25,29,54,0.78,5,143,17.48,36,77050.0,18:36,84,121,205,40.98,133,55,46,38,8,6,8,14,13893.0,3:21,1,0,1,2420.0,0:35,5750000
8471699,Andrew,Cogliano,1987-06-14,LW,L,2018-19,78,6,11,17,0.22,1,106,5.66,22,58925.0,12:35,11,18,29,37.93,68,32,22,32,-10,1,0,1,302.0,0:3,0,0,0,6414.0,1:22,3250000
8471702,Matt,Niskanen,1986-12-06,D,R,2018-19,80,8,17,25,0.31,-3,143,5.59,41,105271.0,21:55,0,0,0,0.0,167,137,40,73,-33,1,1,2,2764.0,0:34,0,1,1,13240.0,2:45,5750000
8471707,James,Neal,1987-09-03,LW,L,2018-19,63,7,12,19,0.3,-5,141,4.96,28,56542.0,14:57,5,6,11,45.45,46,19,11,35,-24,2,4,6,8343.0,2:12,0,0,0,61.0,0:0,5750000
8471709,Marc-Edouard,Vlasic,1987-03-30,D,L,2018-19,72,3,22,25,0.35,-6,100,3.0,10,90904.0,21:2,0,0,0,0.0,23,114,24,51,-27,0,1,1,3281.0,0:45,0,0,0,11272.0,2:36,7000000
8471716,Justin,Abdelkader,1987-02-25,LW,L,2018-19,71,6,13,19,0.27,-14,95,6.32,38,65606.0,15:24,52,51,103,50.49,185,34,9,40,-31,1,1,2,2635.0,0:37,1,0,1,7972.0,1:52,4250000
8471717,Adam,McQuaid,1986-10-12,D,R,2018-19,50,3,4,7,0.14,2,28,10.71,42,47332.0,15:46,0,0,0,0.0,122,88,11,19,-8,0,0,0,34.0,0:0,0,1,1,5196.0,1:43,2750000
8471724,Kris,Letang,1987-04-24,D,R,2018-19,65,16,40,56,0.86,13,206,7.77,48,101241.0,25:57,0,0,0,0.0,116,111,63,76,-13,2,17,19,12633.0,3:14,1,1,2,8398.0,2:9,7250000
8471729,Kris,Russell,1987-05-02,D,L,2018-19,72,3,13,16,0.22,5,63,4.76,27,88246.0,20:25,0,0,0,0.0,93,185,21,71,-50,0,0,0,984.0,0:13,0,1,1,8421.0,1:56,4000000
8471735,Keith,Yandle,1986-09-09,D,L,2018-19,82,9,53,62,0.76,-17,199,4.52,50,110422.0,22:26,0,0,0,0.0,47,76,27,110,-83,7,32,39,17483.0,3:33,0,0,0,1850.0,0:22,6350000
8471743,Vladimir,Sobotka,1987-07-02,LW,L,2018-19,69,5,8,13,0.19,-20,71,7.04,26,58729.0,14:11,318,295,613,51.88,87,30,12,14,-2,0,0,0,631.0,0:9,0,1,1,7831.0,1:53,3500000
8471761,Chris,Butler,1986-10-27,D,L,2018-19,13,1,1,2,0.15,3,10,10.0,0,10950.0,14:2,0,0,0,0.0,17,17,3,4,-1,0,0,0,10.0,0:0,0,0,0,732.0,0:56,650000
8471768,Tom,Pyatt,1987-02-14,LW,L,2018-19,37,0,2,2,0.05,-16,29,0.0,2,26004.0,11:42,56,92,148,37.84,15,46,4,9,-5,0,0,0,58.0,0:1,0,0,0,3956.0,1:46,1100000
8471769,Niklas,Hjalmarsson,1987-06-06,D,L,2018-19,82,0,10,10,0.12,8,57,0.0,44,96916.0,19:41,0,0,0,0.0,45,187,32,46,-14,0,0,0,85.0,0:1,0,2,2,15565.0,3:9,4100000
8471794,Darren,Helm,1987-01-21,LW,L,2018-19,61,7,10,17,0.28,-11,107,6.54,20,53342.0,14:34,16,20,36,44.44,50,26,33,30,3,0,0,0,208.0,0:3,1,3,4,6891.0,1:52,3850000
8471817,Ryan,Reaves,1987-01-20,RW,R,2018-19,80,9,11,20,0.25,1,95,9.47,74,52189.0,10:52,40,54,94,42.55,305,24,37,11,26,3,0,3,3497.0,0:43,0,0,0,0.0,0:0,2775000
8471873,Anton,Stralman,1986-08-01,D,R,2018-19,47,2,15,17,0.36,12,57,3.51,8,57875.0,20:31,0,0,0,0.0,59,71,25,16,9,0,1,1,314.0,0:6,0,0,0,8251.0,2:55,4500000
8471887,Patric,Hornqvist,1987-01-01,RW,R,2018-19,69,18,19,37,0.54,-3,197,9.14,26,64072.0,15:28,9,9,18,50.0,150,34,25,18,7,6,6,12,11273.0,2:43,0,0,0,46.0,0:0,5300000
8471958,Dan,Girardi,1984-04-29,D,R,2018-19,62,4,12,16,0.26,6,75,5.33,12,66217.0,17:48,0,0,0,0.0,151,108,8,25,-17,0,0,0,106.0,0:1,0,1,1,8357.0,2:14,5500000
8472382,Andy,Greene,1982-10-30,D,L,2018-19,82,5,20,25,0.3,-9,104,4.81,16,102502.0,20:50,0,0,0,0.0,67,208,40,45,-5,0,2,2,549.0,0:6,0,4,4,20155.0,4:5,5000000
8472410,Stephen,Gionta,1983-10-09,RW,R,2018-19,5,0,0,0,0.0,-4,4,0.0,0,2635.0,8:47,20,17,37,54.05,14,2,0,2,-2,0,0,0,7.0,0:1,0,0,0,322.0,1:4,650000
8473412,Bryan,Little,1987-11-12,C,R,2018-19,82,15,26,41,0.5,-12,126,11.9,26,77897.0,15:49,526,476,1002,52.5,62,29,36,21,15,4,3,7,6970.0,1:25,0,2,2,5791.0,1:10,5291667
8473415,Alex,Biega,1988-04-04,D,R,2018-19,41,2,14,16,0.39,0,91,2.2,22,43471.0,17:40,0,0,0,0.0,101,43,4,17,-13,0,1,1,201.0,0:4,0,0,0,1687.0,0:41,825000
8473419,Brad,Marchand,1988-05-11,LW,L,2018-19,79,36,64,100,1.27,15,231,15.58,96,93016.0,19:37,45,60,105,42.86,46,19,59,84,-25,10,24,34,14997.0,3:9,3,4,7,7438.0,1:34,6125000
8473422,Nick,Foligno,1987-10-31,LW,L,2018-19,73,17,18,35,0.48,12,141,12.06,44,77543.0,17:42,133,102,235,56.6,175,51,37,26,11,2,2,4,10743.0,2:27,0,0,0,3834.0,0:52,5500000
8473446,Erik,Johnson,1988-03-21,D,R,2018-19,80,7,18,25,0.31,8,144,4.86,38,104710.0,21:48,0,0,0,0.0,124,143,31,41,-10,0,0,0,1721.0,0:21,0,0,0,14866.0,3:5,6000000
8473449,Kyle,Okposo,1988-04-16,RW,R,2018-19,78,14,15,29,0.37,-9,147,9.52,41,64515.0,13:47,63,71,134,47.01,87,27,17,27,-10,7,4,11,8835.0,1:53,0,0,0,65.0,0:0,6000000
8473453,Trevor,Lewis,1987-01-08,C,R,2018-19,44,3,9,12,0.27,-9,87,3.45,9,37020.0,14:1,57,67,124,45.97,53,25,12,12,0,0,0,0,262.0,0:5,0,0,0,3818.0,1:26,2000000
8473463,Leo,Komarov,1987-01-23,C,L,2018-19,82,6,20,26,0.32,18,78,7.69,42,68346.0,13:53,84,100,184,45.65,203,38,28,26,2,0,0,0,330.0,0:4,0,0,0,8541.0,1:44,3000000
8473465,Jamie,McGinn,1988-08-05,LW,L,2018-19,19,4,3,7,0.37,-5,23,17.39,6,12172.0,10:40,1,0,1,100.0,34,3,4,6,-2,1,0,1,1210.0,1:3,0,0,0,7.0,0:0,3333333
8473468,Eric,Gryba,1988-04-14,D,R,2018-19,10,0,0,0,0.0,-1,11,0.0,10,9177.0,15:17,0,0,0,0.0,21,16,4,6,-2,0,0,0,7.0,0:0,0,0,0,761.0,1:16,900000
8473473,Milan,Lucic,1988-06-07,LW,L,2018-19,79,6,14,20,0.25,-9,74,8.11,91,62738.0,13:14,25,20,45,55.56,259,22,27,34,-7,2,2,4,6367.0,1:20,0,0,0,0.0,0:0,6000000
8473492,Matt,Beleskey,1988-06-07,LW,L,2018-19,4,1,0,1,0.25,1,3,33.33,5,1769.0,7:22,1,0,1,100.0,7,1,0,2,-2,0,0,0,0.0,0:0,0,0,0,0.0,0:0,3800000
8473504,Cal,Clutterbuck,1987-11-18,RW,R,2018-19,73,8,15,23,0.32,6,95,8.42,44,61200.0,13:58,15,19,34,44.12,209,40,20,28,-8,3,0,3,5495.0,1:15,0,1,1,8028.0,1:49,3500000
8473507,Jeff,Petry,1987-12-09,D,R,2018-19,82,13,33,46,0.56,-5,172,7.56,28,113747.0,23:7,0,1,1,0.0,190,123,39,129,-90,3,8,11,12464.0,2:32,0,1,1,10323.0,2:5,5500000
8473512,Claude,Giroux,1988-01-12,C,R,2018-19,82,22,63,85,1.04,9,229,9.61,24,105567.0,21:27,674,490,1164,57.9,28,19,46,48,-2,2,21,23,17304.0,3:31,1,0,1,8534.0,1:44,8275000
8473533,Jordan,Staal,1988-09-10,C,L,2018-19,50,11,17,28,0.56,6,121,9.09,26,54854.0,18:17,571,452,1023,55.82,122,18,40,24,16,0,2,2,5463.0,1:49,0,0,0,5467.0,1:49,6000000
8473534,Patrik,Berglund,1988-06-02,C,L,2018-19,23,2,2,4,0.17,-5,25,8.0,6,17999.0,13:2,68,48,116,58.62,25,16,6,5,1,0,0,0,755.0,0:32,0,0,0,1548.0,1:7,3850000
8473544,Derick,Brassard,1987-09-22,C,L,2018-19,70,14,9,23,0.33,-19,110,12.73,39,62980.0,14:59,283,305,588,48.13,102,15,35,28,7,2,3,5,6680.0,1:35,0,0,0,367.0,0:5,5000000
8473546,Michael,Grabner,1987-10-05,RW,L,2018-19,41,9,7,16,0.39,-2,65,13.85,8,35401.0,14:23,5,7,12,41.67,28,15,31,19,12,0,0,0,207.0,0:5,6,3,9,5800.0,2:21,3350000
8473548,Phil,Kessel,1987-10-02,RW,R,2018-19,82,27,55,82,1.0,-19,215,12.56,28,88453.0,17:58,4,5,9,44.44,12,18,33,78,-45,12,24,36,15897.0,3:13,0,0,0,12.0,0:0,8000000
8473560,Korbinian,Holzer,1988-02-16,D,R,2018-19,22,1,3,4,0.18,5,15,6.67,8,21208.0,16:4,0,0,0,0.0,61,38,7,15,-8,0,0,0,48.0,0:2,0,0,0,3356.0,2:32,900000
8473563,Nicklas,Backstrom,1987-11-23,C,L,2018-19,80,22,52,74,0.92,2,169,13.02,30,95773.0,19:57,700,739,1439,48.64,54,30,53,62,-9,7,18,25,17754.0,3:41,0,0,0,4434.0,0:55,6700000
8473564,Michael,Frolik,1988-02-17,RW,L,2018-19,65,16,18,34,0.52,24,132,12.12,26,52109.0,13:21,13,25,38,34.21,57,22,33,49,-16,0,0,0,268.0,0:4,2,0,2,2227.0,0:34,4300000
8473573,Artem,Anisimov,1988-05-24,C,L,2018-19,78,15,22,37,0.47,-2,142,10.56,14,76484.0,16:20,332,394,726,45.73,25,33,50,14,36,1,3,4,6591.0,1:24,1,0,1,5309.0,1:8,4550000
8473584,Andrew,MacDonald,1986-09-07,D,L,2018-19,47,0,9,9,0.19,-5,41,0.0,18,46232.0,16:23,0,0,0,0.0,30,95,3,27,-24,0,0,0,166.0,0:3,0,2,2,5391.0,1:54,5000000
8473588,Erik,Condra,1986-08-06,RW,R,2018-19,6,1,0,1,0.17,-2,10,10.0,2,4566.0,12:41,0,1,1,0.0,3,1,0,6,-6,0,0,0,432.0,1:12,0,0,0,0.0,0:0,700000
8473604,Jonathan,Toews,1988-04-29,C,L,2018-19,82,35,46,81,0.99,2,235,14.89,40,103354.0,21:0,1059,821,1880,56.33,42,44,72,52,20,9,14,23,16096.0,3:16,1,0,1,8538.0,1:44,10500000
8473618,Mathieu,Perreault,1988-01-05,C,L,2018-19,82,15,15,30,0.37,-1,95,15.79,44,60182.0,12:13,26,27,53,49.06,127,25,31,17,14,4,3,7,6772.0,1:22,0,0,0,39.0,0:0,4125000
8473673,David,Schlemko,1987-05-07,D,L,2018-19,18,0,2,2,0.11,-1,29,0.0,4,21432.0,19:50,0,0,0,0.0,29,45,4,20,-16,0,2,2,1458.0,1:21,0,0,0,2380.0,2:12,2100000
8473914,Mark,Letestu,1985-02-04,C,R,2018-19,2,0,0,0,0.0,-1,1,0.0,0,1120.0,9:20,5,1,6,83.33,3,0,0,0,0,0,0,0,41.0,0:20,0,0,0,0.0,0:0,750000
8473933,Ben,Lovejoy,1984-02-20,D,R,2018-19,71,2,7,9,0.13,-1,95,2.11,37,72788.0,17:5,0,0,0,0.0,76,118,23,38,-15,0,0,0,194.0,0:2,0,0,0,14461.0,3:23,2666667
8473986,Alex,Killorn,1989-09-14,LW,L,2018-19,82,18,22,40,0.49,22,153,11.76,45,73182.0,14:52,2,8,10,20.0,88,23,30,22,8,2,3,5,6753.0,1:22,1,1,2,9602.0,1:57,4450000
8473991,Karl,Alzner,1988-09-24,D,L,2018-19,9,0,1,1,0.11,1,8,0.0,2,9342.0,17:18,0,0,0,0.0,13,10,1,6,-5,0,0,0,24.0,0:2,0,0,0,1144.0,2:7,4625000
8473992,Justin,Falk,1988-10-11,D,L,2018-19,10,0,0,0,0.0,-4,7,0.0,11,7755.0,12:55,0,0,0,0.0,36,9,1,5,-4,0,0,0,8.0,0:0,0,0,0,672.0,1:7,650000
8473994,Jamie,Benn,1989-07-18,LW,L,2018-19,78,27,26,53,0.68,14,189,14.29,56,85302.0,18:13,205,213,418,49.04,142,71,44,80,-36,8,3,11,12322.0,2:37,0,0,0,1702.0,0:21,9500000
8474000,Steven,Kampfer,1988-09-24,D,R,2018-19,35,3,3,6,0.17,-6,40,7.5,22,30714.0,14:37,0,0,0,0.0,44,32,12,7,5,1,1,2,1942.0,0:55,0,0,0,1286.0,0:36,650000
8474008,Paul,Carey,1988-09-24,C,L,2018-19,7,0,0,0,0.0,0,4,0.0,0,4470.0,10:38,1,3,4,25.0,3,3,3,4,-1,0,0,0,16.0,0:2,0,0,0,77.0,0:11,700000
8474009,Nick,Bonino,1988-04-20,C,L,2018-19,81,17,18,35,0.43,27,118,14.41,18,79244.0,16:18,586,546,1132,51.77,24,70,30,40,-10,3,0,3,8071.0,1:39,0,1,1,9415.0,1:56,4100000
8474013,Ian,Cole,1989-02-21,D,L,2018-19,71,2,13,15,0.21,-1,82,2.44,115,84161.0,19:45,0,0,0,0.0,107,178,27,46,-19,0,0,0,356.0,0:5,0,0,0,13987.0,3:17,4250000
8474025,Eric,Tangradi,1989-02-10,LW,L,2018-19,6,0,1,1,0.17,-3,10,0.0,0,4961.0,13:46,3,3,6,50.0,11,4,3,1,2,0,0,0,637.0,1:46,0,0,0,7.0,0:1,650000
8474027,Justin,Braun,1987-02-10,D,R,2018-19,78,2,14,16,0.21,-14,105,1.9,35,95035.0,20:18,0,0,0,0.0,121,120,34,51,-17,0,1,1,509.0,0:6,0,0,0,10730.0,2:17,3800000
8474031,Kevin,Shattenkirk,1989-01-29,D,R,2018-19,73,2,26,28,0.38,-15,148,1.35,20,82956.0,18:56,0,0,0,0.0,73,104,39,55,-16,1,6,7,10644.0,2:25,0,0,0,1904.0,0:26,6650000
8474034,Patrick,Maroon,1988-04-23,LW,L,2018-19,74,10,18,28,0.38,-3,118,8.47,64,62913.0,14:10,2,3,5,40.0,135,7,25,21,4,2,9,11,8662.0,1:57,0,0,0,0.0,0:0,1750000
8474037,James,van Riemsdyk,1989-05-04,LW,L,2018-19,66,27,21,48,0.73,-10,167,16.17,18,65750.0,16:36,6,5,11,54.55,34,16,25,19,6,8,5,13,10978.0,2:46,0,0,0,28.0,0:0,7000000
8474038,Paul,Byron,1989-04-27,LW,L,2018-19,56,15,16,31,0.55,16,94,15.96,17,48944.0,14:34,12,23,35,34.29,114,36,12,26,-14,0,1,1,3618.0,1:4,2,1,3,4650.0,1:23,1166667
8474040,Sam,Gagner,1989-08-10,C,R,2018-19,32,6,7,13,0.41,-6,68,8.82,14,28003.0,14:35,59,59,118,50.0,21,7,5,20,-15,1,0,1,2730.0,1:25,0,0,0,46.0,0:1,3150000
8474053,Logan,Couture,1989-03-28,C,L,2018-19,81,27,43,70,0.86,-6,204,13.24,22,90371.0,18:35,282,327,609,46.31,65,52,71,36,35,6,12,18,14074.0,2:53,2,0,2,7589.0,1:33,6000000
8474056,P.K.,Subban,1989-05-13,D,R,2018-19,63,9,22,31,0.49,5,168,5.36,60,85671.0,22:39,0,0,0,0.0,56,75,22,57,-35,2,8,10,9787.0,2:35,1,0,1,5907.0,1:33,9000000
8474061,Anthony,Peluso,1989-04-18,RW,R,2018-19,4,0,0,0,0.0,-1,1,0.0,7,987.0,4:6,0,0,0,0.0,4,0,2,1,1,0,0,0,0.0,0:0,0,0,0,0.0,0:0,650000
8474062,Riley,Nash,1989-05-09,C,R,2018-19,78,3,9,12,0.15,-8,79,3.8,19,50730.0,10:50,150,183,333,45.05,72,43,39,13,26,0,0,0,374.0,0:4,0,0,0,1356.0,0:17,2750000
8474066,Thomas,Hickey,1989-02-08,D,L,2018-19,40,0,4,4,0.1,5,47,0.0,33,44412.0,18:30,0,0,0,0.0,40,71,9,27,-18,0,0,0,165.0,0:4,0,1,1,5427.0,2:15,2500000
8474068,Kyle,Turris,1989-08-14,C,R,2018-19,55,7,16,23,0.42,-6,78,8.97,33,51784.0,15:41,281,272,553,50.81,24,15,19,26,-7,4,2,6,7370.0,2:14,0,0,0,93.0,0:1,6000000
8474089,Brad,Malone,1989-05-20,C,L,2018-19,16,0,0,0,0.0,0,13,0.0,4,8593.0,8:57,32,40,72,44.44,35,5,1,1,0,0,0,0,39.0,0:2,0,0,0,893.0,0:55,650000
8474090,Brendan,Smith,1989-02-08,D,L,2018-19,63,4,9,13,0.21,-7,66,6.06,71,57818.0,15:17,0,1,1,0.0,100,48,32,50,-18,0,0,0,162.0,0:2,0,1,1,6049.0,1:36,4350000
8474091,Brandon,Sutter,1989-02-14,C,R,2018-19,26,4,2,6,0.23,-12,43,9.3,6,27249.0,17:28,224,238,462,48.48,33,13,8,6,2,1,0,1,1405.0,0:54,1,0,1,4883.0,3:7,4375000
8474098,Colton,Sceviour,1989-04-20,C,R,2018-19,59,5,10,15,0.25,-2,116,4.31,15,43525.0,12:17,39,71,110,35.45,89,58,18,24,-6,0,1,1,173.0,0:2,0,0,0,7156.0,2:1,1200000
8474102,David,Perron,1988-05-28,LW,R,2018-19,57,23,23,46,0.81,3,112,20.54,46,58466.0,17:5,15,18,33,45.45,52,13,41,17,24,7,7,14,7997.0,2:20,0,0,0,91.0,0:1,4000000
8474125,Carl,Gunnarsson,1986-11-09,D,L,2018-19,25,3,4,7,0.28,8,21,14.29,6,23897.0,15:55,0,0,0,0.0,11,35,6,7,-1,0,0,0,30.0,0:1,0,1,1,2541.0,1:41,2900000
8474131,Mario,Kempe,1988-09-19,RW,L,2018-19,52,4,5,9,0.17,5,57,7.02,18,34893.0,11:11,126,203,329,38.3,105,30,11,10,1,0,0,0,129.0,0:2,0,0,0,2272.0,0:43,700000
8474134,Yannick,Weber,1988-09-23,D,R,2018-19,62,2,6,8,0.13,7,67,2.99,18,44317.0,11:54,0,0,0,0.0,64,32,7,13,-6,0,0,0,274.0,0:4,0,0,0,1281.0,0:20,675000
8474141,Patrick,Kane,1988-11-19,RW,L,2018-19,81,44,66,110,1.36,2,341,12.9,22,109297.0,22:29,1,4,5,20.0,21,18,42,54,-12,9,21,30,18043.0,3:42,0,0,0,248.0,0:3,10500000
8474145,Robert,Bortuzzo,1989-03-18,D,R,2018-19,59,2,8,10,0.17,9,75,2.67,47,54775.0,15:28,0,0,0,0.0,95,72,11,20,-9,0,0,0,133.0,0:2,0,1,1,8318.0,2:20,1150000
8474149,Evgenii,Dadonov,1989-03-12,RW,L,2018-19,82,28,42,70,0.85,-6,195,14.36,8,90386.0,18:22,2,3,5,40.0,33,42,45,59,-14,8,9,17,16509.0,3:21,0,0,0,46.0,0:0,4000000
8474150,Mikael,Backlund,1989-03-17,C,L,2018-19,77,21,26,47,0.61,34,205,10.24,52,82661.0,17:53,511,520,1031,49.56,52,26,78,55,23,1,1,2,7597.0,1:38,1,1,2,6448.0,1:23,5350000
8474151,Ryan,McDonagh,1989-06-13,D,L,2018-19,82,9,37,46,0.56,38,128,7.03,34,108674.0,22:5,0,0,0,0.0,98,161,46,66,-20,0,3,3,3254.0,0:39,0,3,3,15489.0,3:8,4700000
8474157,Max,Pacioretty,1988-11-20,LW,L,2018-19,66,22,18,40,0.61,-13,191,11.52,36,67325.0,17:0,21,32,53,39.62,119,20,39,38,1,4,4,8,10017.0,2:31,0,0,0,970.0,0:14,4500000
8474161,Jakub,Voracek,1989-08-15,RW,L,2018-19,78,20,46,66,0.85,-16,210,9.52,25,87386.0,18:40,12,18,30,40.0,17,29,32,58,-26,4,14,18,15222.0,3:15,0,0,0,129.0,0:1,8250000
8474162,Jake,Muzzin,1989-02-21,D,L,2018-19,80,9,28,37,0.46,21,141,6.38,47,102439.0,21:20,0,0,0,0.0,172,134,20,102,-82,1,4,5,5625.0,1:10,0,1,1,8447.0,1:45,4000000
8474166,Alec,Martinez,1987-07-26,D,L,2018-19,60,4,14,18,0.3,-2,78,5.13,8,76907.0,21:21,0,0,0,0.0,78,135,12,70,-58,0,2,2,4354.0,1:12,0,0,0,6826.0,1:53,4000000
8474176,Carl,Hagelin,1988-08-23,LW,L,2018-19,58,5,14,19,0.33,7,99,5.05,30,51258.0,14:43,6,21,27,22.22,64,20,30,19,11,0,0,0,167.0,0:2,0,0,0,6790.0,1:57,4000000
8474189,Lars,Eller,1989-05-08,C,L,2018-19,81,13,23,36,0.44,-1,163,7.98,37,80357.0,16:32,543,566,1109,48.96,69,47,59,63,-4,0,3,3,6256.0,1:17,1,2,3,11347.0,2:20,3500000
8474190,Wayne,Simmonds,1988-08-26,RW,R,2018-19,79,17,13,30,0.38,-16,157,10.83,99,74258.0,15:39,4,13,17,23.53,137,28,27,38,-11,5,3,8,13060.0,2:45,0,0,0,27.0,0:0,3975000
8474207,Nick,Holden,1987-05-15,D,L,2018-19,61,3,12,15,0.25,5,77,3.9,14,66950.0,18:17,0,0,0,0.0,104,76,26,30,-4,0,0,0,324.0,0:5,0,2,2,6385.0,1:44,2200000
8474218,Jason,Demers,1988-06-09,D,R,2018-19,35,2,6,8,0.23,9,39,5.13,12,41984.0,19:59,0,0,0,0.0,50,43,14,18,-4,0,1,1,855.0,0:24,0,0,0,4017.0,1:54,4500000
8474230,Micheal,Haley,1986-03-30,C,L,2018-19,43,2,4,6,0.14,-2,34,5.88,75,20875.0,8:5,13,17,30,43.33,76,16,3,15,-12,0,0,0,105.0,0:2,0,0,0,31.0,0:0,825000
8474250,Zack,Smith,1988-04-05,LW,L,2018-19,70,9,19,28,0.4,-6,101,8.91,81,68679.0,16:21,403,417,820,49.15,136,27,42,47,-5,0,0,0,428.0,0:6,1,2,3,7656.0,1:49,3250000
8474291,Jay,Beagle,1985-10-16,C,R,2018-19,57,3,10,13,0.23,-8,45,6.67,18,46699.0,13:39,426,332,758,56.2,102,33,13,10,3,0,0,0,143.0,0:2,1,0,1,9156.0,2:40,3000000
8474520,Jason,Garrison,1984-11-13,D,L,2018-19,17,1,0,1,0.06,1,16,6.25,8,12950.0,12:41,0,0,0,0.0,13,23,2,5,-3,1,0,1,1113.0,1:5,0,0,0,1012.0,0:59,650000
8474563,Drew,Doughty,1989-12-08,D,R,2018-19,82,8,37,45,0.55,-35,154,5.19,44,130846.0,26:35,0,0,0,0.0,168,120,23,105,-82,7,17,24,14420.0,2:55,0,1,1,12073.0,2:27,7000000
8474564,Steven,Stamkos,1990-02-07,C,R,2018-19,82,45,53,98,1.2,4,234,19.23,37,90037.0,18:18,506,447,953,53.1,72,40,28,60,-32,19,21,40,17858.0,3:37,2,0,2,2959.0,0:36,8500000
8474565,Alex,Pietrangelo,1990-01-18,D,R,2018-19,71,13,28,41,0.58,2,168,7.74,22,102568.0,24:4,0,1,1,0.0,62,139,55,50,5,3,12,15,11730.0,2:45,0,1,1,8768.0,2:3,6500000
8474567,Zach,Bogosian,1990-07-15,D,R,2018-19,65,3,16,19,0.29,-5,93,3.23,52,84344.0,21:37,0,0,0,0.0,83,116,17,46,-29,0,1,1,997.0,0:15,1,0,1,10776.0,2:45,5142857
8474568,Luke,Schenn,1989-11-02,D,R,2018-19,26,0,2,2,0.08,-10,30,0.0,16,21692.0,13:54,0,0,0,0.0,105,39,2,9,-7,0,0,0,2.0,0:0,0,0,0,1912.0,1:13,800000
8474569,Colin,Wilson,1989-10-20,C,L,2018-19,65,12,15,27,0.42,-6,104,11.54,8,52894.0,13:33,20,32,52,38.46,55,31,16,10,6,5,2,7,8114.0,2:4,0,0,0,42.0,0:0,3937500
8474571,Mikkel,Boedker,1989-12-16,LW,L,2018-19,71,7,28,35,0.49,-23,88,7.95,6,59737.0,14:1,7,11,18,38.89,54,28,25,27,-2,2,5,7,8026.0,1:53,0,0,0,72.0,0:1,4000000
8474573,Josh,Bailey,1989-10-02,RW,L,2018-19,82,16,40,56,0.68,8,126,12.7,21,82792.0,16:49,140,132,272,51.47,19,32,41,80,-39,2,12,14,12057.0,2:27,1,0,1,170.0,0:2,5000000
8474574,Tyler,Myers,1990-02-01,D,R,2018-19,80,9,22,31,0.39,11,156,5.77,63,97665.0,20:20,0,0,0,0.0,97,99,32,63,-31,0,7,7,5559.0,1:9,1,1,2,10423.0,2:10,5500000
8474578,Erik,Karlsson,1990-05-31,D,R,2018-19,53,3,42,45,0.85,6,169,1.78,22,77879.0,24:29,0,1,1,0.0,44,69,59,63,-4,2,18,20,9904.0,3:6,0,0,0,5849.0,1:50,6500000
8474579,Luca,Sbisa,1990-01-30,D,L,2018-19,9,0,1,1,0.11,0,5,0.0,4,8353.0,15:28,0,0,0,0.0,17,7,1,3,-2,0,0,0,3.0,0:0,0,0,0,951.0,1:45,1500000
8474581,Jake,Gardiner,1990-07-04,D,L,2018-19,62,3,27,30,0.48,19,78,3.85,26,78916.0,21:12,0,1,1,0.0,61,64,25,53,-28,0,5,5,6918.0,1:51,0,0,0,470.0,0:7,4050000
8474584,Michael,Del Zotto,1990-06-24,D,L,2018-19,42,1,9,10,0.24,-2,45,2.22,8,42912.0,17:1,0,0,0,0.0,129,53,7,22,-15,0,0,0,226.0,0:5,0,0,0,4297.0,1:42,3000000
8474586,Jordan,Eberle,1990-05-15,C,R,2018-19,78,19,18,37,0.47,-6,160,11.88,17,77346.0,16:31,9,11,20,45.0,36,35,34,40,-6,7,5,12,13155.0,2:48,0,0,0,111.0,0:1,6000000
8474589,Tyler,Ennis,1989-10-06,LW,L,2018-19,51,12,6,18,0.35,-6,81,14.81,2,30414.0,9:56,1,0,1,100.0,49,14,19,21,-2,2,3,5,4928.0,1:36,0,0,0,0.0,0:0,4600000
8474590,John,Carlson,1990-01-10,D,R,2018-19,80,13,57,70,0.88,21,185,7.03,34,120311.0,25:3,0,0,0,0.0,54,164,55,87,-32,3,30,33,19585.0,4:4,0,0,0,12373.0,2:34,8000000
8474597,Cody,Goloubef,1989-11-30,D,R,2018-19,5,0,0,0,0.0,0,3,0.0,2,3247.0,10:49,0,0,0,0.0,13,5,0,2,-2,0,0,0,0.0,0:0,0,0,0,83.0,0:16,650000
8474600,Roman,Josi,1990-06-01,D,L,2018-19,82,15,41,56,0.68,9,274,5.47,42,123814.0,25:9,0,1,1,0.0,53,144,36,65,-29,2,10,12,14670.0,2:58,0,1,1,12742.0,2:35,4000000
8474602,Justin,Schultz,1990-07-06,D,R,2018-19,29,2,13,15,0.52,0,47,4.26,4,35672.0,20:30,0,0,0,0.0,25,41,5,27,-22,1,5,6,4178.0,2:24,0,0,0,235.0,0:8,5500000
8474610,Zac,Dalpe,1989-11-01,C,R,2018-19,1,0,1,1,1.0,1,1,0.0,0,541.0,9:1,0,1,1,0.0,0,0,0,0,0,0,0,0,0.0,0:0,0,0,0,0.0,0:0,725000
8474611,Cameron,Gaunce,1990-03-19,D,L,2018-19,2,0,0,0,0.0,3,2,0.0,7,1880.0,15:40,0,0,0,0.0,4,1,2,2,0,0,0,0,0.0,0:0,0,0,0,133.0,1:6,650000
8474612,Travis,Hamonic,1990-08-16,D,R,2018-19,69,7,12,19,0.28,21,128,5.47,33,86384.0,20:51,0,1,1,0.0,44,167,37,62,-25,0,0,0,779.0,0:11,1,2,3,11819.0,2:51,3857143
8474613,Derek,Stepan,1990-06-18,C,R,2018-19,72,15,20,35,0.49,-2,195,7.69,14,83046.0,19:13,651,725,1376,47.31,50,51,50,44,6,1,2,3,11718.0,2:42,3,0,3,8307.0,1:55,6500000
8474618,Marco,Scandella,1990-02-23,D,L,2018-19,63,6,7,13,0.21,-13,83,7.23,26,66567.0,17:36,0,0,0,0.0,53,75,16,41,-25,0,0,0,379.0,0:6,0,1,1,7534.0,1:59,4000000
8474627,Jori,Lehtera,1987-12-23,C,L,2018-19,27,1,2,3,0.11,-7,17,5.88,33,14760.0,9:6,79,67,146,54.11,29,7,6,4,2,0,0,0,119.0,0:4,0,0,0,2450.0,1:30,4700000
8474628,Michael,Stone,1990-06-07,D,R,2018-19,14,0,5,5,0.36,0,12,0.0,10,13386.0,15:56,0,0,0,0.0,27,16,6,6,0,0,0,0,425.0,0:30,0,0,0,1582.0,1:53,3500000
8474641,Adam,Henrique,1990-02-06,C,L,2018-19,82,18,24,42,0.51,-5,122,14.75,24,80940.0,16:27,571,512,1083,52.72,78,71,39,26,13,8,5,13,11361.0,2:18,0,1,1,5406.0,1:5,4000000
8474659,Matt,Donovan,1990-05-09,D,L,2018-19,2,0,1,1,0.5,0,1,0.0,2,887.0,7:23,0,0,0,0.0,0,3,0,0,0,0,0,0,0.0,0:0,0,0,0,0.0,0:0,675000
8474668,Dale,Weise,1988-08-05,RW,R,2018-19,51,5,6,11,0.22,-8,58,8.62,19,36037.0,11:46,6,10,16,37.5,88,21,9,10,-1,0,0,0,314.0,0:6,1,0,1,3966.0,1:17,2350000
8474673,TJ,Brodie,1990-06-07,D,L,2018-19,79,9,25,34,0.43,29,102,8.82,24,101773.0,21:28,0,1,1,0.0,21,86,68,100,-32,1,3,4,4628.0,0:58,1,0,1,9201.0,1:56,4650400
8474679,Gustav,Nyquist,1989-09-01,RW,L,2018-19,81,22,38,60,0.74,1,204,10.78,12,85146.0,17:31,11,11,22,50.0,36,23,42,74,-32,2,10,12,10476.0,2:9,0,0,0,118.0,0:1,4750000
8474683,Derek,Grant,1990-04-20,C,L,2018-19,56,4,10,14,0.25,-6,74,5.41,14,39267.0,11:41,271,244,515,52.62,92,29,19,14,5,0,0,0,310.0,0:5,0,1,1,5504.0,1:38,650000
8474685,Matt,Calvert,1989-12-24,LW,L,2018-19,82,11,15,26,0.32,-10,141,7.8,58,69824.0,14:11,41,53,94,43.62,115,51,43,20,23,1,1,2,1057.0,0:12,0,2,2,11068.0,2:14,2850000
8474688,Greg,Pateryn,1990-06-20,D,R,2018-19,80,1,6,7,0.09,-11,100,1.0,41,82179.0,17:7,0,1,1,0.0,144,118,14,17,-3,0,0,0,185.0,0:2,0,0,0,8459.0,1:45,2250000
8474697,Mark,Borowiecki,1989-07-12,D,L,2018-19,53,1,4,5,0.09,-12,59,1.69,89,49513.0,15:34,0,0,0,0.0,212,93,14,26,-12,0,0,0,57.0,0:1,0,0,0,4683.0,1:28,1200000
8474709,Matt,Martin,1989-05-08,LW,L,2018-19,67,6,8,14,0.21,5,62,9.68,53,45962.0,11:26,6,9,15,40.0,275,42,13,19,-6,0,0,0,170.0,0:2,0,0,0,889.0,0:13,2500000
8474715,Cam,Atkinson,1989-06-05,RW,R,2018-19,80,41,28,69,0.86,3,295,13.9,20,93014.0,19:22,24,52,76,31.58,27,25,47,45,2,8,6,14,12892.0,2:41,4,0,4,6425.0,1:20,5875000
8474716,Jared,Spurgeon,1989-11-29,D,R,2018-19,82,14,29,43,0.52,-1,152,9.21,20,118792.0,24:8,1,0,1,100.0,91,145,30,23,7,4,7,11,11959.0,2:25,0,1,1,11543.0,2:20,5187500
8474717,Mark,Barberio,1990-03-23,D,L,2018-19,12,1,0,1,0.08,-6,11,9.09,4,10962.0,15:13,0,0,0,0.0,13,14,3,8,-5,0,0,0,0.0,0:0,0,0,0,1810.0,2:30,1450000
8474722,Luke,Witkowski,1990-04-14,RW,R,2018-19,34,0,2,2,0.06,-5,14,0.0,23,19579.0,9:35,0,0,0,0.0,67,27,3,20,-17,0,0,0,44.0,0:1,0,0,0,1269.0,0:37,750000
8474736,Zac,Rinaldo,1990-06-15,C,L,2018-19,23,1,2,3,0.13,1,11,9.09,20,9832.0,7:7,1,4,5,20.0,47,8,4,2,2,0,0,0,7.0,0:0,0,0,0,0.0,0:0,650000
8474749,Matt,Bartkowski,1988-06-04,D,L,2018-19,2,1,0,1,0.5,2,2,50.0,0,1284.0,10:42,0,0,0,0.0,1,1,0,0,0,0,0,0,0.0,0:0,0,0,0,0.0,0:0,650000
8474774,Dalton,Prout,1990-03-13,D,R,2018-19,20,1,1,2,0.1,1,14,7.14,8,15739.0,13:6,0,0,0,0.0,36,20,4,10,-6,0,0,0,26.0,0:1,0,0,0,1438.0,1:11,800000
8474818,Jordie,Benn,1987-07-26,D,L,2018-19,81,5,17,22,0.27,15,93,5.38,39,88422.0,18:11,0,0,0,0.0,124,128,19,71,-52,0,0,0,114.0,0:1,0,0,0,13508.0,2:46,1100000
8474849,Antoine,Roussel,1989-11-21,LW,L,2018-19,65,9,22,31,0.48,5,84,10.71,118,53660.0,13:45,17,17,34,50.0,87,50,20,20,0,0,0,0,222.0,0:3,0,0,0,3404.0,0:52,3000000
8474870,Tyler,Johnson,1990-07-29,C,R,2018-19,80,29,18,47,0.59,15,163,17.79,28,76552.0,15:56,230,243,473,48.63,50,32,13,32,-19,1,7,8,7651.0,1:35,1,0,1,2255.0,0:28,5000000
8474873,Brian,Lashoff,1990-07-16,D,L,2018-19,4,0,1,1,0.25,-1,2,0.0,2,3278.0,13:39,0,0,0,0.0,3,4,0,0,0,0,0,0,0.0,0:0,0,0,0,297.0,1:14,650000
8474884,Mike,Hoffman,1989-11-24,LW,L,2018-19,82,36,34,70,0.85,-24,253,14.23,30,87762.0,17:50,13,25,38,34.21,42,26,48,98,-50,17,18,35,16922.0,3:26,0,0,0,72.0,0:0,5187500
8475098,Tyler,Bozak,1986-03-19,C,R,2018-19,72,13,25,38,0.53,-3,141,9.22,20,70627.0,16:20,451,379,830,54.34,52,33,30,19,11,2,6,8,10346.0,2:23,0,0,0,5483.0,1:16,5000000
8475149,Marcus,Johansson,1990-10-06,LW,L,2018-19,58,13,17,30,0.52,-16,115,11.3,8,55414.0,15:55,16,34,50,32.0,28,24,27,38,-11,2,7,9,8645.0,2:29,0,0,0,112.0,0:1,4583333
8475151,Kyle,Palmieri,1991-02-01,RW,R,2018-19,74,27,23,50,0.68,-9,224,12.05,42,80609.0,18:9,24,62,86,27.91,98,35,36,37,-1,11,7,18,14639.0,3:17,0,0,0,1306.0,0:17,4650000
8475158,Ryan,O'Reilly,1991-02-07,C,L,2018-19,82,28,49,77,0.94,22,234,11.97,12,102133.0,20:45,1086,824,1910,56.86,31,36,94,33,61,6,16,22,14048.0,2:51,1,2,3,9817.0,1:59,7500000
8475160,Kyle,Clifford,1991-01-13,LW,L,2018-19,72,11,10,21,0.29,4,115,9.57,96,45304.0,10:29,3,5,8,37.5,115,24,11,16,-5,1,0,1,931.0,0:12,0,0,0,55.0,0:0,1600000
8475163,Alex,Chiasson,1990-10-01,RW,R,2018-19,73,22,16,38,0.52,-1,123,17.89,32,74330.0,16:58,7,15,22,31.82,85,31,28,27,1,8,7,15,11476.0,2:37,1,1,2,2689.0,0:36,650000
8475164,Jakob,Silfverberg,1990-10-13,RW,R,2018-19,73,24,19,43,0.59,-9,163,14.72,28,74895.0,17:5,19,32,51,37.25,38,43,27,27,0,3,8,11,9203.0,2:6,2,1,3,7512.0,1:42,3750000
8475166,John,Tavares,1990-09-20,C,L,2018-19,82,47,41,88,1.07,19,286,16.43,34,93919.0,19:5,832,696,1528,54.45,59,53,53,72,-19,10,9,19,12764.0,2:35,0,0,0,973.0,0:11,11000000
8475167,Victor,Hedman,1990-12-18,D,L,2018-19,70,12,42,54,0.77,24,182,6.59,44,95636.0,22:46,0,1,1,0.0,59,97,32,50,-18,2,23,25,13936.0,3:19,0,1,1,8905.0,2:7,7875000
8475168,Matt,Duchene,1991-01-16,C,L,2018-19,73,31,39,70,0.96,-3,172,18.02,8,82494.0,18:50,676,546,1222,55.32,28,40,50,68,-18,6,8,14,11248.0,2:34,0,0,0,742.0,0:10,6000000
8475169,Evander,Kane,1991-08-02,LW,L,2018-19,75,30,26,56,0.75,-4,268,11.19,153,82847.0,18:24,92,120,212,43.4,173,25,48,38,10,5,6,11,8631.0,1:55,1,1,2,4438.0,0:59,7000000
8475170,Brayden,Schenn,1991-08-22,C,L,2018-19,72,17,37,54,0.75,3,159,10.69,40,80308.0,18:35,323,357,680,47.5,111,31,51,42,9,4,8,12,10349.0,2:23,0,0,0,2599.0,0:36,5125000
8475171,Oliver,Ekman-Larsson,1991-07-17,D,L,2018-19,81,14,30,44,0.54,-16,176,7.95,52,114887.0,23:38,0,0,0,0.0,162,52,32,65,-33,5,14,19,17284.0,3:33,1,2,3,6130.0,1:15,5500000
8475172,Nazem,Kadri,1990-10-06,C,L,2018-19,73,16,28,44,0.6,-2,184,8.7,43,70911.0,16:11,403,327,730,55.21,85,13,42,47,-5,4,9,13,11329.0,2:35,0,0,0,71.0,0:0,4500000
8475175,Magnus,Paajarvi,1991-04-12,LW,L,2018-19,80,11,8,19,0.24,-14,119,9.24,6,64650.0,13:28,7,9,16,43.75,65,67,18,16,2,0,0,0,443.0,0:5,1,1,2,9402.0,1:57,900000
8475176,Ryan,Ellis,1991-01-03,D,R,2018-19,82,7,34,41,0.5,21,149,4.7,20,118150.0,24:0,0,0,0,0.0,71,154,54,61,-7,1,4,5,10299.0,2:5,1,0,1,13168.0,2:40,2500000
8475177,Calvin,de Haan,1991-05-09,D,L,2018-19,74,1,13,14,0.19,1,102,0.98,20,82190.0,18:30,0,1,1,0.0,187,106,59,55,4,0,0,0,426.0,0:5,0,0,0,8820.0,1:59,4550000
8475178,Zack,Kassian,1991-01-24,RW,R,2018-19,79,15,11,26,0.33,-6,111,13.51,102,70161.0,14:48,0,6,6,0.0,191,15,35,48,-13,0,0,0,433.0,0:5,1,0,1,5895.0,1:14,1950000
8475179,Dmitry,Kulikov,1990-10-29,D,L,2018-19,57,0,6,6,0.11,4,40,0.0,47,53569.0,15:39,0,0,0,0.0,88,71,19,37,-18,0,0,0,314.0,0:5,0,0,0,3516.0,1:1,4333333
8475181,Nick,Leddy,1991-03-20,D,L,2018-19,82,4,22,26,0.32,0,116,3.45,18,106026.0,21:33,0,0,0,0.0,77,89,18,63,-45,0,10,10,13737.0,2:47,0,0,0,1943.0,0:23,5500000
8475184,Chris,Kreider,1991-04-30,LW,L,2018-19,79,28,24,52,0.66,4,201,13.93,57,82504.0,17:24,27,45,72,37.5,159,49,31,52,-21,7,5,12,12357.0,2:36,0,0,0,294.0,0:3,4625000
8475186,John,Moore,1990-11-19,D,L,2018-19,61,4,9,13,0.21,0,97,4.12,26,68708.0,18:46,0,0,0,0.0,77,76,10,24,-14,2,1,3,1496.0,0:24,0,0,0,7904.0,2:9,2750000
8475188,Brayden,McNabb,1991-01-21,D,L,2018-19,81,4,12,16,0.2,11,84,4.76,52,94666.0,19:28,0,0,0,0.0,200,139,37,38,-1,0,0,0,247.0,0:3,0,1,1,13681.0,2:48,2500000
8475191,Reilly,Smith,1991-04-01,RW,L,2018-19,74,19,34,53,0.72,13,178,10.67,14,81126.0,18:16,5,2,7,71.43,39,33,67,54,13,4,10,14,10903.0,2:27,1,3,4,6845.0,1:32,5000000
8475193,Tomas,Tatar,1990-12-01,LW,L,2018-19,80,25,33,58,0.72,21,195,12.82,34,78765.0,16:24,10,29,39,25.64,77,30,52,44,8,4,4,8,10850.0,2:15,0,0,0,152.0,0:1,5300000
8475197,Tyson,Barrie,1991-07-26,D,R,2018-19,78,14,45,59,0.76,-3,218,6.42,36,101912.0,21:46,0,0,0,0.0,48,93,28,41,-13,2,23,25,18944.0,4:2,0,0,0,303.0,0:3,5500000
8475200,Dmitry,Orlov,1991-07-23,D,L,2018-19,82,3,26,29,0.35,3,101,2.97,33,106451.0,21:38,0,0,0,0.0,137,103,53,80,-27,0,1,1,4002.0,0:48,0,0,0,6751.0,1:22,5100000
8475204,Brandon,Pirri,1991-04-10,RW,L,2018-19,31,12,6,18,0.58,7,82,14.63,6,26872.0,14:26,15,19,34,44.12,29,13,14,11,3,3,1,4,3722.0,2:0,0,0,0,6.0,0:0,650000
8475206,Stefan,Elliott,1991-01-30,D,R,2018-19,3,0,1,1,0.33,1,3,0.0,0,1617.0,8:59,0,0,0,0.0,2,1,0,1,-1,0,0,0,123.0,0:41,0,0,0,0.0,0:0,650000
8475208,Brian,Dumoulin,1991-09-06,D,L,2018-19,76,3,20,23,0.3,31,99,3.03,20,95875.0,21:1,0,0,0,0.0,141,129,39,51,-12,0,0,0,598.0,0:7,0,4,4,10768.0,2:21,4100000
8475209,Richard,Panik,1991-02-07,RW,L,2018-19,75,14,19,33,0.44,-3,140,10.0,44,74738.0,16:36,5,13,18,27.78,137,52,46,39,7,0,2,2,8923.0,1:58,1,0,1,5393.0,1:11,2800000
8475218,Mattias,Ekholm,1990-05-24,D,L,2018-19,80,8,36,44,0.55,27,146,5.48,47,112147.0,23:21,0,0,0,0.0,68,107,32,69,-37,2,5,7,6594.0,1:22,0,2,2,10698.0,2:13,3750000
8475220,Marcus,Foligno,1991-08-10,LW,L,2018-19,82,7,12,19,0.23,-1,91,7.69,55,58893.0,11:58,13,15,28,46.43,206,43,31,13,18,0,1,1,221.0,0:2,0,1,1,8859.0,1:48,2875000
8475222,Sami,Vatanen,1991-06-03,D,R,2018-19,50,4,13,17,0.34,-17,107,3.74,22,65185.0,21:43,0,0,0,0.0,68,77,16,36,-20,3,2,5,6756.0,2:15,0,0,0,5727.0,1:54,4875000
8475225,Craig,Smith,1989-09-05,RW,R,2018-19,76,21,17,38,0.5,11,205,10.24,20,68974.0,15:7,26,28,54,48.15,77,33,43,39,4,4,4,8,11450.0,2:30,0,0,0,44.0,0:0,4250000
8475227,Chris,Wideman,1990-01-07,D,R,2018-19,25,2,5,7,0.28,-12,27,7.41,18,19586.0,13:3,0,0,0,0.0,35,26,3,9,-6,0,1,1,3218.0,2:8,0,0,0,23.0,0:0,1000000
8475231,Casey,Cizikas,1991-02-27,C,L,2018-19,73,20,13,33,0.45,22,111,18.02,36,61424.0,14:1,497,516,1013,49.06,129,68,44,34,10,0,0,0,299.0,0:4,2,1,3,8525.0,1:56,3350000
8475233,David,Savard,1990-10-22,D,R,2018-19,82,8,16,24,0.29,19,124,6.45,36,97139.0,19:44,0,0,0,0.0,122,123,17,38,-21,0,0,0,397.0,0:4,0,0,0,8411.0,1:42,4250000
8475235,Nicolas,Deslauriers,1991-02-22,LW,L,2018-19,48,2,3,5,0.1,-12,48,4.17,22,28909.0,10:2,1,0,1,100.0,135,22,11,9,2,0,0,0,91.0,0:1,1,0,1,1116.0,0:23,950000
8475236,Cody,Eakin,1991-05-24,C,L,2018-19,78,22,19,41,0.53,19,120,18.33,16,71975.0,15:22,479,461,940,50.96,88,35,51,34,17,1,3,4,5234.0,1:7,3,0,3,6200.0,1:19,3850000
8475246,Kevin,Connauton,1990-02-23,D,L,2018-19,50,1,7,8,0.16,-2,75,1.33,22,55055.0,18:21,0,0,0,0.0,108,75,5,24,-19,0,0,0,335.0,0:6,0,2,2,8273.0,2:45,1375000
8475253,Garrett,Wilson,1991-03-16,LW,L,2018-19,50,2,6,8,0.16,2,54,3.7,18,22845.0,7:36,3,4,7,42.86,114,16,5,5,0,0,0,0,44.0,0:0,0,0,0,1754.0,0:35,650000
8475260,Corban,Knight,1990-09-10,C,R,2018-19,23,1,3,4,0.17,-5,15,6.67,0,13356.0,9:40,63,58,121,52.07,9,13,6,2,4,0,0,0,22.0,0:0,0,0,0,1226.0,0:53,650000
8475263,Wade,Megan,1990-07-22,C,L,2018-19,11,0,1,1,0.09,-4,16,0.0,2,5199.0,7:52,28,23,51,54.9,4,4,2,3,-1,0,0,0,0.0,0:0,0,0,0,105.0,0:9,650000
8475268,Gabriel,Bourque,1990-09-23,LW,L,2018-19,55,2,6,8,0.15,3,34,5.88,10,32134.0,9:44,7,13,20,35.0,100,48,11,8,3,0,0,0,84.0,0:1,0,1,1,8253.0,2:30,950000
8475279,Ben,Chiarot,1991-05-09,D,L,2018-19,78,5,15,20,0.26,6,111,4.5,62,87124.0,18:36,0,0,0,0.0,171,139,20,65,-45,0,0,0,127.0,0:1,0,1,1,8142.0,1:44,1400000
8475287,Erik,Haula,1991-03-23,LW,L,2018-19,15,2,5,7,0.47,1,26,7.69,10,14929.0,16:35,78,74,152,51.32,11,6,12,6,6,0,1,1,2124.0,2:21,0,0,0,135.0,0:9,2750000
8475314,Anders,Lee,1990-07-03,LW,L,2018-19,82,28,23,51,0.62,20,204,13.73,58,84072.0,17:5,75,80,155,48.39,103,51,22,29,-7,10,6,16,14022.0,2:51,0,0,0,118.0,0:1,3750000
8475321,Phil,Varone,1990-12-04,C,L,2018-19,47,3,4,7,0.15,-2,34,8.82,8,22315.0,7:54,81,82,163,49.69,23,19,5,11,-6,0,0,0,101.0,0:2,0,0,0,126.0,0:2,650000
8475323,Marcus,Kruger,1990-05-27,C,L,2018-19,74,4,8,12,0.16,-2,74,5.41,30,46243.0,10:24,188,203,391,48.08,51,34,17,11,6,0,0,0,120.0,0:1,0,1,1,7966.0,1:47,3083333
8475324,Nick,Jensen,1990-09-21,D,R,2018-19,80,2,18,20,0.25,4,94,2.13,21,95290.0,19:51,0,0,0,0.0,82,105,27,61,-34,0,0,0,312.0,0:3,0,1,1,11690.0,2:26,812500
8475325,Jordan,Nolan,1989-06-23,C,L,2018-19,14,0,2,2,0.14,2,17,0.0,14,6668.0,7:56,0,1,1,0.0,22,4,1,0,1,0,0,0,19.0,0:1,0,0,0,0.0,0:0,650000
8475343,Nic,Dowd,1990-05-27,C,R,2018-19,64,8,14,22,0.34,10,47,17.02,20,39524.0,10:17,245,227,472,51.91,97,37,29,22,7,0,0,0,46.0,0:0,0,1,1,6345.0,1:39,650000
8475413,Justin,Dowling,1990-10-01,C,L,2018-19,11,0,1,1,0.09,-4,9,0.0,0,8361.0,12:40,31,28,59,52.54,11,7,6,3,3,0,0,0,654.0,0:59,0,0,0,0.0,0:0,650000
8475423,Darren,Archibald,1990-02-09,RW,L,2018-19,12,1,1,2,0.17,-3,10,10.0,12,5310.0,7:22,0,1,1,0.0,10,4,1,3,-2,0,0,0,0.0,0:0,0,0,0,3.0,0:0,650000
8475430,Brandon,Manning,1990-06-04,D,L,2018-19,39,2,2,4,0.1,-15,33,6.06,25,34728.0,14:50,0,0,0,0.0,63,40,7,14,-7,0,0,0,115.0,0:2,0,0,0,4163.0,1:46,2250000
8475455,Brenden,Dillon,1990-11-13,D,L,2018-19,82,1,21,22,0.27,19,71,1.41,61,87296.0,17:44,0,0,0,0.0,202,78,16,38,-22,0,0,0,253.0,0:3,1,0,1,5402.0,1:5,3270000
8475461,Andrew,Agozzino,1991-01-03,LW,L,2018-19,11,1,1,2,0.18,2,11,9.09,0,5155.0,7:48,16,22,38,42.11,14,3,1,4,-3,0,0,0,56.0,0:5,0,0,0,298.0,0:27,650000
8475462,Radko,Gudas,1990-06-05,D,R,2018-19,77,4,16,20,0.26,6,136,2.94,63,82584.0,17:52,0,0,0,0.0,255,133,23,59,-36,0,0,0,83.0,0:1,0,0,0,12126.0,2:37,3350000
8475613,Nate,Prosser,1986-05-07,D,R,2018-19,15,0,0,0,0.0,1,10,0.0,2,9200.0,10:13,0,0,0,0.0,17,13,1,1,0,0,0,0,33.0,0:2,0,0,0,379.0,0:25,650000
8475625,Matt,Irwin,1987-11-29,D,L,2018-19,44,1,6,7,0.16,5,50,2.0,38,29820.0,11:17,0,0,0,0.0,80,37,8,13,-5,0,0,0,1.0,0:0,0,0,0,578.0,0:13,675000
8475690,Christopher,Tanev,1989-12-20,D,R,2018-19,55,2,10,12,0.22,3,51,3.92,18,66553.0,20:10,0,0,0,0.0,29,122,20,32,-12,0,0,0,407.0,0:7,0,0,0,10782.0,3:16,4450000
8475692,Mats,Zuccarello,1987-09-01,RW,L,2018-19,48,12,28,40,0.83,-8,104,11.54,24,57172.0,19:51,10,20,30,33.33,57,43,38,29,9,3,12,15,8630.0,2:59,0,0,0,4363.0,1:30,4500000
8475714,Calle,Jarnkrok,1991-09-25,C,R,2018-19,79,10,16,26,0.33,13,106,9.43,12,73140.0,15:25,166,165,331,50.15,56,22,25,21,4,1,1,2,4385.0,0:55,1,0,1,8320.0,1:45,2000000
8475715,Oscar,Lindberg,1991-10-29,C,L,2018-19,55,9,11,20,0.36,4,91,9.89,28,41165.0,12:28,101,122,223,45.29,104,27,22,25,-3,0,1,1,1380.0,0:25,0,0,0,513.0,0:9,1700000
8475716,Martin,Marincin,1992-02-18,D,L,2018-19,24,1,4,5,0.21,-4,34,2.94,12,21888.0,15:12,0,1,1,0.0,21,21,11,25,-14,0,0,0,43.0,0:1,0,0,0,2061.0,1:25,800000
8475718,Justin,Holl,1992-01-30,D,R,2018-19,11,0,1,1,0.09,-5,6,0.0,2,8238.0,12:28,0,0,0,0.0,9,5,2,6,-4,0,0,0,28.0,0:2,0,0,0,0.0,0:0,675000
8475722,Jason,Zucker,1992-01-16,LW,L,2018-19,81,21,21,42,0.52,-9,214,9.81,28,83007.0,17:4,2,11,13,15.38,87,38,47,31,16,7,7,14,10886.0,2:14,0,0,0,890.0,0:10,5500000
8475726,Tyler,Toffoli,1992-04-24,C,R,2018-19,82,13,21,34,0.41,-16,226,5.75,23,84685.0,17:12,24,27,51,47.06,39,23,44,27,17,3,2,5,10133.0,2:3,0,0,0,6333.0,1:17,4600000
8475727,Ryan,Spooner,1992-01-30,C,L,2018-19,52,3,6,9,0.17,-12,67,4.48,2,35651.0,11:25,59,54,113,52.21,39,7,10,18,-8,0,1,1,3474.0,1:6,0,0,0,3.0,0:0,4000000
8475728,Johan,Larsson,1992-07-25,C,L,2018-19,73,6,8,14,0.19,-8,79,7.59,37,62602.0,14:17,503,490,993,50.65,112,44,29,22,7,0,0,0,354.0,0:4,1,0,1,10308.0,2:21,1475000
8475729,Mark,Alt,1991-10-18,D,R,2018-19,2,0,0,0,0.0,0,2,0.0,0,1189.0,9:54,0,0,0,0.0,0,2,0,0,0,0,0,0,0.0,0:0,0,0,0,49.0,0:24,725000
8475735,Greg,McKegg,1992-06-17,C,L,2018-19,41,6,5,11,0.27,-2,27,22.22,8,26227.0,10:39,146,140,286,51.05,30,18,14,10,4,0,0,0,272.0,0:6,0,0,0,89.0,0:2,715000
8475736,Connor,Brickley,1992-02-25,C,L,2018-19,14,1,3,4,0.29,3,18,5.56,9,7541.0,8:58,0,7,7,0.0,35,6,3,5,-2,0,0,0,0.0,0:0,0,0,0,0.0,0:0,650000
8475738,Jordan,Weal,1992-04-15,C,R,2018-19,63,8,13,21,0.33,-8,75,10.67,18,50887.0,13:27,333,266,599,55.59,28,26,20,19,1,2,4,6,4030.0,1:3,0,0,0,22.0,0:0,1750000
8475744,Evgeny,Kuznetsov,1992-05-19,C,L,2018-19,76,21,51,72,0.95,7,193,10.88,50,85686.0,18:47,396,627,1023,38.71,46,20,46,62,-16,8,15,23,16710.0,3:39,0,0,0,1002.0,0:13,7800000
8475745,Charlie,Coyle,1992-03-02,C,R,2018-19,81,12,22,34,0.42,-1,155,7.74,20,81536.0,16:46,322,380,702,45.87,77,56,42,43,-1,1,3,4,8437.0,1:44,1,0,1,5042.0,1:2,3200000
8475747,Patrik,Nemeth,1992-02-08,D,L,2018-19,74,1,9,10,0.14,5,57,1.75,53,73202.0,16:29,0,0,0,0.0,137,131,4,19,-15,0,0,0,113.0,0:1,0,1,1,14267.0,3:12,2500000
8475750,Jon,Merrill,1992-02-03,D,L,2018-19,57,3,12,15,0.26,16,72,4.17,53,61144.0,17:52,0,0,0,0.0,71,72,16,26,-10,0,0,0,625.0,0:10,1,0,1,4181.0,1:13,1375000
8475752,Tyler,Pitlick,1991-11-01,C,R,2018-19,47,8,4,12,0.26,-2,75,10.67,6,37738.0,13:22,5,7,12,41.67,93,27,11,16,-5,1,0,1,1931.0,0:41,0,0,0,2295.0,0:48,1000000
8475753,Justin,Faulk,1992-03-20,D,R,2018-19,82,11,24,35,0.43,9,217,5.07,47,110325.0,22:25,0,0,0,0.0,156,121,47,66,-19,6,4,10,14471.0,2:56,0,0,0,8483.0,1:43,4833333
8475754,Brock,Nelson,1991-10-15,C,L,2018-19,82,25,28,53,0.65,20,181,13.81,28,88423.0,17:58,594,652,1246,47.67,51,55,54,47,7,2,6,8,11823.0,2:24,1,0,1,3945.0,0:48,4250000
8475755,Alex,Petrovic,1992-03-03,D,R,2018-19,35,0,2,2,0.06,-15,47,0.0,26,34705.0,16:31,0,0,0,0.0,116,53,9,28,-19,0,0,0,336.0,0:9,0,0,0,2708.0,1:17,1950000
8475758,Devante,Smith-Pelly,1992-06-14,RW,R,2018-19,54,4,4,8,0.15,-6,60,6.67,15,35167.0,10:51,16,25,41,39.02,78,36,7,9,-2,0,0,0,122.0,0:2,0,0,0,5388.0,1:39,1000000
8475760,Nick,Bjugstad,1992-07-17,C,R,2018-19,64,14,12,26,0.41,6,154,9.09,30,58057.0,15:7,262,268,530,49.43,126,27,37,39,-2,2,4,6,5749.0,1:29,0,0,0,99.0,0:1,4100000
8475762,Derek,Forbort,1992-03-04,D,L,2018-19,81,2,12,14,0.17,-13,75,2.67,52,100806.0,20:44,0,1,1,0.0,105,139,15,78,-63,0,0,0,259.0,0:3,0,0,0,11109.0,2:17,2525000
8475763,Kevin,Hayes,1992-05-08,C,L,2018-19,71,19,36,55,0.77,-2,156,12.18,12,77873.0,18:16,483,498,981,49.24,58,15,61,60,1,3,8,11,9065.0,2:7,2,1,3,7593.0,1:46,5175000
8475764,Cam,Fowler,1991-12-05,D,L,2018-19,59,5,18,23,0.39,-14,88,5.68,20,82722.0,23:22,0,0,0,0.0,32,91,24,43,-19,1,5,6,8884.0,2:30,0,1,1,5332.0,1:30,6500000
8475765,Vladimir,Tarasenko,1991-12-13,RW,L,2018-19,76,33,35,68,0.89,8,275,12.0,22,83902.0,18:23,4,2,6,66.67,88,40,34,31,3,12,10,22,13290.0,2:54,0,0,0,282.0,0:3,7500000
8475766,Austin,Watson,1992-01-13,LW,R,2018-19,37,7,9,16,0.43,11,64,10.94,39,32175.0,14:29,7,9,16,43.75,109,28,12,13,-1,1,0,1,155.0,0:4,0,0,0,3810.0,1:42,1100000
8475768,Jaden,Schwartz,1992-06-25,LW,L,2018-19,69,11,25,36,0.52,-6,183,6.01,16,75050.0,18:7,18,19,37,48.65,61,27,47,28,19,2,3,5,9363.0,2:15,0,0,0,2385.0,0:34,5350000
8475772,Riley,Sheahan,1991-12-07,C,L,2018-19,82,9,10,19,0.23,-9,110,8.18,17,66231.0,13:27,360,328,688,52.33,72,44,49,23,26,0,0,0,250.0,0:3,1,1,2,9797.0,1:59,2100000
8475780,Chris,Wagner,1991-05-27,RW,R,2018-19,76,12,7,19,0.25,3,135,8.89,51,61344.0,13:27,54,66,120,45.0,247,38,21,21,0,0,0,0,224.0,0:2,0,0,0,6604.0,1:26,1250000
8475784,Jeff,Skinner,1992-05-16,LW,L,2018-19,82,40,23,63,0.77,0,268,14.93,36,91109.0,18:31,157,144,301,52.16,31,24,56,39,17,8,8,16,15156.0,3:4,0,0,0,145.0,0:1,5725000
8475786,Zach,Hyman,1992-06-09,C,R,2018-19,71,21,20,41,0.58,16,144,14.58,65,73594.0,17:16,113,124,237,47.68,102,39,30,28,2,0,0,0,1072.0,0:15,1,0,1,9658.0,2:16,2250000
8475790,Erik,Gudbranson,1992-01-07,D,R,2018-19,76,2,8,10,0.13,-20,94,2.13,87,83132.0,18:13,0,0,0,0.0,184,84,10,31,-21,0,0,0,203.0,0:2,0,1,1,9346.0,2:2,4000000
8475791,Taylor,Hall,1991-11-14,LW,L,2018-19,33,11,26,37,1.12,-6,113,9.73,16,38980.0,19:41,26,32,58,44.83,22,29,31,39,-8,1,11,12,6731.0,3:23,0,0,0,84.0,0:2,6000000
8475792,Brett,Connolly,1992-05-02,RW,R,2018-19,81,22,24,46,0.57,13,139,15.83,24,64784.0,13:19,9,22,31,29.03,53,25,33,25,8,1,1,2,4559.0,0:56,0,0,0,83.0,0:1,1500000
8475793,Ryan,Johansen,1992-07-31,C,R,2018-19,80,14,50,64,0.8,7,136,10.29,42,93865.0,19:33,782,679,1461,53.52,95,23,43,66,-23,0,16,16,14603.0,3:2,1,1,2,6846.0,1:25,8000000
8475794,Tyler,Seguin,1992-01-31,C,R,2018-19,82,33,47,80,0.98,17,334,9.88,18,102082.0,20:44,676,579,1255,53.86,74,47,47,55,-8,9,18,27,14701.0,2:59,0,0,0,4271.0,0:52,5750000
8475795,Dylan,McIlrath,1992-04-20,D,R,2018-19,7,0,0,0,0.0,2,6,0.0,4,6379.0,15:11,0,0,0,0.0,19,7,2,2,0,0,0,0,0.0,0:0,0,0,0,788.0,1:52,650000
8475796,Mark,Pysyk,1992-01-11,D,R,2018-19,70,1,10,11,0.16,-1,64,1.56,26,76730.0,18:16,0,0,0,0.0,133,89,35,72,-37,0,0,0,210.0,0:3,0,1,1,7343.0,1:44,2733333
8475798,Mikael,Granlund,1992-02-26,RW,L,2018-19,79,16,38,54,0.68,-8,189,8.47,24,86948.0,18:20,129,159,288,44.79,46,40,47,34,13,2,18,20,12148.0,2:33,2,0,2,2941.0,0:37,5750000
8475799,Nino,Niederreiter,1992-09-08,RW,L,2018-19,82,23,30,53,0.65,-4,184,12.5,30,79828.0,16:13,37,30,67,55.22,94,20,51,39,12,6,9,15,11092.0,2:15,0,0,0,100.0,0:1,5250000
8475807,Joakim,Nordstrom,1992-02-25,LW,L,2018-19,70,7,5,12,0.17,0,103,6.8,13,56617.0,13:28,48,77,125,38.4,86,52,26,19,7,0,0,0,439.0,0:6,0,0,0,6909.0,1:38,1000000
8475808,Michael,Chaput,1992-04-09,C,L,2018-19,32,0,5,5,0.16,-4,31,0.0,14,21548.0,11:13,124,120,244,50.82,53,17,7,8,-1,0,0,0,36.0,0:1,0,0,0,3794.0,1:58,675000
8475810,Bryan,Rust,1992-05-11,RW,R,2018-19,72,18,17,35,0.49,10,141,12.77,24,68707.0,15:54,8,16,24,33.33,119,59,30,27,3,0,0,0,533.0,0:7,2,2,4,8521.0,1:58,3500000
8475820,Joonas,Donskoi,1992-04-13,RW,R,2018-19,80,14,23,37,0.46,10,115,12.17,10,64431.0,13:25,1,9,10,10.0,36,36,24,38,-14,1,2,3,2844.0,0:35,0,0,0,224.0,0:2,1900000
8475832,Tom,Kuhnhackl,1992-01-21,RW,L,2018-19,36,4,5,9,0.25,1,30,13.33,10,27393.0,12:40,0,2,2,0.0,48,41,8,16,-8,0,0,0,173.0,0:4,0,1,1,2174.0,1:0,700000
8475834,Marcus,Sorensen,1992-04-07,LW,L,2018-19,80,17,13,30,0.38,10,100,17.0,23,62221.0,12:57,12,19,31,38.71,88,29,33,21,12,0,0,0,1456.0,0:18,1,1,2,5072.0,1:3,700000
8475841,Tim,Heed,1991-01-27,D,R,2018-19,37,2,11,13,0.35,9,41,4.88,10,31898.0,14:22,0,0,0,0.0,16,31,11,23,-12,1,2,3,3053.0,1:22,0,0,0,62.0,0:1,650000
8475842,Sam,Carrick,1992-02-04,C,R,2018-19,6,0,1,1,0.17,-1,5,0.0,2,3679.0,10:13,19,18,37,51.35,15,2,1,1,0,0,0,0,0.0,0:0,0,0,0,86.0,0:14,650000
8475844,Kenny,Agostino,1992-04-30,LW,L,2018-19,63,6,18,24,0.38,-3,79,7.59,34,48826.0,12:55,15,27,42,35.71,143,14,25,30,-5,0,5,5,4615.0,1:13,0,0,0,192.0,0:3,700000
8475848,Brendan,Gallagher,1992-05-06,RW,R,2018-19,82,33,19,52,0.63,10,302,10.93,49,80673.0,16:23,23,28,51,45.1,126,31,57,30,27,4,3,7,12091.0,2:27,0,0,0,150.0,0:1,3750000
8475855,Jesper,Fast,1991-12-02,RW,R,2018-19,66,8,12,20,0.3,-3,80,10.0,26,62253.0,15:43,7,13,20,35.0,120,47,25,24,1,0,0,0,476.0,0:7,0,0,0,6842.0,1:43,1850000
8475857,Kevin,Gravel,1992-03-06,D,L,2018-19,36,0,3,3,0.08,-2,44,0.0,4,31772.0,14:42,0,0,0,0.0,31,53,7,18,-11,0,0,0,25.0,0:0,0,0,0,3464.0,1:36,700000
8475868,Anthony,Bitetto,1990-07-15,D,L,2018-19,36,0,3,3,0.08,-7,30,0.0,12,25758.0,11:55,0,0,0,0.0,80,36,6,13,-7,0,0,0,77.0,0:2,0,0,0,249.0,0:6,650000
8475869,Brandon,Davidson,1991-08-21,D,L,2018-19,10,0,1,1,0.1,-4,7,0.0,15,8276.0,13:47,0,0,0,0.0,17,15,2,3,-1,0,0,0,31.0,0:3,0,0,0,806.0,1:20,650000
8475902,Zach,Trotman,1990-08-26,D,R,2018-19,13,0,1,1,0.08,4,16,0.0,4,11907.0,15:15,0,0,0,0.0,20,18,2,5,-3,0,1,1,960.0,1:13,0,0,0,476.0,0:36,650000
8475906,John,Klingberg,1992-08-14,D,R,2018-19,64,10,35,45,0.7,6,153,6.54,12,94197.0,24:31,0,0,0,0.0,42,77,26,79,-53,5,15,20,11443.0,2:58,0,0,0,2907.0,0:45,4250000
8475907,Micheal,Ferland,1992-04-20,LW,L,2018-19,71,17,23,40,0.56,13,156,10.9,58,60044.0,14:5,23,50,73,31.51,182,19,36,48,-12,6,7,13,8282.0,1:56,0,0,0,99.0,0:1,1750000
8475913,Mark,Stone,1992-05-13,RW,R,2018-19,77,33,40,73,0.95,17,199,16.58,27,91870.0,19:53,28,34,62,45.16,72,71,122,62,60,6,14,20,11730.0,2:32,1,0,1,5155.0,1:6,7350000
8475982,Erik,Burgdoerfer,1988-12-11,D,R,2018-19,4,0,0,0,0.0,-1,2,0.0,2,2561.0,10:40,0,0,0,0.0,16,0,0,2,-2,0,0,0,36.0,0:9,0,0,0,67.0,0:16,650000
8476043,Ben,Street,1987-02-13,C,L,2018-19,21,3,2,5,0.24,-4,19,15.79,2,15205.0,12:4,16,27,43,37.21,19,9,4,4,0,0,0,0,100.0,0:4,0,0,0,2505.0,1:59,750000
8476166,Taylor,Fedun,1988-06-04,D,R,2018-19,54,4,7,11,0.2,2,86,4.65,14,44898.0,13:51,0,0,0,0.0,19,58,14,37,-23,0,2,2,754.0,0:13,0,1,1,3121.0,0:57,650000
8476177,Matt,Read,1986-06-14,RW,R,2018-19,12,1,0,1,0.08,-2,13,7.69,2,8463.0,11:45,2,4,6,33.33,11,8,5,4,1,0,0,0,118.0,0:9,0,0,0,440.0,0:36,650000
8476191,Kevan,Miller,1987-11-15,D,R,2018-19,39,0,7,7,0.18,8,32,0.0,35,41524.0,17:44,0,0,0,0.0,73,79,18,20,-2,0,0,0,131.0,0:3,0,0,0,4151.0,1:46,2500000
8476195,Cory,Conacher,1989-12-14,C,L,2018-19,1,0,0,0,0.0,0,1,0.0,2,515.0,8:35,0,0,0,0.0,0,0,0,1,-1,0,0,0,9.0,0:9,0,0,0,0.0,0:0,650000
8476207,Brian,Gibbons,1988-02-26,LW,L,2018-19,64,8,11,19,0.3,-5,50,16.0,20,41925.0,10:55,13,25,38,34.21,40,29,26,23,3,0,0,0,131.0,0:2,0,0,0,2977.0,0:46,1000000
8476278,Colin,Blackwell,1993-03-28,C,R,2018-19,6,0,0,0,0.0,-1,5,0.0,2,3506.0,9:44,13,16,29,44.83,10,3,2,3,-1,0,0,0,33.0,0:5,0,0,0,0.0,0:0,675000
8476285,Matthew,Peca,1993-04-27,C,L,2018-19,39,3,7,10,0.26,-14,35,8.57,4,24627.0,10:31,80,89,169,47.34,33,21,12,12,0,0,0,0,99.0,0:2,0,1,1,2916.0,1:14,1300000
8476288,Ryan,Dzingel,1992-03-09,LW,L,2018-19,78,26,30,56,0.72,-9,159,16.35,29,78694.0,16:48,39,56,95,41.05,54,38,25,39,-14,5,6,11,8298.0,1:46,0,0,0,63.0,0:0,1800000
8476292,Ondrej,Palat,1991-03-28,LW,L,2018-19,64,8,26,34,0.53,4,100,8.0,20,57168.0,14:53,2,15,17,11.76,104,34,18,41,-23,2,6,8,7712.0,2:0,0,0,0,575.0,0:8,5300000
8476293,Scott,Wilson,1992-04-24,C,L,2018-19,15,0,3,3,0.2,-8,25,0.0,4,10305.0,11:27,1,2,3,33.33,29,2,4,4,0,0,0,0,4.0,0:0,0,0,0,1166.0,1:17,1050000
8476310,Lukas,Sedlak,1993-02-25,C,L,2018-19,47,4,2,6,0.13,-5,43,9.3,10,25377.0,8:59,43,44,87,49.43,69,20,6,8,-2,0,0,0,168.0,0:3,0,0,0,1633.0,0:34,825000
8476312,Josh,Manson,1991-10-07,D,R,2018-19,74,3,13,16,0.22,-8,96,3.12,62,99043.0,22:18,0,0,0,0.0,184,90,36,77,-41,0,0,0,576.0,0:7,0,1,1,14100.0,3:10,4100000
8476323,Max,McCormick,1992-05-01,LW,L,2018-19,14,1,0,1,0.07,-6,12,8.33,4,6300.0,7:30,0,1,1,0.0,21,6,1,3,-2,0,0,0,24.0,0:1,0,0,0,231.0,0:16,650000
8476326,Josh,Archibald,1992-10-06,RW,R,2018-19,68,12,10,22,0.32,1,92,13.04,15,55357.0,13:34,12,25,37,32.43,161,39,18,8,10,0,0,0,250.0,0:3,0,1,1,6531.0,1:36,675000
8476329,Travis,Boyd,1993-09-14,C,L,2018-19,53,5,15,20,0.38,6,35,14.29,6,31254.0,9:49,76,134,210,36.19,13,21,14,15,-1,0,2,2,839.0,0:15,0,0,0,1819.0,0:34,800000
8476331,Dylan,DeMelo,1993-05-01,D,R,2018-19,77,4,18,22,0.29,-1,109,3.67,32,89093.0,19:17,0,0,0,0.0,121,130,16,55,-39,0,3,3,2197.0,0:28,0,1,1,7677.0,1:39,900000
8476346,Johnny,Gaudreau,1993-08-13,LW,L,2018-19,82,36,63,99,1.21,18,245,14.69,24,98765.0,20:4,1,2,3,33.33,12,12,58,124,-66,6,21,27,16410.0,3:20,0,0,0,244.0,0:2,6750000
8476356,Tobias,Rieder,1993-01-10,C,L,2018-19,67,0,11,11,0.16,-8,92,0.0,8,50829.0,12:38,5,20,25,20.0,69,44,35,12,23,0,2,2,1441.0,0:21,0,0,0,5332.0,1:19,2000000
8476368,Fredrik,Claesson,1992-11-24,D,L,2018-19,37,2,4,6,0.16,3,44,4.55,9,38291.0,17:14,0,0,0,0.0,76,33,9,31,-22,0,0,0,11.0,0:0,0,1,1,3514.0,1:34,700000
8476370,Blake,Pietila,1993-02-20,LW,L,2018-19,19,0,1,1,0.05,-7,22,0.0,6,15121.0,13:15,36,46,82,43.9,36,8,9,2,7,0,0,0,733.0,0:38,0,0,0,960.0,0:50,667500
8476372,Nick,Seeler,1993-06-03,D,L,2018-19,71,2,5,7,0.1,-4,67,2.99,64,52538.0,12:19,0,0,0,0.0,78,116,5,18,-13,0,0,0,125.0,0:1,0,0,0,3312.0,0:46,725000
8476374,Sean,Kuraly,1993-01-20,C,L,2018-19,71,8,13,21,0.3,6,134,5.97,38,58678.0,13:46,286,245,531,53.86,129,35,34,32,2,0,0,0,254.0,0:3,0,0,0,5572.0,1:18,1275000
8476381,Andrew,Shaw,1991-07-20,RW,R,2018-19,63,19,28,47,0.75,17,135,14.07,71,60159.0,15:54,181,203,384,47.14,128,36,16,24,-8,3,3,6,7699.0,2:2,0,0,0,2789.0,0:44,3900000
8476389,Vincent,Trocheck,1993-07-11,C,R,2018-19,55,10,24,34,0.62,-9,158,6.33,54,64876.0,19:39,498,463,961,51.82,112,42,55,57,-2,3,10,13,8131.0,2:27,1,0,1,5410.0,1:38,4750000
8476392,Adam,Lowry,1993-03-29,C,L,2018-19,78,12,11,23,0.29,6,105,11.43,33,68507.0,14:38,643,473,1116,57.62,223,49,42,23,19,0,0,0,495.0,0:6,1,2,3,10587.0,2:15,2916667
8476393,Nick,Cousins,1993-07-20,C,L,2018-19,81,7,20,27,0.33,-8,144,4.86,35,65827.0,13:32,243,277,520,46.73,115,51,39,22,17,1,2,3,4220.0,0:52,0,0,0,61.0,0:0,1000000
8476396,Steven,Fogarty,1993-04-19,C,R,2018-19,10,0,0,0,0.0,-1,9,0.0,0,4656.0,7:45,8,19,27,29.63,6,3,4,3,1,0,0,0,0.0,0:0,0,0,0,0.0,0:0,708750
8476399,Blake,Coleman,1991-11-28,C,L,2018-19,78,22,14,36,0.46,-19,213,10.33,71,79617.0,17:0,109,153,262,41.6,225,44,50,36,14,3,0,3,3429.0,0:43,3,2,5,12588.0,2:41,1800000
8476407,Andy,Welinski,1993-04-27,D,R,2018-19,26,1,3,4,0.15,-5,32,3.12,8,25022.0,16:2,0,0,0,0.0,47,18,6,15,-9,0,0,0,1147.0,0:44,0,0,0,181.0,0:6,690000
8476409,Alan,Quine,1993-02-25,C,L,2018-19,13,3,2,5,0.38,0,11,27.27,6,7408.0,9:29,13,20,33,39.39,14,2,3,5,-2,1,0,1,179.0,0:13,0,0,0,0.0,0:0,700000
8476410,Josh,Leivo,1993-05-26,LW,R,2018-19,76,14,10,24,0.32,5,151,9.27,32,63977.0,14:1,15,26,41,36.59,44,23,37,32,5,3,4,7,10375.0,2:16,0,0,0,34.0,0:0,925000
8476415,Kyle,Rau,1992-10-24,C,L,2018-19,6,0,1,1,0.17,0,6,0.0,0,2525.0,7:0,3,1,4,75.0,11,2,1,1,0,0,0,0,0.0,0:0,0,0,0,0.0,0:0,700000
8476419,Jean-Gabriel,Pageau,1992-11-11,C,R,2018-19,39,4,8,12,0.31,-12,83,4.82,14,41757.0,17:50,259,222,481,53.85,63,38,21,22,-1,0,0,0,2130.0,0:54,0,0,0,4663.0,1:59,3100000
8476422,Mike,Reilly,1993-07-13,D,L,2018-19,57,3,8,11,0.19,0,101,2.97,16,63871.0,18:40,0,0,0,0.0,48,53,13,56,-43,1,0,1,4841.0,1:24,0,0,0,1723.0,0:30,725000
8476427,Ty,Rattie,1993-02-05,RW,R,2018-19,50,4,7,11,0.22,-2,84,4.76,4,34037.0,11:20,1,2,3,33.33,57,7,22,12,10,0,1,1,2651.0,0:53,0,0,0,7.0,0:0,800000
8476428,Rocco,Grimaldi,1993-02-08,C,R,2018-19,53,5,8,13,0.25,-2,81,6.17,10,31820.0,10:0,4,3,7,57.14,32,20,27,15,12,0,0,0,91.0,0:1,0,0,0,56.0,0:1,650000
8476429,Scott,Mayfield,1992-10-14,D,R,2018-19,79,4,15,19,0.24,18,104,3.85,68,88801.0,18:44,0,1,1,0.0,118,159,10,72,-62,0,0,0,143.0,0:1,1,0,1,11020.0,2:19,1450000
8476431,Adam,Clendening,1992-10-26,D,R,2018-19,4,0,0,0,0.0,1,3,0.0,0,2557.0,10:39,0,0,0,0.0,1,3,2,0,2,0,0,0,69.0,0:17,0,0,0,360.0,1:30,700000
8476432,Boone,Jenner,1993-06-15,C,L,2018-19,77,16,22,38,0.49,6,170,9.41,42,78838.0,17:3,626,531,1157,54.11,158,70,42,21,21,1,2,3,7382.0,1:35,1,0,1,6742.0,1:27,3750000
8476436,Dmitrij,Jaskin,1993-03-23,RW,L,2018-19,37,2,6,8,0.22,-5,48,4.17,6,22387.0,10:5,0,3,3,0.0,87,14,13,6,7,0,0,0,40.0,0:1,0,0,0,521.0,0:14,1100000
8476437,Victor,Rask,1993-03-01,C,L,2018-19,49,3,6,9,0.18,-4,55,5.45,8,35585.0,12:6,204,226,430,47.44,40,12,13,18,-5,0,2,2,4476.0,1:31,0,0,0,128.0,0:2,4000000
8476438,Brandon,Saad,1992-10-27,LW,L,2018-19,80,23,24,47,0.59,-9,195,11.79,12,84905.0,17:41,24,38,62,38.71,52,25,35,36,-1,5,1,6,7075.0,1:28,3,0,3,8080.0,1:41,6000000
8476439,Brett,Ritchie,1993-07-01,RW,R,2018-19,53,4,2,6,0.11,-7,57,7.02,57,30543.0,9:36,2,7,9,22.22,126,13,7,12,-5,1,0,1,2076.0,0:39,0,0,0,73.0,0:1,1750000
8476440,Markus,Granlund,1993-04-16,C,L,2018-19,77,12,10,22,0.29,-4,123,9.76,20,69495.0,15:2,149,199,348,42.82,46,24,32,9,23,2,1,3,7296.0,1:34,0,1,1,11100.0,2:24,1475000
8476441,Joel,Edmundson,1993-06-28,D,L,2018-19,64,2,9,11,0.17,8,102,1.96,68,74446.0,19:23,0,1,1,0.0,128,106,9,41,-32,0,0,0,490.0,0:7,0,0,0,7974.0,2:4,3000000
8476442,Matt,Nieto,1992-11-05,LW,L,2018-19,64,4,19,23,0.36,2,86,4.65,8,52879.0,13:46,9,8,17,52.94,50,26,19,11,8,0,0,0,214.0,0:3,1,2,3,10094.0,2:37,1975000
8476443,Xavier,Ouellet,1993-07-29,D,L,2018-19,19,0,3,3,0.16,-3,32,0.0,13,19393.0,17:0,0,0,0,0.0,32,30,5,10,-5,0,0,0,85.0,0:4,0,0,0,1529.0,1:20,1250000
8476447,Miikka,Salomaki,1993-03-09,RW,L,2018-19,37,3,4,7,0.19,5,51,5.88,8,23212.0,10:27,2,5,7,28.57,72,20,6,5,1,0,0,0,66.0,0:1,0,0,0,254.0,0:6,750000
8476448,William,Karlsson,1993-01-08,C,L,2018-19,82,24,32,56,0.68,1,169,14.2,16,92727.0,18:50,588,646,1234,47.65,51,55,73,41,32,7,7,14,11980.0,2:26,1,2,3,7528.0,1:31,5250000
8476449,Scott,Harrington,1993-03-10,D,L,2018-19,73,2,15,17,0.23,6,54,3.7,23,57149.0,13:2,0,0,0,0.0,73,81,9,18,-9,0,0,0,54.0,0:0,0,0,0,4024.0,0:55,675000
8476453,Nikita,Kucherov,1993-06-17,RW,L,2018-19,82,41,87,128,1.56,24,246,16.67,62,98230.0,19:57,0,3,3,0.0,44,31,58,89,-31,15,33,48,18341.0,3:43,0,0,0,251.0,0:3,4766667
8476454,Ryan,Nugent-Hopkins,1993-04-12,C,L,2018-19,82,28,41,69,0.84,-13,208,13.46,26,98903.0,20:6,379,461,840,45.12,69,40,59,56,3,8,18,26,15949.0,3:14,1,2,3,8343.0,1:41,6000000
8476455,Gabriel,Landeskog,1992-11-23,LW,L,2018-19,73,34,41,75,1.03,17,243,13.99,51,92631.0,21:8,361,333,694,52.02,120,64,46,47,-1,10,17,27,17953.0,4:5,0,0,0,1313.0,0:17,5571429
8476456,Jonathan,Huberdeau,1993-06-04,LW,L,2018-19,82,30,62,92,1.12,-14,226,13.27,40,92759.0,18:51,12,7,19,63.16,57,45,43,84,-41,11,23,34,16798.0,3:24,0,0,0,840.0,0:10,5900000
8476457,Adam,Larsson,1992-11-12,D,R,2018-19,82,3,17,20,0.24,-28,117,2.56,44,106386.0,21:37,0,0,0,0.0,256,128,25,68,-43,0,0,0,355.0,0:4,0,1,1,9881.0,2:0,4166666
8476458,Ryan,Strome,1993-07-11,C,R,2018-19,81,19,16,35,0.43,-3,110,17.27,64,75673.0,15:34,365,402,767,47.59,76,36,37,53,-16,4,3,7,6489.0,1:20,0,0,0,5394.0,1:6,3100000
8476459,Mika,Zibanejad,1993-04-18,C,R,2018-19,82,30,44,74,0.9,-12,236,12.71,47,101148.0,20:33,831,842,1673,49.67,134,66,69,69,0,11,12,23,13999.0,2:50,2,0,2,9760.0,1:59,5350000
8476460,Mark,Scheifele,1993-03-15,C,R,2018-19,82,38,46,84,1.02,8,199,19.1,38,107562.0,21:51,803,933,1736,46.26,54,54,74,48,26,12,11,23,17708.0,3:35,0,3,3,5583.0,1:8,6125000
8476461,Sean,Couturier,1992-12-07,C,L,2018-19,80,33,43,76,0.95,2,223,14.8,34,106210.0,22:7,755,568,1323,57.07,40,60,47,48,-1,8,9,17,14916.0,3:6,1,0,1,11091.0,2:18,4333333
8476462,Dougie,Hamilton,1993-06-17,D,R,2018-19,82,18,21,39,0.48,0,259,6.95,54,96789.0,19:40,0,1,1,0.0,160,91,35,66,-31,2,5,7,9162.0,1:51,0,0,0,1241.0,0:15,5750000
8476463,Jonas,Brodin,1993-07-12,D,L,2018-19,82,4,14,18,0.22,-15,111,3.6,30,101073.0,20:32,0,0,0,0.0,61,135,29,20,9,0,1,1,1317.0,0:16,1,0,1,10373.0,2:6,4166667
8476465,Ryan,Murphy,1993-03-31,D,R,2018-19,3,0,1,1,0.33,1,1,0.0,0,2010.0,11:10,0,0,0,0.0,1,3,1,0,1,0,1,1,172.0,0:57,0,0,0,1.0,0:0,650000
8476466,Sven,Baertschi,1992-10-05,LW,L,2018-19,26,9,5,14,0.54,-9,43,20.93,6,23615.0,15:8,1,3,4,25.0,18,13,10,6,4,3,4,7,4656.0,2:59,0,0,0,26.0,0:1,3366666
8476467,Jamie,Oleksiak,1992-12-21,D,L,2018-19,57,4,8,12,0.21,5,55,7.27,45,50382.0,14:43,0,0,0,0.0,135,59,10,38,-28,0,0,0,273.0,0:4,0,0,0,1275.0,0:22,2137500
8476468,J.T.,Miller,1993-03-14,C,L,2018-19,75,13,34,47,0.63,8,108,12.04,32,65992.0,14:39,259,265,524,49.43,115,23,42,38,4,4,16,20,11599.0,2:34,0,0,0,131.0,0:1,5250000
8476469,Joel,Armia,1993-05-31,RW,R,2018-19,57,13,10,23,0.4,0,134,9.7,14,54014.0,15:47,5,24,29,17.24,113,21,46,32,14,2,4,6,5937.0,1:44,1,0,1,5350.0,1:33,1850000
8476470,Nathan,Beaulieu,1992-12-05,D,L,2018-19,48,3,9,12,0.25,6,60,5.0,39,44658.0,15:30,0,0,0,0.0,60,42,9,22,-13,0,1,1,686.0,0:14,0,0,0,1784.0,0:37,2400000
8476472,Oscar,Klefbom,1993-07-20,D,L,2018-19,61,5,23,28,0.46,-11,167,2.99,16,87762.0,23:58,0,0,0,0.0,44,102,26,51,-25,1,10,11,9713.0,2:39,0,0,0,6573.0,1:47,4167000
8476473,Connor,Murphy,1993-03-26,D,R,2018-19,52,5,8,13,0.25,12,84,5.95,40,60805.0,19:29,0,0,0,0.0,119,91,14,48,-34,0,0,0,91.0,0:1,0,0,0,6528.0,2:5,3850000
8476474,Stefan,Noesen,1993-02-12,RW,R,2018-19,41,3,5,8,0.2,-19,64,4.69,28,31321.0,12:43,23,33,56,41.07,95,21,17,9,8,0,0,0,1686.0,0:41,0,0,0,49.0,0:1,1725000
8476476,Joe,Morrow,1992-12-09,D,L,2018-19,41,1,6,7,0.17,0,40,2.5,20,34340.0,13:57,0,0,0,0.0,37,37,5,28,-23,0,0,0,39.0,0:0,0,0,0,532.0,0:12,1000000
8476477,Matt,Puempel,1993-01-24,LW,L,2018-19,8,1,0,1,0.12,-2,10,10.0,2,4993.0,10:24,0,2,2,0.0,4,5,0,2,-2,1,0,1,341.0,0:42,0,0,0,6.0,0:0,675000
8476479,Phillip,Danault,1993-02-24,C,L,2018-19,81,12,41,53,0.65,17,132,9.09,39,86398.0,17:46,882,706,1588,55.54,95,60,49,53,-4,0,4,4,2345.0,0:28,0,2,2,12152.0,2:30,3083333
8476480,Vladislav,Namestnikov,1992-11-22,C,L,2018-19,78,11,20,31,0.4,-7,119,9.24,44,73908.0,15:47,22,32,54,40.74,140,62,32,46,-14,1,2,3,6510.0,1:23,2,3,5,7697.0,1:38,4000000
8476483,Rickard,Rakell,1993-05-05,C,R,2018-19,69,18,25,43,0.62,-13,194,9.28,27,76477.0,18:28,17,31,48,35.42,82,38,41,60,-19,6,7,13,10142.0,2:26,0,0,0,1830.0,0:26,3789444
8476525,Colin,Miller,1992-10-29,D,R,2018-19,65,3,26,29,0.45,0,131,2.29,44,76619.0,19:38,0,0,0,0.0,122,64,22,46,-24,1,12,13,9273.0,2:22,0,0,0,2282.0,0:35,3875000
8476539,Jonathan,Marchessault,1990-12-27,C,R,2018-19,82,25,34,59,0.72,2,278,8.99,52,89281.0,18:8,92,155,247,37.25,98,22,51,68,-17,5,11,16,13236.0,2:41,0,0,0,83.0,0:1,5000000
8476545,Kurtis,Gabriel,1993-04-20,RW,R,2018-19,22,2,2,4,0.18,0,7,28.57,59,9732.0,7:22,0,0,0,0.0,78,8,2,4,-2,0,0,0,27.0,0:1,0,0,0,5.0,0:0,650000
8476617,Tomas,Hyka,1993-03-23,RW,R,2018-19,17,1,3,4,0.24,-2,22,4.55,2,12001.0,11:45,1,1,2,50.0,6,5,9,7,2,0,2,2,2035.0,1:59,0,0,0,0.0,0:0,650000
8476624,Barclay,Goodrow,1993-02-26,RW,L,2018-19,82,7,10,17,0.21,4,84,8.33,76,54164.0,11:0,296,255,551,53.72,125,68,35,17,18,0,0,0,234.0,0:2,1,0,1,7087.0,1:26,650000
8476779,Brad,Hunt,1988-08-24,D,L,2018-19,42,5,7,12,0.29,-2,75,6.67,8,37523.0,14:53,0,0,0,0.0,18,28,22,14,8,4,4,8,6075.0,2:24,0,0,0,31.0,0:0,650000
8476792,Torey,Krug,1991-04-12,D,L,2018-19,64,6,47,53,0.83,-2,151,3.97,33,81793.0,21:18,0,0,0,0.0,53,60,20,52,-32,2,28,30,14235.0,3:42,0,0,0,817.0,0:12,5250000
8476799,Cameron,Schilling,1988-10-07,D,L,2018-19,4,0,1,1,0.25,0,2,0.0,0,2903.0,12:5,0,0,0,0.0,3,5,0,3,-3,0,0,0,0.0,0:0,0,0,0,138.0,0:34,650000
8476806,J.T.,Brown,1990-07-02,RW,R,2018-19,56,3,5,8,0.14,0,56,5.36,29,30810.0,9:10,5,13,18,27.78,99,16,16,9,7,0,0,0,32.0,0:0,0,0,0,767.0,0:13,687500
8476807,Matt,Tennyson,1990-04-23,D,R,2018-19,4,0,0,0,0.0,-4,4,0.0,0,2579.0,10:44,0,0,0,0.0,10,2,0,3,-3,0,0,0,6.0,0:1,0,0,0,19.0,0:4,650000
8476822,Luke,Glendening,1989-04-28,RW,R,2018-19,78,10,13,23,0.29,2,102,9.8,15,73891.0,15:47,658,524,1182,55.67,198,102,23,25,-2,0,0,0,577.0,0:7,1,2,3,11831.0,2:31,1800000
8476826,Yanni,Gourde,1991-12-15,C,L,2018-19,80,22,26,48,0.6,9,130,16.92,66,76024.0,15:50,151,132,283,53.36,83,30,50,40,10,5,4,9,6790.0,1:24,1,1,2,8366.0,1:44,1000000
8476850,Ryan,Murray,1993-09-27,D,L,2018-19,56,1,28,29,0.52,20,71,1.41,10,72036.0,21:26,0,0,0,0.0,27,93,22,30,-8,0,1,1,2023.0,0:36,0,0,0,8495.0,2:31,2825000
8476851,Alex,Galchenyuk,1994-02-12,LW,L,2018-19,72,19,22,41,0.57,-19,159,11.95,34,67958.0,15:43,188,223,411,45.74,62,34,28,40,-12,9,12,21,13695.0,3:10,0,0,0,32.0,0:0,4900000
8476853,Morgan,Rielly,1994-03-09,D,L,2018-19,82,20,52,72,0.88,24,223,8.97,14,113761.0,23:7,0,1,1,0.0,61,114,60,94,-34,3,18,21,12815.0,2:36,0,0,0,5293.0,1:4,5000000
8476854,Hampus,Lindholm,1994-01-20,D,L,2018-19,76,6,22,28,0.37,-5,125,4.8,44,109416.0,23:59,0,0,0,0.0,81,133,23,85,-62,1,5,6,5570.0,1:13,0,1,1,14053.0,3:4,5205556
8476856,Matt,Dumba,1994-07-25,D,R,2018-19,32,12,10,22,0.69,-5,93,12.9,21,44882.0,23:22,0,0,0,0.0,60,43,10,17,-7,6,6,12,5218.0,2:43,0,0,0,2965.0,1:32,6000000
8476857,Pontus,Aberg,1993-09-23,LW,R,2018-19,59,12,13,25,0.42,-14,101,11.88,20,51658.0,14:35,2,17,19,10.53,45,11,15,36,-21,3,4,7,7337.0,2:4,0,0,0,21.0,0:0,650000
8476858,Phillip,Di Giuseppe,1993-10-09,LW,L,2018-19,24,1,3,4,0.17,-3,31,3.23,8,14595.0,10:8,3,2,5,60.0,54,9,9,6,3,0,0,0,553.0,0:23,0,0,0,54.0,0:2,750000
8476867,Brendan,Gaunce,1994-03-25,C,L,2018-19,3,1,2,3,1.0,3,2,50.0,0,1370.0,7:36,8,5,13,61.54,4,0,0,1,-1,0,0,0,0.0,0:0,0,0,0,0.0,0:0,750000
8476869,Brady,Skjei,1994-03-26,D,L,2018-19,78,8,17,25,0.32,-4,126,6.35,44,99376.0,21:14,1,0,1,100.0,178,119,32,69,-37,0,0,0,1128.0,0:14,0,1,1,10430.0,2:13,5250000
8476871,Tanner,Pearson,1992-08-10,LW,L,2018-19,80,18,9,27,0.34,-15,147,12.24,25,67445.0,14:3,5,12,17,29.41,128,41,21,23,-2,3,2,5,5945.0,1:14,0,0,0,1285.0,0:16,3750000
8476872,Scott,Laughton,1994-05-30,C,L,2018-19,82,12,20,32,0.39,-11,130,9.23,53,73068.0,14:51,344,291,635,54.17,146,46,42,42,0,0,0,0,752.0,0:9,0,2,2,11032.0,2:14,962500
8476873,Mark,Jankowski,1994-09-13,C,L,2018-19,79,14,18,32,0.41,6,99,14.14,12,60235.0,12:42,426,394,820,51.95,30,56,49,36,13,0,0,0,1120.0,0:14,5,3,8,9217.0,1:56,1675000
8476874,Olli,Maatta,1994-08-22,D,L,2018-19,60,1,13,14,0.23,9,74,1.35,12,66924.0,18:35,0,0,0,0.0,97,116,16,42,-26,1,3,4,2935.0,0:48,0,0,0,7279.0,2:1,4083333
8476875,Mike,Matheson,1994-02-27,D,L,2018-19,75,8,19,27,0.36,-24,129,6.2,44,100431.0,22:19,0,1,1,0.0,63,132,64,135,-71,0,6,6,3596.0,0:47,0,2,2,10783.0,2:23,4875000
8476877,Jordan,Schmaltz,1993-10-08,D,R,2018-19,20,0,2,2,0.1,-7,11,0.0,2,13783.0,11:29,0,0,0,0.0,10,22,1,3,-2,0,0,0,78.0,0:3,0,0,0,480.0,0:24,700000
8476878,Zemgus,Girgensons,1994-01-05,C,L,2018-19,72,5,13,18,0.25,-11,78,6.41,17,58801.0,13:36,28,41,69,40.58,144,29,21,11,10,0,0,0,344.0,0:4,0,0,0,10378.0,2:24,1600000
8476879,Cody,Ceci,1993-12-21,D,R,2018-19,74,7,19,26,0.35,-22,132,5.3,18,100171.0,22:33,0,0,0,0.0,120,142,20,59,-39,0,1,1,2090.0,0:28,0,0,0,11078.0,2:29,4300000
8476880,Tom,Wilson,1994-03-29,RW,R,2018-19,63,22,18,40,0.63,11,130,16.92,128,68579.0,18:8,29,24,53,54.72,200,52,43,44,-1,3,2,5,5284.0,1:23,2,0,2,8458.0,2:14,5166666
8476881,Tomas,Hertl,1993-11-12,C,L,2018-19,77,35,39,74,0.96,5,176,19.89,18,87871.0,19:1,609,574,1183,51.48,53,64,57,44,13,11,4,15,13250.0,2:52,1,1,2,7634.0,1:39,5625000
8476882,Teuvo,Teravainen,1994-09-11,LW,L,2018-19,82,21,55,76,0.93,30,167,12.57,12,88153.0,17:55,18,25,43,41.86,35,23,55,64,-9,8,16,24,13423.0,2:43,1,4,5,4382.0,0:53,2860000
8476884,Derrick,Pouliot,1994-01-16,D,L,2018-19,62,3,9,12,0.19,-1,58,5.17,30,63829.0,17:9,0,0,0,0.0,76,71,19,39,-20,1,0,1,4328.0,1:9,0,0,0,393.0,0:6,1100000
8476885,Jacob,Trouba,1994-02-26,D,R,2018-19,82,8,42,50,0.61,8,162,4.94,58,112560.0,22:52,0,0,0,0.0,112,171,48,86,-38,3,15,18,10132.0,2:3,1,2,3,12117.0,2:27,5500000
8476886,Slater,Koekkoek,1994-02-18,D,L,2018-19,31,2,4,6,0.19,4,36,5.56,14,29447.0,15:49,0,0,0,0.0,54,48,4,7,-3,0,0,0,108.0,0:3,0,0,0,2445.0,1:18,865000
8476887,Filip,Forsberg,1994-08-13,LW,R,2018-19,64,28,22,50,0.78,8,217,12.9,26,71487.0,18:36,1,6,7,14.29,100,29,69,67,2,7,3,10,11619.0,3:1,2,0,2,4014.0,1:2,6000000
8476889,Radek,Faksa,1994-01-09,C,L,2018-19,81,15,15,30,0.37,-3,114,13.16,54,79849.0,16:25,570,562,1132,50.35,103,65,42,29,13,1,2,3,4327.0,0:53,1,1,2,7857.0,1:37,2200000
8476891,Matt,Grzelcyk,1994-01-05,D,L,2018-19,66,3,15,18,0.27,9,90,3.33,68,75759.0,19:7,0,0,0,0.0,46,60,28,39,-11,1,5,6,6196.0,1:33,0,0,0,2849.0,0:43,1400000
8476892,Colton,Parayko,1993-05-12,D,R,2018-19,80,10,18,28,0.35,20,176,5.68,15,109361.0,22:47,0,0,0,0.0,127,157,33,43,-10,4,4,8,6269.0,1:18,0,1,1,6776.0,1:24,5500000
8476894,Brendan,Leipsic,1994-05-19,LW,L,2018-19,62,7,16,23,0.37,-14,92,7.61,24,51276.0,13:47,7,6,13,53.85,56,28,22,21,1,1,3,4,6637.0,1:47,0,0,0,0.0,0:0,650000
8476897,Oskar,Sundqvist,1994-03-23,C,R,2018-19,74,14,17,31,0.42,-1,113,12.39,22,61355.0,13:49,227,314,541,41.96,101,31,41,10,31,0,1,1,1672.0,0:22,1,1,2,7334.0,1:39,700000
8476902,Esa,Lindell,1994-05-23,D,L,2018-19,82,11,21,32,0.39,14,132,8.33,33,119687.0,24:19,0,0,0,0.0,143,161,30,92,-62,4,3,7,5727.0,1:9,2,0,2,15944.0,3:14,2200000
8476905,Chandler,Stephenson,1994-04-22,C,L,2018-19,64,5,6,11,0.17,-13,36,13.89,0,46527.0,12:6,47,48,95,49.47,38,33,18,11,7,0,0,0,52.0,0:0,1,0,1,6760.0,1:45,650000
8476906,Shayne,Gostisbehere,1993-04-20,D,L,2018-19,78,9,28,37,0.47,-20,180,5.0,22,92005.0,19:39,0,0,0,0.0,46,102,20,53,-33,4,10,14,16276.0,3:28,0,0,0,414.0,0:5,4500000
8476907,Mackenzie,MacEachern,1994-03-09,LW,L,2018-19,29,3,2,5,0.17,0,33,9.09,10,13976.0,8:1,0,0,0,0.0,49,4,6,0,6,0,0,0,6.0,0:0,0,0,0,16.0,0:0,650000
8476913,Devin,Shore,1994-07-19,C,L,2018-19,76,10,19,29,0.38,-12,82,12.2,13,65026.0,14:15,86,123,209,41.15,94,64,29,22,7,2,3,5,5717.0,1:15,2,0,2,5848.0,1:16,2300000
8476915,Jujhar,Khaira,1994-08-13,LW,L,2018-19,60,3,15,18,0.3,-12,64,4.69,43,45241.0,12:34,55,71,126,43.65,123,33,22,26,-4,0,0,0,1406.0,0:23,1,1,2,4151.0,1:9,675000
8476917,Adam,Pelech,1994-08-16,D,L,2018-19,78,5,16,21,0.27,22,110,4.55,24,87186.0,18:37,0,0,0,0.0,149,116,37,41,-4,0,0,0,424.0,0:5,0,0,0,7538.0,1:36,1600000
8476918,Jimmy,Vesey,1993-05-26,LW,L,2018-19,81,17,18,35,0.43,-6,154,11.04,21,78039.0,16:3,8,24,32,25.0,79,34,50,42,8,1,3,4,8176.0,1:40,0,0,0,6292.0,1:17,2275000
8476919,Chris,Tierney,1994-07-01,C,L,2018-19,81,9,39,48,0.59,-22,116,7.76,26,82769.0,17:1,531,512,1043,50.91,30,54,53,61,-8,0,10,10,8368.0,1:43,0,0,0,8223.0,1:41,2937500
8476921,Jordan,Martinook,1992-07-25,LW,L,2018-19,82,15,10,25,0.3,1,146,10.27,38,71270.0,14:29,150,191,341,43.99,199,46,53,30,23,0,0,0,480.0,0:5,1,0,1,7955.0,1:37,1800000
8476923,Damon,Severson,1994-08-07,D,R,2018-19,82,11,28,39,0.48,-27,146,7.53,58,108451.0,22:2,0,0,0,0.0,83,87,25,61,-36,3,9,12,12111.0,2:27,0,1,1,7357.0,1:29,4166666
8476924,Martin,Frk,1993-10-05,RW,R,2018-19,30,1,5,6,0.2,-9,28,3.57,4,16534.0,9:11,0,0,0,0.0,35,4,3,10,-7,1,0,1,1899.0,1:3,0,0,0,0.0,0:0,1050000
8476925,Colton,Sissons,1993-11-05,C,R,2018-19,75,15,15,30,0.4,20,111,13.51,23,72199.0,16:2,421,372,793,53.09,109,52,35,25,10,1,1,2,5251.0,1:10,0,1,1,8894.0,1:58,625000
8476927,Teddy,Blueger,1994-08-15,C,L,2018-19,28,6,4,10,0.36,7,33,18.18,15,18576.0,11:3,41,51,92,44.57,52,14,6,7,-1,0,0,0,33.0,0:1,1,2,3,2149.0,1:16,650000
8476931,Jake,McCabe,1993-10-12,D,L,2018-19,59,4,10,14,0.24,-4,64,6.25,35,67065.0,18:56,0,1,1,0.0,103,99,20,32,-12,0,0,0,360.0,0:6,1,0,1,7591.0,2:8,1600000
8476934,Brock,McGinn,1994-02-02,LW,L,2018-19,82,10,16,26,0.32,10,123,8.13,20,70403.0,14:18,26,35,61,42.62,137,38,54,30,24,0,0,0,1263.0,0:15,1,0,1,10945.0,2:13,887500
8476941,Connor,Carrick,1994-04-13,D,R,2018-19,34,2,9,11,0.32,-13,42,4.76,19,34269.0,16:47,0,0,0,0.0,25,37,15,17,-2,0,1,1,1756.0,0:51,0,0,0,839.0,0:24,1300000
8476948,Charles,Hudon,1994-06-23,LW,L,2018-19,32,3,2,5,0.16,-9,50,6.0,16,22412.0,11:40,4,5,9,44.44,73,9,9,14,-5,0,1,1,3056.0,1:35,0,0,0,0.0,0:0,650000
8476952,Dominic,Toninato,1994-03-09,C,L,2018-19,2,1,0,1,0.5,0,1,100.0,0,804.0,6:42,0,4,4,0.0,0,1,0,1,-1,0,0,0,0.0,0:0,0,0,0,28.0,0:14,925000
8476958,Jaccob,Slavin,1994-05-01,D,L,2018-19,82,8,23,31,0.38,0,146,5.48,18,113346.0,23:2,0,1,1,0.0,70,133,86,60,26,5,2,7,8893.0,1:48,1,1,2,11779.0,2:23,5300000
8476960,Andreas,Athanasiou,1994-08-06,LW,L,2018-19,76,30,24,54,0.71,-9,216,13.89,38,77404.0,16:58,171,228,399,42.86,33,26,26,47,-21,3,8,11,10175.0,2:13,0,0,0,390.0,0:5,3000000
8476966,Gemel,Smith,1994-04-16,C,L,2018-19,17,2,1,3,0.18,-4,14,14.29,0,8535.0,8:22,2,2,4,50.0,13,3,5,2,3,0,0,0,0.0,0:0,0,0,0,35.0,0:2,720000
8476967,Brett,Kulak,1994-01-06,D,L,2018-19,57,6,11,17,0.3,12,102,5.88,31,61023.0,17:50,0,0,0,0.0,107,64,15,43,-28,0,0,0,161.0,0:2,1,0,1,1525.0,0:26,900000
8476971,Kevin,Roy,1993-05-20,LW,L,2018-19,3,0,0,0,0.0,-1,2,0.0,0,2348.0,13:2,0,0,0,0.0,0,2,1,2,-1,0,0,0,33.0,0:11,0,0,0,0.0,0:0,874125
8476975,Cedric,Paquette,1993-08-13,C,L,2018-19,80,13,4,17,0.21,7,87,14.94,80,57616.0,12:0,404,364,768,52.6,269,61,21,12,9,0,0,0,224.0,0:2,2,0,2,9618.0,2:0,1000000
8476979,Erik,Gustafsson,1992-03-14,D,L,2018-19,79,17,43,60,0.76,-6,160,10.62,34,107051.0,22:35,0,0,0,0.0,100,115,34,77,-43,4,14,18,14378.0,3:2,0,0,0,546.0,0:6,1200000
8476981,Josh,Anderson,1994-05-07,RW,R,2018-19,82,27,20,47,0.57,25,230,11.74,60,83756.0,17:1,12,26,38,31.58,214,40,46,19,27,3,4,7,6740.0,1:22,2,1,3,6590.0,1:20,1850000
8476982,Danny,O'Regan,1994-01-30,C,R,2018-19,1,0,0,0,0.0,0,2,0.0,0,716.0,11:56,1,0,1,100.0,0,0,0,0,0,0,0,0,53.0,0:53,0,0,0,0.0,0:0,874125
8476983,Paul,LaDue,1992-09-06,D,R,2018-19,33,2,3,5,0.15,0,33,6.06,12,26178.0,13:13,0,0,0,0.0,51,25,2,9,-7,0,0,0,127.0,0:3,0,0,0,212.0,0:6,825000
8476988,Matt,Benning,1994-05-25,D,R,2018-19,70,5,12,17,0.24,11,94,5.32,33,62770.0,14:56,0,0,0,0.0,109,59,10,49,-39,0,1,1,2364.0,0:33,0,1,1,5210.0,1:14,1900000
8476994,Vinnie,Hinostroza,1994-04-03,LW,R,2018-19,72,16,23,39,0.54,-4,152,10.53,14,65956.0,15:16,39,64,103,37.86,69,41,28,34,-6,3,2,5,5673.0,1:18,0,0,0,701.0,0:9,1500000
8477009,Jake,Dotchin,1994-03-24,D,R,2018-19,20,0,1,1,0.05,-4,7,0.0,39,14171.0,11:48,0,0,0,0.0,54,16,4,7,-3,0,0,0,0.0,0:0,0,1,1,821.0,0:41,812500
8477010,Joseph,Blandisi,1994-07-18,LW,L,2018-19,9,0,0,0,0.0,-1,8,0.0,6,4020.0,7:26,0,0,0,0.0,10,1,3,0,3,0,0,0,16.0,0:1,0,0,0,107.0,0:11,680000
8477015,Connor,Brown,1994-01-14,RW,R,2018-19,82,8,21,29,0.35,11,85,9.41,16,67857.0,13:47,20,31,51,39.22,35,37,31,17,14,0,1,1,1206.0,0:14,0,3,3,9639.0,1:57,2100000
8477018,Ben,Hutton,1993-04-20,D,L,2018-19,69,5,15,20,0.29,-23,114,4.39,43,92553.0,22:21,0,0,0,0.0,55,102,27,30,-3,1,7,8,7674.0,1:51,0,1,1,9488.0,2:17,2800000
8477021,Alexander,Kerfoot,1994-08-11,C,L,2018-19,78,15,27,42,0.54,-9,116,12.93,38,69650.0,14:52,274,215,489,56.03,22,29,22,30,-8,4,12,16,9718.0,2:4,0,0,0,277.0,0:3,925000
8477034,Jaycob,Megna,1992-12-10,D,L,2018-19,28,1,3,4,0.14,-1,31,3.23,12,24414.0,14:31,0,0,0,0.0,32,29,11,30,-19,0,0,0,12.0,0:0,0,0,0,3368.0,2:0,650000
8477043,Christian,Djoos,1994-08-06,D,L,2018-19,45,1,9,10,0.22,9,33,3.03,4,36643.0,13:34,0,0,0,0.0,18,28,10,22,-12,0,0,0,195.0,0:4,0,0,0,65.0,0:1,650000
8477046,Joakim,Ryan,1993-06-17,D,L,2018-19,44,0,7,7,0.16,-1,35,0.0,15,33724.0,12:46,0,0,0,0.0,43,39,11,9,2,0,0,0,96.0,0:2,0,0,0,660.0,0:15,650000
8477073,Kurtis,MacDermid,1994-03-25,D,L,2018-19,11,0,1,1,0.09,-1,5,0.0,11,6169.0,9:20,0,0,0,0.0,26,4,0,12,-12,0,0,0,32.0,0:2,0,0,0,273.0,0:24,675000
8477085,Ashton,Sautner,1994-05-27,D,L,2018-19,17,0,1,1,0.06,-2,21,0.0,2,14835.0,14:32,0,0,0,0.0,25,17,3,10,-7,0,0,0,6.0,0:0,0,0,0,228.0,0:13,675000
8477205,Andrej,Sustr,1990-11-29,D,R,2018-19,5,0,0,0,0.0,0,6,0.0,6,3612.0,12:2,0,0,0,0.0,3,7,0,0,0,0,0,0,43.0,0:8,0,0,0,48.0,0:9,1300000
8477213,Tim,Schaller,1990-11-16,C,L,2018-19,47,3,7,10,0.21,-2,44,6.82,9,30069.0,10:39,1,1,2,50.0,66,18,14,8,6,0,0,0,58.0,0:1,0,0,0,3761.0,1:20,1900000
8477215,Danny,DeKeyser,1990-03-07,D,L,2018-19,52,5,15,20,0.38,2,59,8.47,39,68538.0,21:58,0,0,0,0.0,79,94,14,30,-16,0,0,0,725.0,0:13,0,0,0,7826.0,2:30,5000000
8477220,Nate,Schmidt,1991-07-16,D,L,2018-19,61,9,21,30,0.49,22,112,8.04,8,80340.0,21:57,0,0,0,0.0,37,100,45,39,6,1,7,8,6700.0,1:49,0,0,0,5453.0,1:29,2225000
8477240,Carter,Rowney,1989-05-10,RW,R,2018-19,62,7,13,20,0.32,0,53,13.21,12,46690.0,12:33,171,176,347,49.28,178,35,22,26,-4,0,0,0,251.0,0:4,1,0,1,7072.0,1:54,1133333
8477244,Chad,Ruhwedel,1990-05-07,D,R,2018-19,18,1,1,2,0.11,-9,22,4.55,4,17578.0,16:16,0,0,0,0.0,40,16,7,10,-3,0,0,0,94.0,0:5,0,0,0,1385.0,1:16,650000
8477290,Michael,Raffl,1988-12-01,LW,L,2018-19,67,6,12,18,0.27,-1,65,9.23,32,45890.0,11:24,14,20,34,41.18,96,29,28,20,8,0,0,0,260.0,0:3,1,0,1,3720.0,0:55,2350000
8477337,John,Gilmour,1993-05-17,D,L,2018-19,5,0,0,0,0.0,-3,9,0.0,4,4823.0,16:4,0,0,0,0.0,3,13,1,3,-2,0,0,0,38.0,0:7,0,0,0,4.0,0:0,650000
8477341,Andreas,Johnsson,1994-11-21,LW,L,2018-19,73,20,23,43,0.59,14,130,15.38,32,59868.0,13:40,7,12,19,36.84,60,36,25,20,5,3,3,6,6908.0,1:34,0,0,0,63.0,0:0,787500
8477343,Tyler,Lewington,1994-12-05,D,R,2018-19,2,1,1,2,1.0,3,3,33.33,7,1655.0,13:47,0,0,0,0.0,4,1,0,3,-3,0,0,0,0.0,0:0,0,0,0,66.0,0:33,675000
8477346,MacKenzie,Weegar,1994-01-07,D,R,2018-19,64,4,11,15,0.23,-3,79,5.06,64,65151.0,16:57,1,0,1,100.0,127,103,34,59,-25,0,1,1,1117.0,0:17,0,0,0,5544.0,1:26,900000
8477353,Tyler,Motte,1995-03-10,C,L,2018-19,74,9,7,16,0.22,-12,114,7.89,10,56720.0,12:46,15,33,48,31.25,200,52,34,15,19,0,0,0,174.0,0:2,2,0,2,7587.0,1:42,925000
8477355,Will,Butcher,1995-01-06,D,L,2018-19,78,4,26,30,0.38,-17,108,3.7,18,90205.0,19:16,0,0,0,0.0,38,74,17,32,-15,1,13,14,12964.0,2:46,0,0,0,614.0,0:7,925000
8477357,Saku,Maenalanen,1994-05-29,RW,L,2018-19,34,4,4,8,0.24,0,36,11.11,20,19239.0,9:25,6,15,21,28.57,45,10,12,8,4,0,0,0,191.0,0:5,0,0,0,712.0,0:20,925000
8477365,Connor,Clifton,1995-04-28,D,R,2018-19,19,0,1,1,0.05,5,22,0.0,15,20184.0,17:42,0,0,0,0.0,40,13,10,9,1,0,0,0,56.0,0:2,0,0,0,729.0,0:38,725000
8477366,Luke,Johnson,1994-09-19,C,R,2018-19,15,0,1,1,0.07,-8,19,0.0,8,9731.0,10:48,51,55,106,48.11,31,9,6,1,5,0,1,1,297.0,0:19,0,0,0,1201.0,1:20,717500
8477380,Jonny,Brodzinski,1993-06-19,C,L,2018-19,13,2,1,3,0.23,0,17,11.76,2,7740.0,9:55,1,1,2,50.0,23,7,3,0,3,0,0,0,230.0,0:17,0,0,0,3.0,0:0,650000
8477384,Josh,Brown,1994-01-21,D,R,2018-19,37,1,1,2,0.05,-3,28,3.57,28,29527.0,13:18,0,0,0,0.0,80,31,12,17,-5,0,0,0,68.0,0:1,0,0,0,1813.0,0:49,675000
8477399,Tyrell,Goulbourne,1994-01-26,LW,L,2018-19,2,0,0,0,0.0,0,3,0.0,0,889.0,7:24,0,0,0,0.0,6,0,1,0,1,0,0,0,0.0,0:0,0,0,0,0.0,0:0,715000
8477401,John,Hayden,1995-02-14,RW,R,2018-19,54,3,2,5,0.09,-12,42,7.14,27,29682.0,9:9,7,22,29,24.14,97,23,15,9,6,0,0,0,1294.0,0:23,0,0,0,669.0,0:12,750000
8477402,Pavel,Buchnevich,1995-04-17,RW,L,2018-19,64,21,17,38,0.59,-10,119,17.65,13,58271.0,15:10,7,18,25,28.0,60,20,29,43,-14,7,5,12,7503.0,1:57,0,0,0,7.0,0:0,925000
8477404,Jake,Guentzel,1994-10-06,C,L,2018-19,82,40,36,76,0.93,13,227,17.62,26,95205.0,19:21,10,20,30,33.33,105,47,45,42,3,6,5,11,10445.0,2:7,1,0,1,2405.0,0:29,734167
8477406,Mattias,Janmark,1992-12-08,C,L,2018-19,81,6,19,25,0.31,-4,105,5.71,24,73952.0,15:12,10,16,26,38.46,28,44,30,36,-6,0,1,1,1580.0,0:19,0,1,1,7259.0,1:29,2300000
8477407,Anthony,Duclair,1995-08-26,LW,L,2018-19,74,19,14,33,0.45,-2,132,14.39,14,56392.0,12:42,2,13,15,13.33,32,33,33,29,4,7,1,8,7180.0,1:37,0,0,0,129.0,0:1,650000
8477413,Sven,Andrighetto,1993-03-21,RW,L,2018-19,64,7,10,17,0.27,10,95,7.37,14,42503.0,11:4,3,8,11,27.27,29,32,22,18,4,0,0,0,4858.0,1:15,0,0,0,426.0,0:6,1400000
8477416,Oliver,Bjorkstrand,1995-04-10,RW,R,2018-19,77,23,13,36,0.47,8,161,14.29,8,57003.0,12:20,5,8,13,38.46,43,34,31,14,17,3,0,3,5723.0,1:14,0,0,0,35.0,0:0,2500000
8477417,Peter,Cehlarik,1995-08-02,LW,L,2018-19,20,4,2,6,0.3,3,30,13.33,6,15112.0,12:35,0,5,5,0.0,5,7,13,6,7,1,0,1,1472.0,1:13,0,0,0,4.0,0:0,742500
8477425,Miles,Wood,1995-09-13,LW,L,2018-19,63,10,14,24,0.38,-10,159,6.29,91,51764.0,13:41,0,2,2,0.0,97,27,19,33,-14,1,2,3,4571.0,1:12,0,0,0,16.0,0:0,2750000
8477426,Nick,Paul,1995-03-20,LW,L,2018-19,20,1,1,2,0.1,-10,30,3.33,4,10169.0,8:28,16,19,35,45.71,28,4,5,3,2,0,0,0,32.0,0:1,0,0,0,0.0,0:0,650000
8477429,Andrew,Copp,1994-07-08,C,L,2018-19,69,11,14,25,0.36,20,82,13.41,6,50344.0,12:9,198,160,358,55.31,71,34,22,27,-5,0,0,0,229.0,0:3,1,0,1,5664.0,1:22,1000000
8477433,Ben,Harpur,1995-01-12,D,L,2018-19,51,1,4,5,0.1,-13,50,2.0,56,53919.0,17:37,0,0,0,0.0,89,69,16,60,-44,0,0,0,86.0,0:1,0,0,0,7510.0,2:27,725000
8477435,Ryan,Graves,1995-05-21,D,L,2018-19,26,3,2,5,0.19,4,26,11.54,2,17322.0,11:6,0,0,0,0.0,32,51,5,12,-7,0,0,0,3.0,0:0,0,0,0,1897.0,1:12,650000
8477444,Andre,Burakovsky,1995-02-09,LW,L,2018-19,76,12,13,25,0.33,2,100,12.0,14,50732.0,11:7,7,13,20,35.0,35,29,28,29,-1,1,0,1,1106.0,0:14,0,0,0,223.0,0:2,3000000
8477447,Shea,Theodore,1995-08-03,D,L,2018-19,79,12,25,37,0.47,-4,202,5.94,20,95290.0,20:6,1,0,1,100.0,27,91,82,59,23,4,5,9,11487.0,2:25,0,1,1,801.0,0:10,5200000
8477448,Marko,Dano,1994-11-30,C,L,2018-19,8,0,0,0,0.0,-1,3,0.0,7,3304.0,6:53,0,5,5,0.0,16,3,3,2,1,0,0,0,0.0,0:0,0,0,0,18.0,0:2,800000
8477450,Jason,Dickinson,1995-07-04,C,L,2018-19,67,6,16,22,0.33,9,94,6.38,23,53761.0,13:22,201,268,469,42.86,106,50,30,26,4,0,0,0,408.0,0:6,0,0,0,5909.0,1:28,875000
8477451,Ryan,Hartman,1994-09-20,RW,R,2018-19,83,12,14,26,0.31,1,145,8.28,74,65327.0,13:7,4,12,16,25.0,107,39,35,38,-3,0,0,0,1309.0,0:15,0,0,0,2075.0,0:25,875000
8477452,Ian,McCoshen,1995-08-05,D,L,2018-19,19,1,1,2,0.11,-2,15,6.67,8,15184.0,13:19,0,0,0,0.0,41,13,5,11,-6,0,0,0,9.0,0:0,0,0,0,1129.0,0:59,925000
8477454,Adam,Erne,1995-04-20,LW,L,2018-19,65,7,13,20,0.31,10,70,10.0,40,41138.0,10:32,11,12,23,47.83,159,26,16,8,8,2,0,2,1981.0,0:30,0,0,0,1155.0,0:17,800000
8477455,Jacob,de la Rose,1995-05-20,LW,L,2018-19,60,3,6,9,0.15,-13,55,5.45,16,41177.0,11:26,161,219,380,42.37,72,29,17,11,6,0,0,0,290.0,0:4,0,0,0,5194.0,1:26,900000
8477456,J.T.,Compher,1995-04-08,LW,R,2018-19,66,16,16,32,0.48,-8,118,13.56,31,69204.0,17:28,301,311,612,49.18,33,59,23,23,0,4,5,9,12351.0,3:7,3,0,3,7488.0,1:53,925000
8477458,Valentin,Zykov,1995-05-15,LW,R,2018-19,28,2,3,5,0.18,-5,29,6.9,2,16718.0,9:57,2,7,9,22.22,26,6,9,15,-6,0,2,2,2486.0,1:28,0,0,0,0.0,0:0,675000
8477460,Laurent,Dauphin,1995-03-27,C,L,2018-19,1,0,0,0,0.0,-1,2,0.0,0,739.0,12:19,0,1,1,0.0,0,1,0,0,0,0,0,0,0.0,0:0,0,0,0,0.0,0:0,787500
8477461,Remi,Elie,1995-04-16,LW,L,2018-19,16,0,1,1,0.06,-3,9,0.0,2,9936.0,10:21,1,0,1,100.0,30,3,3,4,-1,0,0,0,65.0,0:4,0,0,0,1032.0,1:4,735000
8477462,Robert,Hagg,1995-02-08,D,L,2018-19,82,5,15,20,0.24,-3,86,5.81,63,83371.0,16:56,0,0,0,0.0,258,158,4,39,-35,0,0,0,219.0,0:2,0,0,0,8695.0,1:46,1150000
8477463,Steven,Santini,1995-03-07,D,R,2018-19,39,1,3,4,0.1,-6,41,2.44,16,38976.0,16:39,0,0,0,0.0,80,43,9,9,0,0,0,0,159.0,0:4,0,0,0,1900.0,0:48,1416667
8477464,Nic,Petan,1995-03-22,LW,L,2018-19,18,1,2,3,0.17,-5,15,6.67,2,8247.0,7:38,11,13,24,45.83,2,4,4,3,1,0,0,0,505.0,0:28,0,0,0,9.0,0:0,874125
8477471,Dillon,Heatherington,1995-05-09,D,L,2018-19,5,0,1,1,0.2,4,5,0.0,0,3056.0,10:11,0,0,0,0.0,6,2,0,3,-3,0,0,0,15.0,0:3,0,0,0,0.0,0:0,650000
8477472,Carl,Dahlstrom,1995-01-28,D,L,2018-19,38,0,6,6,0.16,9,42,0.0,6,42418.0,18:36,0,0,0,0.0,33,35,9,29,-20,0,0,0,44.0,0:1,0,1,1,4295.0,1:53,750833
8477473,Justin,Bailey,1995-07-01,RW,R,2018-19,11,0,1,1,0.09,0,5,0.0,2,3785.0,5:44,0,0,0,0.0,9,5,3,2,1,0,0,0,0.0,0:0,0,0,0,0.0,0:0,715000
8477474,Madison,Bowey,1995-04-22,D,R,2018-19,50,2,8,10,0.2,-1,48,4.17,46,45775.0,15:15,0,0,0,0.0,72,63,9,34,-25,0,0,0,123.0,0:2,0,0,0,2869.0,0:57,1000000
8477476,Artturi,Lehkonen,1995-07-04,LW,L,2018-19,82,11,20,31,0.38,10,176,6.25,32,76543.0,15:33,5,14,19,26.32,120,39,46,28,18,0,0,0,2688.0,0:32,0,0,0,11149.0,2:15,839166
8477478,William,Carrier,1994-12-20,LW,L,2018-19,54,8,1,9,0.17,-4,85,9.41,29,32220.0,9:56,0,0,0,0.0,277,13,31,10,21,0,0,0,205.0,0:3,0,0,0,6.0,0:0,725000
8477479,Tyler,Bertuzzi,1995-02-24,LW,L,2018-19,73,21,26,47,0.64,11,131,16.03,36,72341.0,16:30,10,20,30,33.33,76,39,34,43,-9,3,3,6,7544.0,1:43,0,0,0,71.0,0:0,1400000
8477482,Zach,Sanford,1994-11-09,LW,L,2018-19,60,8,12,20,0.33,8,77,10.39,21,45284.0,12:34,8,5,13,61.54,48,37,31,14,17,0,1,1,612.0,0:10,0,0,0,1962.0,0:32,875000
8477488,Brett,Pesce,1994-11-15,D,R,2018-19,73,7,22,29,0.4,35,98,7.14,24,89751.0,20:29,1,0,1,100.0,53,131,54,30,24,0,0,0,632.0,0:8,0,2,2,10938.0,2:29,4025000
8477492,Nathan,MacKinnon,1995-09-01,C,R,2018-19,82,41,58,99,1.21,20,365,11.23,34,108690.0,22:5,517,666,1183,43.7,54,31,48,64,-16,12,25,37,20126.0,4:5,0,0,0,524.0,0:6,6300000
8477493,Aleksander,Barkov,1995-09-02,C,L,2018-19,82,35,61,96,1.17,-3,206,16.99,8,109981.0,22:21,1041,898,1939,53.69,28,61,100,69,31,13,18,31,17299.0,3:30,0,1,1,10176.0,2:4,5900000
8477494,Jonathan,Drouin,1995-03-28,LW,L,2018-19,81,18,35,53,0.65,-8,190,9.47,26,82286.0,16:55,37,51,88,42.05,55,23,50,48,2,3,13,16,13887.0,2:51,0,0,0,312.0,0:3,5500000
8477495,Seth,Jones,1994-10-03,D,R,2018-19,75,9,37,46,0.61,1,184,4.89,28,116202.0,25:49,0,0,0,0.0,106,133,59,69,-10,0,10,10,10524.0,2:20,0,3,3,10274.0,2:16,5400000
8477496,Elias,Lindholm,1994-12-02,C,R,2018-19,81,27,51,78,0.96,30,182,14.84,20,97387.0,20:2,509,428,937,54.32,82,39,50,46,4,9,17,26,15547.0,3:11,1,3,4,11138.0,2:17,4850000
8477497,Sean,Monahan,1994-10-12,C,L,2018-19,78,34,48,82,1.05,7,211,16.11,12,89176.0,19:3,454,434,888,51.13,36,24,78,58,20,12,11,23,15404.0,3:17,0,0,0,285.0,0:3,6375000
8477498,Darnell,Nurse,1995-02-04,D,L,2018-19,82,10,31,41,0.5,-5,196,5.1,87,117196.0,23:49,0,0,0,0.0,162,146,30,73,-43,1,8,9,9076.0,1:50,0,1,1,9464.0,1:55,3200000
8477499,Rasmus,Ristolainen,1994-10-27,D,R,2018-19,78,5,38,43,0.55,-41,182,2.75,38,115322.0,24:38,0,0,0,0.0,235,121,23,44,-21,1,16,17,14049.0,3:0,0,0,0,10166.0,2:10,5400000
8477500,Bo,Horvat,1995-04-05,C,L,2018-19,82,27,34,61,0.74,-4,227,11.89,33,102511.0,20:50,1083,935,2018,53.67,62,63,28,38,-10,7,11,18,16918.0,3:26,2,1,3,2224.0,0:27,5500000
8477501,Valeri,Nichushkin,1995-03-04,RW,L,2018-19,57,0,10,10,0.18,-4,65,0.0,0,40756.0,11:55,3,3,6,50.0,71,32,24,30,-6,0,0,0,1158.0,0:20,0,0,0,1029.0,0:18,2950000
8477502,Samuel,Morin,1995-07-12,D,L,2018-19,5,0,0,0,0.0,-3,5,0.0,4,3711.0,12:22,0,0,0,0.0,9,7,1,5,-4,0,0,0,1.0,0:0,0,0,0,273.0,0:54,700000
8477503,Max,Domi,1995-03-02,LW,L,2018-19,82,28,44,72,0.88,20,203,13.79,80,85519.0,17:22,447,549,996,44.88,53,39,47,70,-23,4,7,11,12634.0,2:34,0,0,0,272.0,0:3,3150000
8477504,Josh,Morrissey,1995-03-28,D,L,2018-19,59,6,25,31,0.53,9,95,6.32,14,79314.0,22:24,0,0,0,0.0,55,107,33,32,1,3,7,10,6204.0,1:45,1,1,2,9949.0,2:48,3150000
8477505,Alexander,Wennberg,1994-09-22,C,L,2018-19,75,2,23,25,0.33,-1,64,3.12,12,67848.0,15:4,342,364,706,48.44,34,32,34,29,5,1,5,6,8422.0,1:52,1,2,3,5748.0,1:16,4900000
8477506,Ryan,Pulock,1994-10-06,D,R,2018-19,82,9,28,37,0.45,21,180,5.0,22,110029.0,22:21,0,0,0,0.0,143,148,35,68,-33,3,6,9,9237.0,1:52,0,0,0,8691.0,1:45,2000000
8477507,Nikita,Zadorov,1995-04-16,D,L,2018-19,70,7,7,14,0.2,19,100,7.0,75,72256.0,17:12,0,0,0,0.0,228,67,21,32,-11,0,0,0,294.0,0:4,0,0,0,7067.0,1:40,2150000
8477509,Mirco,Mueller,1995-03-21,D,L,2018-19,53,1,10,11,0.21,-3,39,2.56,17,57469.0,18:4,0,0,0,0.0,75,61,22,35,-13,0,0,0,368.0,0:6,0,0,0,4955.0,1:33,850000
8477510,Kerby,Rychel,1994-10-07,LW,L,2018-19,2,0,0,0,0.0,-1,1,0.0,0,1101.0,9:10,0,1,1,0.0,3,1,0,0,0,0,0,0,30.0,0:15,0,0,0,0.0,0:0,725000
8477511,Anthony,Mantha,1994-09-16,RW,L,2018-19,67,25,23,48,0.72,-8,198,12.63,30,71665.0,17:49,22,28,50,44.0,67,23,37,60,-23,7,6,13,9476.0,2:21,0,0,0,18.0,0:0,3300000
8477512,Frederik,Gauthier,1995-04-26,C,L,2018-19,70,3,11,14,0.2,3,46,6.52,12,35134.0,8:21,240,207,447,53.69,98,28,12,12,0,0,0,0,127.0,0:1,0,0,0,782.0,0:11,675000
8477527,Ross,Johnston,1994-02-18,LW,L,2018-19,17,1,3,4,0.24,3,12,8.33,23,8073.0,7:54,0,1,1,0.0,43,1,2,5,-3,0,0,0,5.0,0:0,0,0,0,35.0,0:2,1000000
8477529,Colby,Cave,1994-12-26,C,L,2018-19,53,3,5,8,0.15,-5,58,5.17,16,39155.0,12:18,200,199,399,50.13,73,18,22,12,10,0,0,0,1455.0,0:27,0,0,0,3062.0,0:57,675000
8477573,Nathan,Walker,1994-02-07,LW,L,2018-19,3,0,1,1,0.33,1,2,0.0,2,1466.0,8:8,0,0,0,0.0,5,0,0,1,-1,0,0,0,73.0,0:24,0,0,0,77.0,0:25,650000
8477680,Josh,Currie,1992-10-29,RW,R,2018-19,21,2,3,5,0.24,2,19,10.53,2,10973.0,8:42,2,3,5,40.0,39,17,3,2,1,0,0,0,63.0,0:3,0,0,0,0.0,0:0,687500
8477810,Joel,Hanley,1991-06-08,D,L,2018-19,16,0,0,0,0.0,0,9,0.0,2,13145.0,13:41,0,0,0,0.0,16,16,3,9,-6,0,0,0,165.0,0:10,0,0,0,461.0,0:28,650000
8477839,Conor,Sheary,1992-06-08,LW,L,2018-19,78,14,20,34,0.44,-18,147,9.52,12,68424.0,14:37,19,15,34,55.88,29,29,35,31,4,4,2,6,7959.0,1:42,0,0,0,129.0,0:1,3000000
8477845,Trevor,van Riemsdyk,1991-07-24,D,R,2018-19,78,3,11,14,0.18,-4,102,2.94,10,70474.0,15:3,0,0,0,0.0,42,84,28,35,-7,0,0,0,272.0,0:3,0,0,0,4831.0,1:1,2300000
8477846,Ryan,Carpenter,1991-01-18,C,R,2018-19,68,5,13,18,0.26,-6,102,4.9,8,51472.0,12:36,161,145,306,52.61,126,17,30,17,13,0,0,0,823.0,0:12,1,1,2,5107.0,1:15,650000
8477850,Christian,Folin,1991-02-09,D,R,2018-19,45,0,6,6,0.13,6,47,0.0,27,42280.0,15:39,1,0,1,100.0,125,78,4,21,-17,0,0,0,69.0,0:1,0,0,0,2691.0,0:59,800000
8477851,Jordan,Oesterle,1992-06-25,D,L,2018-19,71,6,14,20,0.28,-3,77,7.79,12,80497.0,18:53,0,0,0,0.0,58,139,23,50,-27,3,4,7,7545.0,1:46,0,0,0,4444.0,1:2,650000
8477865,Jake,Chelios,1991-03-08,D,L,2018-19,5,0,0,0,0.0,0,5,0.0,2,5162.0,17:12,0,0,0,0.0,7,5,2,4,-2,0,0,0,0.0,0:0,0,0,0,222.0,0:44,650000
8477901,Daniel,Carr,1991-11-01,LW,L,2018-19,6,1,0,1,0.17,-1,11,9.09,0,3537.0,9:49,0,0,0,0.0,9,3,3,2,1,0,0,0,50.0,0:8,0,0,0,0.0,0:0,750000
8477903,Garnet,Hathaway,1991-11-23,RW,R,2018-19,76,11,8,19,0.25,14,77,14.29,56,48001.0,10:31,7,8,15,46.67,200,36,23,29,-6,0,0,0,837.0,0:11,2,0,2,7773.0,1:42,850000
8477919,Frederick,Gaudreau,1993-05-01,C,R,2018-19,55,3,1,4,0.07,1,43,6.98,2,29747.0,9:0,156,167,323,48.3,25,18,13,9,4,0,0,0,75.0,0:1,0,0,0,25.0,0:0,666666
8477922,Melker,Karlsson,1990-07-18,C,R,2018-19,79,12,4,16,0.2,-1,79,15.19,26,54508.0,11:29,15,12,27,55.56,67,39,30,19,11,0,0,0,220.0,0:2,0,0,0,6982.0,1:28,2000000
8477930,Pierre-Edouard,Bellemare,1985-03-06,LW,L,2018-19,76,6,9,15,0.2,2,108,5.56,6,56680.0,12:25,394,326,720,54.72,71,51,38,23,15,0,0,0,353.0,0:4,2,0,2,8874.0,1:56,1450000
8477931,Tomas,Nosek,1992-09-01,LW,L,2018-19,68,8,9,17,0.25,-10,116,6.9,18,50881.0,12:28,82,50,132,62.12,75,23,32,14,18,0,0,0,1618.0,0:23,1,0,1,6968.0,1:42,962500
8477932,Aaron,Ekblad,1996-02-07,D,R,2018-19,82,13,24,37,0.45,1,180,7.22,47,116329.0,23:38,0,0,0,0.0,114,88,47,122,-75,5,5,10,8357.0,1:41,0,0,0,11324.0,2:18,7500000
8477933,Sam,Reinhart,1995-11-06,C,R,2018-19,82,22,43,65,0.79,-10,180,12.22,16,93272.0,18:57,31,56,87,35.63,38,47,39,46,-7,2,13,15,15729.0,3:11,0,0,0,354.0,0:4,3650000
8477934,Leon,Draisaitl,1995-10-27,C,L,2018-19,82,50,55,105,1.28,2,231,21.65,52,111147.0,22:35,677,663,1340,50.52,57,26,71,116,-45,16,13,29,16460.0,3:20,3,0,3,5680.0,1:9,8500000
8477935,Sam,Bennett,1996-06-20,C,L,2018-19,71,13,14,27,0.38,-6,115,11.3,93,56615.0,13:17,50,40,90,55.56,121,27,25,38,-13,4,2,6,6513.0,1:31,0,0,0,817.0,0:11,1950000
8477936,Michael,Dal Colle,1996-06-20,LW,L,2018-19,28,3,4,7,0.25,3,34,8.82,2,20342.0,12:6,0,1,1,0.0,10,8,7,11,-4,0,0,0,353.0,0:12,0,0,0,0.0,0:0,863333
8477937,Jake,Virtanen,1996-08-17,RW,R,2018-19,70,15,10,25,0.36,-4,154,9.74,44,62240.0,14:49,5,10,15,33.33,154,37,46,22,24,2,0,2,5216.0,1:14,0,0,0,104.0,0:1,1250000
8477938,Haydn,Fleury,1996-07-08,D,L,2018-19,20,0,1,1,0.05,4,17,0.0,2,15040.0,12:32,0,0,0,0.0,25,21,3,6,-3,0,0,0,50.0,0:2,0,0,0,412.0,0:20,863333
8477939,William,Nylander,1996-05-01,C,R,2018-19,54,7,20,27,0.5,-4,130,5.38,16,50271.0,15:30,203,165,368,55.16,16,14,28,25,3,1,5,6,6016.0,1:51,0,0,0,151.0,0:2,10277778
8477940,Nikolaj,Ehlers,1996-02-14,LW,L,2018-19,62,21,16,37,0.6,2,158,13.29,15,58632.0,15:45,1,1,2,50.0,27,16,28,17,11,2,5,7,4894.0,1:18,0,0,0,22.0,0:0,6000000
8477941,Nick,Ritchie,1995-12-05,LW,L,2018-19,60,9,22,31,0.52,6,96,9.38,82,54005.0,15:0,4,8,12,33.33,123,31,20,34,-14,2,7,9,6536.0,1:48,0,0,0,1923.0,0:32,1640000
8477942,Kevin,Fiala,1996-07-22,LW,L,2018-19,83,13,26,39,0.47,-23,174,7.47,36,77882.0,15:38,3,5,8,37.5,42,20,44,68,-24,2,9,11,11077.0,2:13,0,0,0,61.0,0:0,863333
8477943,Brendan,Perlini,1996-04-27,LW,L,2018-19,68,14,7,21,0.31,-17,117,11.97,28,47335.0,11:36,1,6,7,14.29,51,22,11,14,-3,2,2,4,3008.0,0:44,0,0,0,422.0,0:6,863333
8477944,Jakub,Vrana,1996-02-28,LW,L,2018-19,82,24,23,47,0.57,20,161,14.91,27,69078.0,14:2,4,6,10,40.0,47,32,41,50,-9,1,3,4,5597.0,1:8,0,0,0,30.0,0:0,863333
8477945,Julius,Honka,1995-12-03,D,R,2018-19,29,0,4,4,0.14,-2,38,0.0,10,23861.0,13:42,0,1,1,0.0,16,31,4,27,-23,0,0,0,730.0,0:25,0,0,0,422.0,0:14,863333
8477946,Dylan,Larkin,1996-07-30,C,L,2018-19,76,32,41,73,0.96,-6,287,11.15,75,99600.0,21:50,865,722,1587,54.51,80,38,69,100,-31,7,8,15,11218.0,2:27,2,1,3,5982.0,1:18,6100000
8477947,Sonny,Milano,1996-05-12,LW,L,2018-19,8,1,0,1,0.12,0,5,20.0,0,3994.0,8:19,0,0,0,0.0,5,0,0,1,-1,0,0,0,96.0,0:12,0,0,0,0.0,0:0,863333
8477948,Travis,Sanheim,1996-03-29,D,L,2018-19,82,9,26,35,0.43,-4,121,7.44,22,96228.0,19:33,0,0,0,0.0,45,133,20,65,-45,2,3,5,5061.0,1:1,0,0,0,2943.0,0:35,863333
8477949,Alex,Tuch,1996-05-10,RW,R,2018-19,74,20,32,52,0.7,13,180,11.11,8,74267.0,16:43,43,69,112,38.39,92,40,69,51,18,3,3,6,11071.0,2:29,0,0,0,27.0,0:0,925000
8477951,Nick,Schmaltz,1996-02-23,C,R,2018-19,40,7,18,25,0.62,-12,62,11.29,8,42794.0,17:49,104,177,281,37.01,5,12,35,25,10,5,3,8,7351.0,3:3,0,0,0,789.0,0:19,925000
8477952,Robby,Fabbri,1996-01-22,C,L,2018-19,32,2,4,6,0.19,-4,43,4.65,6,24295.0,12:39,4,10,14,28.57,30,8,5,4,1,0,0,0,1721.0,0:53,0,0,0,41.0,0:1,925000
8477953,Kasperi,Kapanen,1996-07-23,RW,R,2018-19,78,20,24,44,0.56,12,174,11.49,27,77741.0,16:36,5,5,10,50.0,92,19,44,38,6,1,2,3,3714.0,0:47,2,0,2,7547.0,1:36,863333
8477955,Jared,McCann,1996-05-31,C,L,2018-19,78,19,16,35,0.45,-1,150,12.67,31,67980.0,14:31,275,320,595,46.22,77,51,35,44,-9,1,2,3,3810.0,0:48,4,0,4,5519.0,1:10,1250000
8477956,David,Pastrnak,1996-05-25,RW,R,2018-19,66,38,43,81,1.23,6,235,16.17,32,74265.0,18:45,1,2,3,33.33,57,25,36,90,-54,17,16,33,13338.0,3:22,0,0,0,159.0,0:2,6666667
8477957,Nikita,Scherbak,1995-12-30,RW,L,2018-19,8,1,0,1,0.12,-4,12,8.33,2,4885.0,10:10,0,0,0,0.0,9,1,0,1,-1,0,0,0,35.0,0:4,0,0,0,0.0,0:0,863333
8477958,Nikolay,Goldobin,1995-10-07,RW,L,2018-19,63,7,20,27,0.43,-10,105,6.67,18,56661.0,14:59,0,0,0,0.0,15,21,20,33,-13,1,8,9,9669.0,2:33,0,1,1,172.0,0:2,863333
8477959,Joshua,Ho-Sang,1996-01-22,RW,R,2018-19,10,1,1,2,0.2,2,10,10.0,6,8714.0,14:31,0,1,1,0.0,0,3,3,6,-3,0,0,0,1150.0,1:55,0,0,0,0.0,0:0,863333
8477960,Adrian,Kempe,1996-09-13,LW,L,2018-19,81,12,16,28,0.35,-10,118,10.17,50,70471.0,14:30,315,424,739,42.63,86,21,20,24,-4,0,4,4,6564.0,1:21,0,0,0,2654.0,0:32,894167
8477961,John,Quenneville,1996-04-16,C,L,2018-19,19,1,0,1,0.05,-1,16,6.25,4,12899.0,11:18,4,7,11,36.36,21,7,5,4,1,0,0,0,1153.0,1:0,0,0,0,7.0,0:0,811667
8477962,Brendan,Lemieux,1996-03-15,LW,L,2018-19,63,12,5,17,0.27,6,67,17.91,108,34200.0,9:2,7,13,20,35.0,129,31,13,14,-1,0,0,0,1156.0,0:18,0,0,0,189.0,0:3,839167
8477963,Jayce,Hawryluk,1996-01-01,C,R,2018-19,42,7,5,12,0.29,-8,35,20.0,16,23766.0,9:25,14,5,19,73.68,101,25,10,21,-11,0,1,1,353.0,0:8,0,0,0,0.0,0:0,925000
8477964,Ivan,Barbashev,1995-12-14,C,L,2018-19,80,14,12,26,0.32,-4,60,23.33,17,55268.0,11:30,201,240,441,45.58,86,31,36,14,22,0,0,0,241.0,0:3,2,0,2,7581.0,1:34,741667
8477969,Marcus,Pettersson,1996-05-08,D,L,2018-19,84,2,23,25,0.3,17,87,2.3,66,84077.0,16:40,1,0,1,100.0,101,108,24,43,-19,1,4,5,4321.0,0:51,0,1,1,4130.0,0:49,794167
8477971,Andreas,Englund,1996-01-21,D,L,2018-19,3,0,0,0,0.0,-2,2,0.0,10,2400.0,13:20,0,0,0,0.0,5,2,0,2,-2,0,0,0,6.0,0:2,0,0,0,123.0,0:41,775833
8477972,Josh,Jacobs,1996-02-15,D,R,2018-19,1,0,0,0,0.0,-1,1,0.0,0,894.0,14:54,0,0,0,0.0,2,1,0,3,-3,0,0,0,0.0,0:0,0,0,0,0.0,0:0,725833
8477973,Vladislav,Kamenev,1996-08-12,C,L,2018-19,23,2,3,5,0.22,-2,22,9.09,10,12474.0,9:2,59,59,118,50.0,20,4,2,5,-3,1,0,1,1378.0,0:59,1,0,1,940.0,0:40,833333
8477979,Nicolas,Aube-Kubel,1996-05-10,RW,R,2018-19,9,0,0,0,0.0,1,2,0.0,0,3018.0,5:35,0,0,0,0.0,14,0,2,0,2,0,0,0,26.0,0:2,0,0,0,0.0,0:0,680833
8477986,Brandon,Montour,1994-04-11,D,R,2018-19,82,8,27,35,0.43,-20,181,4.42,56,110447.0,22:26,0,0,0,0.0,99,121,31,74,-43,1,5,6,8932.0,1:48,0,0,0,8203.0,1:40,3387500
8477987,Ryan,Donato,1996-04-09,C,L,2018-19,56,10,15,25,0.45,-15,139,7.19,6,46028.0,13:41,11,17,28,39.29,24,21,30,22,8,3,5,8,6963.0,2:4,0,0,0,20.0,0:0,900000
8477989,Christian,Dvorak,1996-02-02,C,L,2018-19,20,2,5,7,0.35,-2,25,8.0,2,17262.0,14:23,125,101,226,55.31,16,7,12,14,-2,1,0,1,1598.0,1:19,0,0,0,56.0,0:2,839167
8477994,Dominic,Turgeon,1996-02-25,C,L,2018-19,4,0,0,0,0.0,-3,2,0.0,0,3021.0,12:35,8,13,21,38.1,3,3,1,0,1,0,0,0,0.0,0:0,0,0,0,405.0,1:41,686667
8477996,Juho,Lammikko,1996-01-29,RW,L,2018-19,40,0,6,6,0.15,-7,39,0.0,6,26236.0,10:55,142,190,332,42.77,45,21,12,12,0,0,0,0,182.0,0:4,0,1,1,4143.0,1:43,717500
8477998,Warren,Foegele,1996-04-01,LW,L,2018-19,77,10,5,15,0.19,-17,106,9.43,20,57721.0,12:29,10,11,21,47.62,126,19,36,31,5,0,0,0,465.0,0:6,0,0,0,5977.0,1:17,746667
8478010,Brayden,Point,1996-03-13,C,R,2018-19,79,41,51,92,1.16,27,191,21.47,28,89676.0,18:55,435,421,856,50.82,31,43,35,25,10,20,15,35,15958.0,3:22,0,0,0,455.0,0:5,686667
8478017,Mark,Friedman,1995-12-25,D,R,2018-19,1,0,0,0,0.0,-1,1,0.0,0,753.0,12:33,0,0,0,0.0,1,0,0,0,0,0,0,0,0.0,0:0,0,0,0,0.0,0:0,749167
8478020,Michael,Amadio,1996-05-13,C,R,2018-19,43,6,7,13,0.3,-1,37,16.22,6,26332.0,10:12,96,127,223,43.05,16,13,19,13,6,0,0,0,1664.0,0:38,0,0,0,9.0,0:0,717500
8478027,Lucas,Wallmark,1995-09-05,C,L,2018-19,81,10,18,28,0.35,-8,131,7.63,36,71889.0,14:47,575,554,1129,50.93,82,39,33,32,1,2,5,7,6038.0,1:14,0,0,0,4261.0,0:52,675000
8478029,Chase,De Leo,1995-10-25,C,L,2018-19,1,0,0,0,0.0,1,4,0.0,0,752.0,12:32,0,0,0,0.0,1,0,0,0,0,0,0,0,0.0,0:0,0,0,0,31.0,0:31,650000
8478031,Nelson,Nogier,1996-05-27,D,R,2018-19,1,0,0,0,0.0,0,1,0.0,0,606.0,10:6,0,0,0,0.0,0,1,0,0,0,0,0,0,0.0,0:0,0,0,0,0.0,0:0,713333
8478036,Christoffer,Ehn,1996-04-05,C,L,2018-19,60,3,6,9,0.15,-5,49,6.12,6,38211.0,10:36,84,93,177,47.46,70,39,10,15,-5,0,0,0,44.0,0:0,1,0,1,2768.0,0:46,759167
8478038,Devon,Toews,1994-02-21,D,L,2018-19,48,5,13,18,0.38,7,81,6.17,4,51539.0,17:53,0,1,1,0.0,24,30,14,28,-14,1,3,4,5107.0,1:46,0,0,0,195.0,0:4,700000
8478042,Viktor,Arvidsson,1993-04-08,LW,R,2018-19,58,34,14,48,0.83,12,195,17.44,26,66627.0,19:8,2,15,17,11.76,18,23,41,37,4,3,1,4,10121.0,2:54,2,1,3,4451.0,1:16,4250000
8478046,Danton,Heinen,1995-07-05,C,L,2018-19,77,11,23,34,0.44,13,114,9.65,16,64544.0,13:58,2,10,12,16.67,54,36,43,32,11,1,6,7,6336.0,1:22,0,0,0,594.0,0:7,872500
8478047,Michael,Bunting,1995-09-17,LW,L,2018-19,5,1,0,1,0.2,0,5,20.0,2,2867.0,9:33,0,0,0,0.0,6,1,0,0,0,0,0,0,0.0,0:0,0,0,0,0.0,0:0,715000
8478055,Gustav,Forsling,1996-06-12,D,L,2018-19,43,3,6,9,0.21,-9,57,5.26,30,44075.0,17:5,0,0,0,0.0,38,38,15,23,-8,0,0,0,558.0,0:12,0,0,0,2803.0,1:5,872500
8478056,Clark,Bishop,1996-03-29,C,L,2018-19,20,1,2,3,0.15,-3,16,6.25,6,11348.0,9:27,69,78,147,46.94,39,5,5,5,0,0,0,0,176.0,0:8,0,0,0,245.0,0:12,695000
8478067,Oskar,Lindblom,1996-08-15,LW,L,2018-19,81,17,16,33,0.41,-9,162,10.49,20,66795.0,13:44,3,7,10,30.0,68,52,26,28,-2,2,1,3,5256.0,1:4,0,0,0,3958.0,0:48,925000
8478075,Anders,Bjork,1996-08-05,LW,L,2018-19,20,1,2,3,0.15,-1,18,5.56,2,14159.0,11:47,1,0,1,100.0,9,12,11,9,2,0,0,0,1012.0,0:50,0,0,0,81.0,0:4,925000
8478078,Rourke,Chartier,1996-04-03,C,L,2018-19,13,1,0,1,0.08,-5,19,5.26,2,7334.0,9:24,34,51,85,40.0,14,3,0,1,-1,0,0,0,24.0,0:1,0,0,0,311.0,0:23,672500
8478099,Kevin,Labanc,1995-12-12,RW,R,2018-19,82,17,39,56,0.68,-1,130,13.08,36,68977.0,14:1,9,14,23,39.13,66,16,22,51,-29,2,18,20,11431.0,2:19,0,0,0,59.0,0:0,717500
8478104,Sammy,Blais,1996-06-17,LW,L,2018-19,32,2,2,4,0.12,-1,27,7.41,6,18918.0,9:51,1,1,2,50.0,93,12,11,11,0,0,0,0,374.0,0:11,0,0,0,0.0,0:0,673333
8478106,Dylan,Sikura,1995-06-01,RW,L,2018-19,33,0,8,8,0.24,2,52,0.0,0,22339.0,11:16,0,5,5,0.0,3,10,23,7,16,0,0,0,26.0,0:0,0,0,0,0.0,0:0,925000
8478109,Victor,Olofsson,1995-07-18,RW,L,2018-19,6,2,2,4,0.67,1,21,9.52,2,6486.0,18:1,0,0,0,0.0,2,3,1,3,-2,2,0,2,675.0,1:52,0,0,0,18.0,0:3,767500
8478131,Ondrej,Kase,1995-11-08,RW,R,2018-19,30,11,9,20,0.67,0,94,11.7,2,28184.0,15:39,9,18,27,33.33,17,11,15,18,-3,1,3,4,3947.0,2:11,0,0,0,46.0,0:1,2600000
8478176,Joe,Hicketts,1996-05-04,D,L,2018-19,11,0,0,0,0.0,-9,16,0.0,0,12269.0,18:35,0,0,0,0.0,17,27,2,7,-5,0,0,0,31.0,0:2,0,0,0,1724.0,2:36,636111
8478211,Dryden,Hunt,1995-11-24,LW,L,2018-19,31,3,7,10,0.32,0,53,5.66,8,20576.0,11:3,0,3,3,0.0,65,9,10,8,2,0,0,0,120.0,0:3,0,0,0,29.0,0:0,809167
8478233,Andrew,Mangiapane,1996-04-04,LW,L,2018-19,44,8,5,13,0.3,11,65,12.31,12,27836.0,10:32,6,3,9,66.67,43,17,16,11,5,0,0,0,1192.0,0:27,0,0,0,154.0,0:3,705000
8478268,Jack,Rodewald,1994-02-14,RW,R,2018-19,6,0,0,0,0.0,0,2,0.0,0,2542.0,7:3,0,0,0,0.0,8,3,0,0,0,0,0,0,2.0,0:0,0,0,0,0.0,0:0,706250
8478365,Danick,Martel,1994-12-12,LW,L,2018-19,9,0,2,2,0.22,3,16,0.0,8,5496.0,10:10,1,1,2,50.0,12,1,3,1,2,0,0,0,9.0,0:1,0,0,0,82.0,0:9,715000
8478366,Frank,Vatrano,1994-03-14,C,L,2018-19,81,24,15,39,0.48,-10,208,11.54,38,71259.0,14:39,15,23,38,39.47,139,74,33,30,3,2,6,8,8088.0,1:39,0,0,0,110.0,0:1,925000
8478373,Nikita,Soshnikov,1993-10-14,RW,L,2018-19,5,0,0,0,0.0,-1,1,0.0,0,2150.0,7:10,0,0,0,0.0,5,2,0,1,-1,0,0,0,8.0,0:1,0,0,0,0.0,0:0,800000
8478396,Noah,Hanifin,1997-01-25,D,L,2018-19,80,5,28,33,0.41,18,116,4.31,12,99712.0,20:46,0,0,0,0.0,87,83,50,87,-37,1,4,5,5285.0,1:6,1,1,2,8212.0,1:42,4950000
8478397,Rasmus,Andersson,1996-10-27,D,R,2018-19,79,2,17,19,0.24,17,115,1.74,23,76027.0,16:2,0,0,0,0.0,52,83,24,45,-21,0,2,2,4750.0,1:0,0,0,0,1751.0,0:22,755833
8478398,Kyle,Connor,1996-12-09,LW,L,2018-19,82,34,32,66,0.8,-7,227,14.98,18,94723.0,19:15,8,5,13,61.54,9,21,56,33,23,11,8,19,17134.0,3:28,1,0,1,3355.0,0:40,925000
8478399,Jonas,Siegenthaler,1997-05-06,D,L,2018-19,26,0,4,4,0.15,6,12,0.0,10,22079.0,14:9,0,0,0,0.0,31,44,3,20,-17,0,0,0,13.0,0:0,0,0,0,1642.0,1:3,714166
8478400,Colin,White,1997-01-30,C,R,2018-19,71,14,27,41,0.58,-24,123,11.38,24,69006.0,16:11,379,420,799,47.43,23,35,21,38,-17,5,3,8,9029.0,2:7,0,0,0,912.0,0:12,925000
8478401,Pavel,Zacha,1997-04-06,C,L,2018-19,61,13,12,25,0.41,-6,99,13.13,15,58851.0,16:4,348,364,712,48.88,68,24,28,31,-3,4,2,6,6181.0,1:41,2,1,3,7987.0,2:10,894167
8478402,Connor,McDavid,1997-01-13,C,L,2018-19,78,41,75,116,1.49,3,240,17.08,20,106878.0,22:50,428,490,918,46.62,39,30,99,89,10,9,24,33,16013.0,3:25,1,1,2,2928.0,0:37,12500000
8478403,Jack,Eichel,1996-10-28,C,R,2018-19,77,28,54,82,1.06,-11,303,9.24,26,94439.0,20:26,597,673,1270,47.01,70,51,38,76,-38,8,18,26,16283.0,3:31,0,0,0,2455.0,0:31,10000000
8478407,Vince,Dunn,1996-10-29,D,L,2018-19,78,12,23,35,0.45,14,150,8.0,45,82052.0,17:31,0,1,1,0.0,48,68,18,49,-31,3,5,8,9899.0,2:6,0,0,0,501.0,0:6,722500
8478408,Travis,Dermott,1996-12-22,D,L,2018-19,64,4,13,17,0.27,-5,98,4.08,22,66458.0,17:18,0,0,0,0.0,100,57,26,55,-29,0,0,0,504.0,0:7,0,0,0,4043.0,1:3,863333
8478413,Jordan,Greenway,1997-02-16,LW,L,2018-19,81,12,12,24,0.3,-12,109,11.01,29,66235.0,13:37,31,50,81,38.27,57,40,34,20,14,0,0,0,3203.0,0:39,0,0,0,129.0,0:1,916666
8478414,Timo,Meier,1996-10-08,RW,L,2018-19,78,30,36,66,0.85,9,250,12.0,55,79432.0,16:58,12,26,38,31.58,99,40,49,38,11,6,4,10,8452.0,1:48,0,1,1,2408.0,0:30,894167
8478415,Jakub,Zboril,1997-02-21,D,L,2018-19,2,0,0,0,0.0,0,1,0.0,0,1312.0,10:56,0,0,0,0.0,3,0,0,2,-2,0,0,0,0.0,0:0,0,0,0,4.0,0:2,863333
8478416,Erik,Cernak,1997-05-28,D,R,2018-19,58,5,11,16,0.28,25,107,4.67,58,66993.0,19:15,0,0,0,0.0,198,79,11,19,-8,1,0,1,295.0,0:5,0,0,0,8272.0,2:22,697500
8478417,Jakob,Forsbacka Karlsson,1996-10-31,C,R,2018-19,28,3,6,9,0.32,1,21,14.29,2,19813.0,11:47,95,131,226,42.04,14,9,9,4,5,0,1,1,601.0,0:21,0,0,0,465.0,0:16,916667
8478420,Mikko,Rantanen,1996-10-29,RW,L,2018-19,74,31,56,87,1.18,13,193,16.06,54,92538.0,20:50,17,29,46,36.96,59,41,39,35,4,16,17,33,18162.0,4:5,0,0,0,91.0,0:1,894167
8478421,A.J.,Greer,1996-12-14,LW,L,2018-19,15,1,1,2,0.13,-2,9,11.11,14,5641.0,6:16,2,3,5,40.0,20,5,4,1,3,0,0,0,0.0,0:0,0,0,0,0.0,0:0,741666
8478425,Brendan,Guhle,1997-07-29,D,L,2018-19,8,0,1,1,0.12,-2,15,0.0,4,7207.0,15:0,0,0,0,0.0,9,7,1,1,0,0,0,0,492.0,1:1,0,0,0,4.0,0:0,697500
8478427,Sebastian,Aho,1997-07-26,RW,L,2018-19,82,30,53,83,1.01,25,243,12.35,26,99142.0,20:9,585,619,1204,48.59,65,34,81,64,17,3,21,24,14765.0,3:0,4,1,5,5484.0,1:6,925000
8478430,Oliver,Kylington,1997-05-19,D,L,2018-19,38,3,5,8,0.21,3,21,14.29,10,28322.0,12:25,0,0,0,0.0,11,41,13,32,-19,0,0,0,44.0,0:1,0,0,0,79.0,0:2,730833
8478432,Christian,Fischer,1997-04-15,RW,R,2018-19,71,11,7,18,0.25,-13,116,9.48,27,56102.0,13:10,2,5,7,28.57,124,19,12,12,0,0,0,0,7013.0,1:38,0,0,0,47.0,0:0,821666
8478439,Travis,Konecny,1997-03-11,C,R,2018-19,82,24,25,49,0.6,-4,182,13.19,40,75080.0,15:15,7,15,22,31.82,65,45,38,49,-11,4,4,8,7966.0,1:37,0,0,0,60.0,0:0,894167
8478440,Dylan,Strome,1997-03-07,C,L,2018-19,78,20,37,57,0.73,-8,145,13.79,20,75602.0,16:9,434,463,897,48.38,13,46,47,34,13,6,10,16,14018.0,2:59,0,0,0,110.0,0:1,863333
8478442,Cooper,Marody,1996-12-20,C,R,2018-19,6,0,0,0,0.0,-1,6,0.0,0,2488.0,6:54,9,17,26,34.62,0,0,5,0,5,0,0,0,33.0,0:5,0,0,0,0.0,0:0,925000
8478443,Brandon,Carlo,1996-11-26,D,R,2018-19,72,2,8,10,0.14,22,116,1.72,47,90386.0,20:55,1,0,1,100.0,134,88,43,42,1,0,0,0,242.0,0:3,0,2,2,11997.0,2:46,789167
8478444,Brock,Boeser,1997-02-25,RW,R,2018-19,69,26,30,56,0.81,-2,209,12.44,22,79338.0,19:9,39,51,90,43.33,14,22,40,33,7,6,9,15,14650.0,3:32,0,0,0,111.0,0:1,925000
8478445,Mathew,Barzal,1997-05-26,C,R,2018-19,82,18,44,62,0.76,-5,179,10.06,46,88181.0,17:55,241,339,580,41.55,25,56,66,117,-51,3,15,18,14462.0,2:56,0,0,0,330.0,0:4,863333
8478449,Roope,Hintz,1996-11-17,LW,L,2018-19,58,9,13,22,0.38,-11,99,9.09,24,48916.0,14:3,217,183,400,54.25,87,36,33,23,10,3,3,6,6138.0,1:45,0,0,0,955.0,0:16,811667
8478452,Caleb,Jones,1997-06-06,D,L,2018-19,17,1,5,6,0.35,-9,21,4.76,6,20193.0,19:47,0,0,0,0.0,20,18,13,17,-4,0,1,1,700.0,0:41,0,0,0,1144.0,1:7,720000
8478454,Noah,Juulsen,1997-04-02,D,R,2018-19,21,1,4,5,0.24,5,22,4.55,6,21565.0,17:6,0,0,0,0.0,60,39,6,17,-11,0,0,0,39.0,0:1,0,0,0,2677.0,2:7,863333
8478455,Austin,Wagner,1997-06-23,LW,L,2018-19,62,12,9,21,0.34,2,67,17.91,16,33216.0,8:55,2,4,6,33.33,142,9,8,18,-10,0,0,0,198.0,0:3,0,0,0,0.0,0:0,759167
8478458,Jack,Roslovic,1997-01-29,C,R,2018-19,77,9,15,24,0.31,-2,74,12.16,4,45014.0,9:44,91,118,209,43.54,32,21,25,18,7,5,2,7,2826.0,0:36,0,0,0,21.0,0:0,894166
8478460,Zach,Werenski,1997-07-19,D,L,2018-19,82,11,33,44,0.54,-12,168,6.55,18,112666.0,22:53,0,0,0,0.0,67,89,40,46,-6,2,13,15,12072.0,2:27,0,0,0,6345.0,1:17,925000
8478462,Nicolas,Roy,1997-02-05,C,R,2018-19,6,0,0,0,0.0,0,1,0.0,2,2502.0,6:57,21,18,39,53.85,7,1,3,1,2,0,0,0,0.0,0:0,0,0,0,35.0,0:5,720000
8478463,Anthony,Beauvillier,1997-06-08,C,L,2018-19,81,18,10,28,0.35,1,156,11.54,8,71161.0,14:38,26,31,57,45.61,87,35,34,30,4,1,1,2,8038.0,1:39,0,0,0,22.0,0:0,894167
8478465,Guillaume,Brisebois,1997-07-21,D,L,2018-19,8,0,0,0,0.0,-4,5,0.0,0,5284.0,11:0,0,0,0,0.0,3,7,2,7,-5,0,0,0,17.0,0:2,0,0,0,0.0,0:0,697500
8478466,Daniel,Sprong,1997-03-17,RW,R,2018-19,63,14,9,23,0.37,-16,125,11.2,10,45187.0,11:57,4,10,14,28.57,35,14,18,32,-14,2,3,5,4767.0,1:15,0,0,0,15.0,0:0,750000
8478468,Jeremy,Lauzon,1997-04-28,D,L,2018-19,16,1,0,1,0.06,-1,11,9.09,2,14917.0,15:32,0,0,0,0.0,15,15,4,5,-1,0,0,0,31.0,0:1,0,0,0,2059.0,2:8,747500
8478469,Thomas,Chabot,1997-01-30,D,L,2018-19,70,14,41,55,0.79,-12,185,7.57,32,102013.0,24:17,0,0,0,0.0,71,112,31,72,-41,1,15,16,12341.0,2:56,1,0,1,2501.0,0:35,863333
8478472,Mathieu,Joseph,1997-02-09,RW,L,2018-19,70,13,13,26,0.37,5,95,13.68,26,47706.0,11:21,10,24,34,29.41,129,14,28,24,4,0,0,0,895.0,0:12,0,2,2,2902.0,0:41,728333
8478474,Lawson,Crouse,1997-06-23,LW,L,2018-19,81,11,14,25,0.31,5,131,8.4,67,62925.0,12:56,24,34,58,41.38,288,44,25,23,2,0,0,0,402.0,0:4,2,0,2,6287.0,1:17,894167
8478476,Kyle,Capobianco,1997-08-13,D,L,2018-19,2,0,0,0,0.0,-2,1,0.0,0,1929.0,16:4,0,0,0,0.0,2,2,0,0,0,0,0,0,195.0,1:37,0,0,0,0.0,0:0,745000
8478483,Mitchell,Marner,1997-05-05,C,R,2018-19,82,26,68,94,1.15,22,233,11.16,22,97526.0,19:49,7,4,11,63.64,29,43,78,67,11,3,18,21,12737.0,2:35,1,2,3,6669.0,1:21,894167
8478485,Zach,Senyshyn,1997-03-30,RW,R,2018-19,2,1,0,1,0.5,0,4,25.0,0,1391.0,11:35,0,0,0,0.0,1,0,0,1,-1,0,0,0,0.0,0:0,0,0,0,42.0,0:21,863333
8478488,Filip,Chlapik,1997-06-03,C,L,2018-19,5,1,0,1,0.2,-2,9,11.11,4,4159.0,13:51,8,16,24,33.33,1,4,2,2,0,0,0,0,491.0,1:38,0,0,0,0.0,0:0,728333
8478491,Jacob,Larsson,1997-04-29,D,L,2018-19,49,0,5,5,0.1,-4,57,0.0,16,50317.0,17:6,0,1,1,0.0,41,59,10,30,-20,0,0,0,132.0,0:2,0,0,0,3628.0,1:14,894166
8478493,Joel,Eriksson Ek,1997-01-29,C,L,2018-19,58,7,7,14,0.24,-7,111,6.31,20,47007.0,13:30,247,293,540,45.74,117,24,18,9,9,0,0,0,571.0,0:9,0,0,0,4765.0,1:22,894167
8478495,Denis,Gurianov,1997-06-07,RW,L,2018-19,21,1,3,4,0.19,-3,23,4.35,0,13699.0,10:52,1,1,2,50.0,23,9,2,5,-3,0,1,1,1387.0,1:6,0,0,0,57.0,0:2,894166
8478498,Jake,DeBrusk,1996-10-17,LW,L,2018-19,68,27,15,42,0.62,2,156,17.31,18,65940.0,16:9,8,30,38,21.05,45,24,42,27,15,8,3,11,10874.0,2:39,0,0,0,924.0,0:13,863333
8478500,Ivan,Provorov,1997-01-13,D,L,2018-19,82,7,19,26,0.32,-16,145,4.83,32,123551.0,25:6,0,1,1,0.0,123,149,16,92,-76,0,2,2,7644.0,1:33,0,0,0,14293.0,2:54,894167
8478506,Gabriel,Carlsson,1997-01-02,D,L,2018-19,1,0,0,0,0.0,-1,1,0.0,2,561.0,9:21,0,0,0,0.0,0,0,1,0,1,0,0,0,0.0,0:0,0,0,0,59.0,0:59,894166
8478512,Austin,Czarnik,1992-12-12,C,R,2018-19,54,6,12,18,0.33,-1,65,9.23,8,36718.0,11:19,30,34,64,46.88,10,24,24,15,9,0,3,3,4198.0,1:17,0,0,0,307.0,0:5,1250000
8478519,Anthony,Cirelli,1997-07-15,C,L,2018-19,82,19,20,39,0.48,25,123,15.45,34,73047.0,14:50,502,449,951,52.79,94,49,47,15,32,0,1,1,1457.0,0:17,5,1,6,13359.0,2:42,728333
8478541,Markus,Hannikainen,1993-03-26,LW,L,2018-19,44,4,3,7,0.16,-5,52,7.69,2,25022.0,9:28,0,3,3,0.0,63,8,15,1,14,0,0,0,164.0,0:3,0,0,0,431.0,0:9,675000
8478542,Evan,Rodrigues,1993-07-28,LW,R,2018-19,74,9,20,29,0.39,-7,168,5.36,25,70257.0,15:49,304,351,655,46.41,33,33,34,39,-5,2,2,4,6032.0,1:21,0,3,3,7412.0,1:40,650000
8478550,Artemi,Panarin,1991-10-30,LW,R,2018-19,79,28,59,87,1.1,14,191,14.66,23,94120.0,19:51,1,3,4,25.0,14,17,31,56,-25,6,12,18,13291.0,2:48,0,0,0,204.0,0:2,6000000
8478561,Andreas,Martinsen,1990-06-13,LW,L,2018-19,24,1,3,4,0.17,-5,21,4.76,14,11426.0,7:56,3,4,7,42.86,83,9,3,7,-4,0,0,0,30.0,0:1,0,0,0,338.0,0:14,650000
8478567,Dean,Kukan,1993-07-08,D,L,2018-19,25,0,5,5,0.2,6,16,0.0,6,20198.0,13:27,0,0,0,0.0,16,21,4,5,-1,0,0,0,25.0,0:1,0,0,0,34.0,0:1,725000
8478569,Noel,Acciari,1991-12-01,C,R,2018-19,72,6,8,14,0.19,-3,99,6.06,47,56099.0,12:59,200,203,403,49.63,221,36,35,13,22,0,0,0,185.0,0:2,0,0,0,6762.0,1:33,725000
8478585,Derek,Ryan,1986-12-29,C,R,2018-19,81,13,25,38,0.47,21,103,12.62,24,67087.0,13:48,440,316,756,58.2,19,19,54,54,0,2,5,7,8186.0,1:41,0,4,4,9416.0,1:56,3125000
8478831,Kevin,Stenlund,1996-09-20,C,R,2018-19,4,0,0,0,0.0,0,3,0.0,4,2631.0,10:57,3,3,6,50.0,3,1,3,1,2,0,0,0,5.0,0:1,0,0,0,0.0,0:0,864166
8478840,William,Borgen,1996-12-19,D,R,2018-19,4,0,0,0,0.0,-5,2,0.0,0,3972.0,16:33,0,0,0,0.0,12,3,0,0,0,0,0,0,0.0,0:0,0,0,0,178.0,0:44,864166
8478841,Colton,White,1997-05-03,D,L,2018-19,3,0,0,0,0.0,-2,1,0.0,2,2561.0,14:13,0,0,0,0.0,2,2,0,1,-1,0,0,0,56.0,0:18,0,0,0,10.0,0:3,728333
8478843,Denis,Malgin,1997-01-18,C,R,2018-19,50,7,9,16,0.32,-10,66,10.61,14,38668.0,12:53,36,56,92,39.13,40,21,16,15,1,0,1,1,1514.0,0:30,0,0,0,1629.0,0:32,690000
8478846,Christian,Wolanin,1995-03-17,D,L,2018-19,30,4,8,12,0.4,3,36,11.11,6,31186.0,17:19,0,0,0,0.0,11,31,15,25,-10,0,3,3,3366.0,1:52,0,0,0,102.0,0:3,925000
8478856,Conor,Garland,1996-03-11,RW,R,2018-19,47,13,5,18,0.38,1,118,11.02,12,36068.0,12:47,10,8,18,55.56,33,17,25,10,15,4,2,6,6743.0,2:23,0,0,0,1.0,0:0,680556
8478866,Dominik,Simon,1994-08-08,C,L,2018-19,71,8,20,28,0.39,8,121,6.61,18,56764.0,13:19,6,13,19,31.58,89,19,33,33,0,1,2,3,3492.0,0:49,0,0,0,19.0,0:0,750000
8478868,Christian,Jaros,1996-04-02,D,R,2018-19,61,1,9,10,0.16,-14,65,1.54,27,52584.0,14:22,0,0,0,0.0,110,82,17,40,-23,0,2,2,1089.0,0:17,0,0,0,2165.0,0:35,755000
8478870,Rudolfs,Balcers,1997-04-08,LW,L,2018-19,36,5,9,14,0.39,-7,48,10.42,10,26685.0,12:21,1,6,7,14.29,18,24,11,15,-4,3,1,4,3111.0,1:26,0,0,0,485.0,0:13,759167
8478873,Troy,Terry,1997-09-10,RW,R,2018-19,32,4,9,13,0.41,8,25,16.0,2,26776.0,13:56,1,4,5,20.0,4,12,14,16,-2,2,4,6,3613.0,1:52,0,0,0,75.0,0:2,925000
8478874,Adam,Gaudette,1996-10-03,C,R,2018-19,56,5,7,12,0.21,-8,55,9.09,18,36789.0,10:56,150,221,371,40.43,48,15,10,7,3,0,2,2,4596.0,1:22,0,0,0,5.0,0:0,916667
8478881,Brett,Seney,1996-02-28,LW,L,2018-19,51,5,8,13,0.25,-14,49,10.2,31,31604.0,10:19,98,162,260,37.69,48,15,17,17,0,0,1,1,511.0,0:10,0,0,0,152.0,0:2,757500
8478891,Mason,Appleton,1996-01-15,C,R,2018-19,36,3,7,10,0.28,9,29,10.34,4,17721.0,8:12,0,1,1,0.0,28,12,4,5,-1,0,0,0,89.0,0:2,0,0,0,531.0,0:14,741667
8478906,Markus,Nutivaara,1994-06-06,D,L,2018-19,80,5,16,21,0.26,3,99,5.05,6,84863.0,17:40,0,0,0,0.0,80,61,25,23,2,0,0,0,800.0,0:10,0,0,0,788.0,0:9,2700000
8478911,Matt,Roy,1995-03-01,D,R,2018-19,25,2,4,6,0.24,-1,34,5.88,8,25696.0,17:7,0,0,0,0.0,38,47,4,17,-13,0,0,0,225.0,0:9,0,0,0,2271.0,1:30,833750
8478915,Sami,Niku,1996-10-10,D,L,2018-19,30,1,3,4,0.13,0,19,5.26,2,25052.0,13:55,0,0,0,0.0,10,30,3,11,-8,0,0,0,179.0,0:5,0,0,0,34.0,0:1,775000
8478949,Kole,Sherwood,1997-01-22,RW,R,2018-19,2,0,0,0,0.0,0,2,0.0,0,1107.0,9:13,0,0,0,0.0,10,1,1,0,1,0,0,0,97.0,0:48,0,0,0,0.0,0:0,694444
8479026,Philippe,Myers,1997-01-25,D,R,2018-19,21,1,1,2,0.1,-5,25,4.0,2,19362.0,15:22,0,0,0,0.0,42,8,7,13,-6,0,0,0,142.0,0:6,0,0,0,910.0,0:43,678889
8479066,Ryan,Lomberg,1994-12-09,LW,L,2018-19,4,0,0,0,0.0,0,1,0.0,17,1676.0,6:59,0,0,0,0.0,12,0,1,0,1,0,0,0,106.0,0:26,0,0,0,0.0,0:0,710000
8479206,Tanner,Fritz,1991-08-20,C,R,2018-19,8,0,1,1,0.12,-3,6,0.0,2,5195.0,10:49,17,24,41,41.46,18,6,1,1,0,0,0,0,0.0,0:0,0,0,0,167.0,0:20,650000
8479250,Nick,Lappin,1992-11-01,RW,R,2018-19,11,0,0,0,0.0,-6,11,0.0,0,9034.0,13:41,5,1,6,83.33,16,3,3,2,1,0,0,0,791.0,1:11,0,0,0,43.0,0:3,700000
8479268,Casey,Nelson,1992-07-18,D,R,2018-19,38,1,5,6,0.16,1,37,2.7,13,35133.0,15:24,0,0,0,0.0,44,36,5,19,-14,0,0,0,33.0,0:0,0,0,0,2613.0,1:8,812500
8479290,Kalle,Kossila,1993-04-14,C,L,2018-19,8,1,0,1,0.12,-1,11,9.09,4,4946.0,10:18,30,28,58,51.72,5,3,0,2,-2,0,0,0,58.0,0:7,0,0,0,889.0,1:51,650000
8479291,Kevin,Rooney,1993-05-21,C,L,2018-19,41,6,4,10,0.24,-4,39,15.38,15,31028.0,12:36,187,192,379,49.34,77,22,15,9,6,0,0,0,79.0,0:1,1,0,1,4713.0,1:54,700000
8479293,Brandon,Tanev,1991-12-31,LW,L,2018-19,80,14,15,29,0.36,9,127,11.02,41,67729.0,14:6,3,5,8,37.5,278,81,22,18,4,0,0,0,289.0,0:3,2,1,3,10249.0,2:8,1150000
8479314,Matthew,Tkachuk,1997-12-11,LW,L,2018-19,80,34,43,77,0.96,14,207,16.43,62,84475.0,17:35,6,7,13,46.15,104,13,42,56,-14,11,13,24,15329.0,3:11,0,0,0,176.0,0:2,925000
8479315,Joey,Anderson,1998-06-19,RW,R,2018-19,34,4,3,7,0.21,-7,49,8.16,6,26319.0,12:54,9,8,17,52.94,42,11,12,3,9,0,0,0,415.0,0:12,1,0,1,2605.0,1:16,925000
8479316,Luke,Kunin,1997-12-04,C,R,2018-19,49,6,11,17,0.35,-9,88,6.82,27,46703.0,15:53,88,112,200,44.0,67,34,12,15,-3,0,1,1,3765.0,1:16,0,0,0,4260.0,1:26,925000
8479318,Auston,Matthews,1997-09-17,C,L,2018-19,68,37,36,73,1.07,-9,251,14.74,12,75704.0,18:33,475,436,911,52.14,28,60,57,67,-10,12,8,20,10479.0,2:34,0,0,0,124.0,0:1,925000
8479320,Maxime,Lajoie,1997-11-05,D,L,2018-19,56,7,8,15,0.27,-25,79,8.86,20,63523.0,18:54,0,0,0,0.0,34,82,13,48,-35,4,4,8,5532.0,1:38,0,0,0,6216.0,1:51,710000
8479324,Ryan,Lindgren,1998-02-11,D,L,2018-19,5,0,0,0,0.0,-6,8,0.0,8,4376.0,14:35,0,0,0,0.0,11,9,0,2,-2,0,0,0,0.0,0:0,0,0,0,218.0,0:43,925000
8479325,Charlie,McAvoy,1997-12-21,D,R,2018-19,54,7,21,28,0.52,14,79,8.86,45,71840.0,22:10,0,0,0,0.0,92,91,30,54,-24,1,1,2,5105.0,1:34,0,1,1,4208.0,1:17,916667
8479330,Brandon,Gignac,1997-11-07,C,L,2018-19,1,0,0,0,0.0,-2,1,0.0,0,544.0,9:4,0,0,0,0.0,0,1,0,2,-2,0,0,0,0.0,0:0,0,0,0,0.0,0:0,714166
8479333,Libor,Hajek,1998-02-04,D,L,2018-19,5,1,0,1,0.2,1,10,10.0,6,4959.0,16:31,0,0,0,0.0,5,3,4,5,-1,0,0,0,40.0,0:8,0,0,0,272.0,0:54,833333
8479336,Carl,Grundstrom,1997-12-01,RW,L,2018-19,15,5,1,6,0.4,-4,26,19.23,6,13472.0,14:58,0,0,0,0.0,38,3,8,5,3,0,1,1,1807.0,2:0,0,0,0,11.0,0:0,925000
8479337,Alex,DeBrincat,1997-12-18,RW,R,2018-19,82,41,35,76,0.93,0,220,18.64,15,87084.0,17:42,16,19,35,45.71,35,26,51,50,1,13,11,24,16069.0,3:15,0,0,0,552.0,0:6,778333
8479339,Patrik,Laine,1998-04-19,RW,R,2018-19,82,30,20,50,0.61,-24,245,12.24,42,84787.0,17:13,11,19,30,36.67,70,44,28,48,-20,15,8,23,17256.0,3:30,0,0,0,71.0,0:0,925000
8479343,Clayton,Keller,1998-07-29,C,L,2018-19,82,14,33,47,0.57,-21,200,7.0,24,89717.0,18:14,28,56,84,33.33,16,21,46,37,9,1,18,19,17335.0,3:31,0,0,0,701.0,0:8,885833
8479344,Jesse,Puljujarvi,1998-05-07,RW,R,2018-19,46,4,5,9,0.2,-14,53,7.55,16,32991.0,11:57,2,2,4,50.0,46,26,20,29,-9,0,1,1,1231.0,0:26,0,0,0,86.0,0:1,925000
8479345,Jakob,Chychrun,1998-03-31,D,L,2018-19,53,5,15,20,0.38,-12,117,4.27,28,64410.0,20:15,0,0,0,0.0,74,77,20,38,-18,3,5,8,8093.0,2:32,0,0,0,162.0,0:3,925000
8479346,Dillon,Dube,1998-07-20,C,L,2018-19,25,1,4,5,0.2,2,22,4.55,4,15101.0,10:4,16,24,40,40.0,11,3,6,6,0,0,0,0,705.0,0:28,0,0,0,437.0,0:17,778333
8479351,Sam,Steel,1998-02-03,C,L,2018-19,22,6,5,11,0.5,2,33,18.18,8,19754.0,14:57,108,112,220,49.09,9,6,7,10,-3,0,2,2,2100.0,1:35,1,0,1,692.0,0:31,863333
8479353,Brett,Howden,1998-03-29,C,L,2018-19,66,6,17,23,0.35,-16,74,8.11,14,59157.0,14:56,353,376,729,48.42,64,47,28,37,-9,0,2,2,5419.0,1:22,0,0,0,4967.0,1:15,863333
8479364,Tim,Gettinger,1998-04-14,LW,L,2018-19,4,0,0,0,0.0,0,2,0.0,0,1805.0,7:31,0,0,0,0.0,15,3,0,3,-3,0,0,0,0.0,0:0,0,0,0,0.0,0:0,730000
8479365,Trent,Frederic,1998-02-11,C,L,2018-19,15,0,0,0,0.0,-4,19,0.0,15,8460.0,9:24,41,40,81,50.62,18,3,5,2,3,0,0,0,305.0,0:20,0,0,0,91.0,0:6,925000
8479366,Logan,Brown,1998-03-05,C,L,2018-19,2,0,0,0,0.0,-2,2,0.0,0,1262.0,10:31,2,6,8,25.0,0,1,1,0,1,0,0,0,305.0,2:32,0,0,0,0.0,0:0,863333
8479368,Max,Jones,1998-02-17,LW,L,2018-19,30,2,3,5,0.17,-1,58,3.45,14,23714.0,13:10,1,2,3,33.33,30,5,12,9,3,0,1,1,1152.0,0:38,0,0,0,1375.0,0:45,863333
8479370,Tyson,Jost,1998-03-14,C,L,2018-19,70,11,15,26,0.37,-2,114,9.65,14,54625.0,13:0,55,91,146,37.67,48,35,29,8,21,4,1,5,8707.0,2:4,0,0,0,35.0,0:0,885833
8479371,Dante,Fabbro,1998-06-20,D,R,2018-19,4,1,0,1,0.25,-1,5,20.0,0,3057.0,12:44,0,0,0,0.0,3,6,2,1,1,0,0,0,0.0,0:0,0,0,0,53.0,0:13,925000
8479372,Josh,Mahura,1998-05-05,D,L,2018-19,17,1,4,5,0.29,0,20,5.0,4,14590.0,14:18,0,0,0,0.0,6,18,7,8,-1,0,3,3,884.0,0:52,0,0,0,94.0,0:5,745000
8479376,Victor,Mete,1998-06-07,D,L,2018-19,71,0,13,13,0.18,17,65,0.0,6,75713.0,17:46,0,0,0,0.0,21,95,10,57,-47,0,0,0,1330.0,0:18,0,0,0,3772.0,0:53,748333
8479385,Jordan,Kyrou,1998-05-05,C,R,2018-19,16,1,2,3,0.19,-1,16,6.25,4,9273.0,9:39,2,0,2,100.0,2,3,3,3,0,0,0,0,284.0,0:17,0,0,0,0.0,0:0,758333
8479388,Riley,Stillman,1998-03-09,D,L,2018-19,1,0,0,0,0.0,0,1,0.0,2,682.0,11:22,0,0,0,0.0,5,0,0,1,-1,0,0,0,0.0,0:0,0,0,0,0.0,0:0,773333
8479395,Dennis,Cholowski,1998-02-15,D,L,2018-19,52,7,9,16,0.31,-20,71,9.86,16,56950.0,18:15,1,0,1,100.0,18,50,7,50,-43,4,5,9,7655.0,2:27,0,0,0,664.0,0:12,894166
8479398,Samuel,Girard,1998-05-12,D,L,2018-19,82,4,23,27,0.33,8,116,3.45,6,97871.0,19:53,1,0,1,100.0,65,90,25,44,-19,0,9,9,9975.0,2:1,0,0,0,660.0,0:8,728333
8479400,Pierre-Luc,Dubois,1998-06-24,C,L,2018-19,82,27,34,61,0.74,16,174,15.52,64,87160.0,17:42,455,592,1047,43.46,115,52,45,54,-9,2,7,9,11313.0,2:17,0,0,0,879.0,0:10,894166
8479402,Jake,Bean,1998-06-09,D,L,2018-19,2,0,0,0,0.0,0,1,0.0,2,1015.0,8:27,0,0,0,0.0,1,0,1,0,1,0,0,0,19.0,0:9,0,0,0,0.0,0:0,863333
8479404,Henrik,Borgstrom,1997-08-06,C,L,2018-19,50,8,10,18,0.36,-14,54,14.81,4,36009.0,12:0,165,240,405,40.74,11,12,21,25,-4,3,4,7,3337.0,1:6,0,0,0,62.0,0:1,925000
8479407,Jesper,Bratt,1998-07-30,LW,L,2018-19,51,8,25,33,0.65,-8,91,8.79,6,46413.0,15:10,4,3,7,57.14,36,22,17,24,-7,1,7,8,6632.0,2:10,0,0,0,510.0,0:10,749167
8479410,Mikhail,Sergachev,1998-06-25,D,L,2018-19,75,6,26,32,0.43,12,128,4.69,28,80655.0,17:55,1,1,2,50.0,97,93,18,50,-32,0,6,6,6800.0,1:30,0,0,0,1030.0,0:13,894166
8479414,Nathan,Bastian,1997-12-06,RW,R,2018-19,7,3,0,3,0.43,0,13,23.08,10,5326.0,12:40,3,0,3,100.0,24,1,1,0,1,0,0,0,681.0,1:37,0,0,0,0.0,0:0,714166
8479415,Michael,McLeod,1998-02-03,C,R,2018-19,21,0,3,3,0.14,-8,21,0.0,13,15367.0,12:11,70,62,132,53.03,41,4,12,10,2,0,0,0,384.0,0:18,0,0,0,110.0,0:5,863333
8479420,Tage,Thompson,1997-10-30,C,R,2018-19,65,7,5,12,0.18,-22,108,6.48,20,47306.0,12:7,10,10,20,50.0,66,9,24,32,-8,1,0,1,3370.0,0:51,0,0,0,112.0,0:1,925000
8479423,Alexander,Nylander,1998-03-02,RW,R,2018-19,12,2,2,4,0.33,-4,16,12.5,4,8779.0,12:11,2,1,3,66.67,1,1,1,4,-3,1,0,1,705.0,0:58,0,0,0,0.0,0:0,863333
8479425,Filip,Hronek,1997-11-02,D,R,2018-19,46,5,18,23,0.5,-10,73,6.85,30,55092.0,19:57,0,0,0,0.0,66,32,10,47,-37,1,4,5,4631.0,1:40,0,1,1,3221.0,1:10,714166
8479442,Troy,Stecher,1994-04-07,D,R,2018-19,78,2,21,23,0.29,9,105,1.9,32,93211.0,19:55,0,0,0,0.0,91,96,42,32,10,0,2,2,4121.0,0:52,1,0,1,6724.0,1:26,2325000
8479447,Anthony,Greco,1993-09-30,RW,R,2018-19,1,0,0,0,0.0,-3,2,0.0,0,570.0,9:30,0,0,0,0.0,0,0,0,0,0,0,0,0,0.0,0:0,0,0,0,0.0,0:0,667500
8479458,Nikita,Zaitsev,1991-10-29,D,R,2018-19,81,3,11,14,0.17,2,71,4.23,18,99502.0,20:28,0,0,0,0.0,139,151,18,79,-61,0,0,0,337.0,0:4,0,0,0,13873.0,2:51,4500000
8479465,Drake,Caggiula,1994-06-20,LW,L,2018-19,55,12,11,23,0.42,-5,96,12.5,28,47614.0,14:25,16,27,43,37.21,135,26,18,22,-4,0,0,0,1404.0,0:25,1,0,1,2285.0,0:41,1500000
8479466,Patrick,Russell,1993-01-04,RW,R,2018-19,6,0,0,0,0.0,0,6,0.0,2,3164.0,8:47,0,0,0,0.0,9,2,3,2,1,0,0,0,63.0,0:10,0,0,0,164.0,0:27,700000
8479482,Michal,Kempny,1990-09-08,D,L,2018-19,71,6,19,25,0.35,24,111,5.41,60,81736.0,19:11,0,0,0,0.0,84,135,21,47,-26,0,0,0,59.0,0:0,0,0,0,7007.0,1:38,2500000
8479511,Janne,Kuokkanen,1998-05-25,C,L,2018-19,7,0,0,0,0.0,-2,6,0.0,4,4586.0,10:55,0,0,0,0.0,0,3,2,1,1,0,0,0,938.0,2:14,0,0,0,48.0,0:6,811666
8479553,Maxim,Mamin,1995-01-13,C,L,2018-19,7,0,0,0,0.0,-2,8,0.0,5,3086.0,7:20,0,1,1,0.0,10,1,1,0,1,0,0,0,27.0,0:3,0,0,0,0.0,0:0,757500
8479580,Dylan,Gambrell,1996-08-26,C,R,2018-19,8,0,0,0,0.0,1,6,0.0,2,4142.0,8:37,20,19,39,51.28,13,1,5,0,5,0,0,0,15.0,0:1,0,0,0,165.0,0:20,925000
8479644,Matt,Luff,1997-05-05,RW,R,2018-19,33,8,3,11,0.33,-2,45,17.78,9,22010.0,11:6,1,3,4,25.0,17,19,4,12,-8,1,0,1,1026.0,0:31,0,0,0,0.0,0:0,677777
8479657,Alexandre,Fortin,1997-02-25,LW,L,2018-19,24,3,3,6,0.25,-6,29,10.34,2,15251.0,10:35,11,6,17,64.71,21,7,9,3,6,0,0,0,83.0,0:3,1,0,1,555.0,0:23,706666
8479675,Trevor,Moore,1995-03-31,C,L,2018-19,25,2,6,8,0.32,1,26,7.69,2,13641.0,9:5,0,0,0,0.0,15,7,8,9,-1,0,0,0,359.0,0:14,0,0,0,46.0,0:1,925000
8479772,Zack,MacEwen,1996-07-08,C,R,2018-19,4,0,1,1,0.25,-4,2,0.0,5,1724.0,7:11,0,1,1,0.0,4,1,0,4,-4,0,0,0,160.0,0:40,0,0,0,11.0,0:2,847500
8479944,Zach,Aston-Reese,1994-08-10,C,L,2018-19,43,8,9,17,0.4,12,76,10.53,26,35234.0,13:39,8,10,18,44.44,138,37,17,11,6,0,0,0,303.0,0:7,1,0,1,4838.0,1:52,925000
8479945,Gavin,Bayreuther,1994-05-12,D,L,2018-19,19,2,3,5,0.26,2,25,8.0,10,20735.0,18:11,0,0,0,0.0,11,19,8,13,-5,0,2,2,1530.0,1:20,0,0,0,603.0,0:31,925000
8479968,Vinni,Lettieri,1995-02-06,C,R,2018-19,27,1,2,3,0.11,-7,40,2.5,14,16452.0,10:9,7,6,13,53.85,41,11,7,9,-2,1,1,2,910.0,0:33,0,0,0,284.0,0:10,925000
8479970,Joseph,Gambardella,1993-12-01,C,L,2018-19,15,0,3,3,0.2,2,7,0.0,2,7293.0,8:6,3,1,4,75.0,14,5,5,2,3,0,0,0,7.0,0:0,0,0,0,2.0,0:0,725000
8479974,Nolan,Patrick,1998-09-19,C,R,2018-19,72,13,18,31,0.43,-8,115,11.3,27,65157.0,15:4,399,380,779,51.22,72,26,40,26,14,1,1,2,7138.0,1:39,0,0,0,161.0,0:2,925000
8479976,Juuso,Valimaki,1998-10-06,D,L,2018-19,24,1,2,3,0.12,-2,28,3.57,12,22296.0,15:29,0,0,0,0.0,21,43,9,14,-5,0,0,0,205.0,0:8,0,0,0,1882.0,1:18,894166
8479977,Kailer,Yamamoto,1998-09-29,RW,R,2018-19,17,1,1,2,0.12,-6,13,7.69,2,13322.0,13:3,0,0,0,0.0,18,11,3,6,-3,0,1,1,924.0,0:54,0,0,0,408.0,0:24,894166
8479992,Michael,Rasmussen,1999-04-17,C,L,2018-19,62,8,10,18,0.29,-8,74,10.81,29,44923.0,12:4,23,41,64,35.94,84,28,12,29,-17,4,0,4,6682.0,1:47,0,0,0,23.0,0:0,894166
8479994,Jaret,Anderson-Dolan,1999-09-12,C,L,2018-19,5,0,1,1,0.2,-2,6,0.0,0,3481.0,11:36,4,5,9,44.44,5,2,2,2,0,0,0,0,535.0,1:47,0,0,0,0.0,0:0,745000
8479999,Casey,Mittelstadt,1998-11-22,C,L,2018-19,77,12,13,25,0.32,-19,118,10.17,10,62147.0,13:27,213,323,536,39.74,30,16,31,39,-8,3,7,10,8143.0,1:45,0,0,0,50.0,0:0,925000
8480001,Urho,Vaakanainen,1999-01-01,D,L,2018-19,2,0,0,0,0.0,-1,2,0.0,0,1092.0,9:6,0,0,0,0.0,0,0,0,1,-1,0,0,0,0.0,0:0,0,0,0,53.0,0:26,925000
8480002,Nico,Hischier,1999-01-04,C,L,2018-19,69,17,30,47,0.68,0,160,10.62,24,74950.0,18:6,437,529,966,45.24,53,44,38,32,6,3,8,11,12029.0,2:54,0,0,0,2729.0,0:39,925000
8480005,Kristian,Vesalainen,1999-06-01,LW,L,2018-19,5,0,1,1,0.2,0,1,0.0,0,2052.0,6:50,0,0,0,0.0,1,1,0,2,-2,0,0,0,18.0,0:3,0,0,0,0.0,0:0,925000
8480009,Eeli,Tolvanen,1999-04-22,RW,L,2018-19,4,1,1,2,0.5,2,2,50.0,0,3185.0,13:16,0,0,0,0.0,4,2,3,1,2,0,1,1,348.0,1:27,0,0,0,0.0,0:0,894166
8480012,Elias,Pettersson,1998-11-12,C,L,2018-19,71,28,38,66,0.93,3,144,19.44,12,77644.0,18:13,257,370,627,40.99,42,51,41,52,-11,10,12,22,15264.0,3:34,0,0,0,281.0,0:3,925000
8480023,Robert,Thomas,1999-07-02,C,R,2018-19,70,9,24,33,0.47,-2,80,11.25,14,54905.0,13:4,97,123,220,44.09,13,22,36,30,6,3,4,7,5331.0,1:16,0,0,0,599.0,0:8,894166
8480029,Alex,Formenton,1999-09-13,LW,L,2018-19,9,1,0,1,0.11,-2,16,6.25,6,6301.0,11:40,1,2,3,33.33,11,7,4,5,-1,0,0,0,53.0,0:5,0,0,0,217.0,0:24,753333
8480031,Max,Comtois,1999-01-08,LW,L,2018-19,10,2,5,7,0.7,3,9,22.22,7,8754.0,14:35,3,8,11,27.27,27,3,2,4,-2,0,0,0,893.0,1:29,0,0,0,5.0,0:0,820000
8480035,Henri,Jokiharju,1999-06-17,D,R,2018-19,38,0,12,12,0.32,-7,62,0.0,16,43275.0,18:58,0,0,0,0.0,48,37,7,26,-19,0,1,1,2274.0,0:59,0,0,0,1841.0,0:48,925000
8480036,Miro,Heiskanen,1999-07-18,D,L,2018-19,82,12,21,33,0.4,-14,182,6.59,16,113717.0,23:6,0,0,0,0.0,34,71,35,96,-61,2,6,8,8195.0,1:39,0,1,1,6829.0,1:23,894166
8480039,Martin,Necas,1999-01-15,C,R,2018-19,7,1,1,2,0.29,0,6,16.67,2,4210.0,10:1,16,28,44,36.36,3,2,3,7,-4,0,0,0,808.0,1:55,0,0,0,0.0,0:0,894167
8480068,Ryan,Poehling,1999-01-03,C,L,2018-19,1,3,0,3,3.0,3,3,100.0,0,682.0,11:22,4,3,7,57.14,1,0,0,0,0,0,0,0,0.0,0:0,0,0,0,42.0,0:42,925000
8480072,Lias,Andersson,1998-10-13,C,L,2018-19,42,2,4,6,0.14,-13,41,4.88,29,27007.0,10:43,84,106,190,44.21,60,8,14,12,2,0,0,0,139.0,0:3,1,0,1,1657.0,0:39,894166
8480074,Alexandre,Texier,1999-09-13,C,L,2018-19,2,1,0,1,0.5,3,6,16.67,0,1532.0,12:46,0,1,1,0.0,2,1,0,2,-2,0,0,0,0.0,0:0,0,0,0,0.0,0:0,897500
8480078,Filip,Chytil,1999-09-05,C,L,2018-19,75,11,12,23,0.31,-22,133,8.27,8,62037.0,13:47,68,107,175,38.86,29,21,25,46,-21,3,4,7,6594.0,1:27,0,0,0,12.0,0:0,894166
8480082,Justin,Kloos,1993-11-30,C,R,2018-19,1,0,0,0,0.0,0,2,0.0,0,424.0,7:4,0,0,0,0.0,2,0,1,0,1,0,0,0,0.0,0:0,0,0,0,0.0,0:0,792500
8480083,C.J.,Smith,1994-12-01,LW,L,2018-19,11,2,0,2,0.18,0,18,11.11,0,7032.0,10:39,0,0,0,0.0,4,1,2,3,-1,0,0,0,54.0,0:4,0,0,0,195.0,0:17,874125
8480113,Alex,Iafallo,1993-12-21,C,L,2018-19,82,15,18,33,0.4,-17,148,10.14,22,82802.0,16:49,7,17,24,29.17,87,54,26,19,7,2,4,6,7999.0,1:37,0,0,0,1958.0,0:23,925000
8480143,Jakub,Jerabek,1991-05-12,D,L,2018-19,1,0,0,0,0.0,-3,1,0.0,2,472.0,7:52,0,0,0,0.0,0,1,0,0,0,0,0,0,2.0,0:2,0,0,0,25.0,0:25,1000000
8480144,David,Kampf,1995-01-12,C,L,2018-19,63,4,15,19,0.3,-6,72,5.56,14,52619.0,13:55,276,333,609,45.32,39,30,31,6,25,0,0,0,428.0,0:6,0,0,0,7019.0,1:51,925000
8480145,Neal,Pionk,1995-07-29,D,R,2018-19,73,6,20,26,0.36,-16,132,4.55,35,92706.0,21:9,0,1,1,0.0,138,98,38,60,-22,2,11,13,6556.0,1:29,0,1,1,12597.0,2:52,925000
8480147,Oscar,Fantenberg,1991-10-07,D,L,2018-19,61,2,2,4,0.07,4,70,2.86,17,58562.0,16:0,0,0,0,0.0,91,74,12,38,-26,0,0,0,896.0,0:14,0,0,0,4330.0,1:10,650000
8480157,Calle,Rosen,1994-02-02,D,L,2018-19,4,1,0,1,0.25,-3,5,20.0,0,4009.0,16:42,0,0,0,0.0,1,2,0,4,-4,0,0,0,116.0,0:29,0,0,0,6.0,0:1,925000
8480160,Radim,Simek,1992-09-20,D,L,2018-19,41,1,8,9,0.22,7,41,2.44,8,37432.0,15:12,0,0,0,0.0,67,34,14,21,-7,0,0,0,120.0,0:2,0,0,0,2067.0,0:50,675000
8480161,Libor,Sulak,1994-03-04,D,L,2018-19,6,0,0,0,0.0,-4,7,0.0,6,6977.0,19:22,0,0,0,0.0,18,5,3,10,-7,0,0,0,8.0,0:1,0,0,0,776.0,2:9,833750
8480172,Jan,Rutta,1990-07-29,D,R,2018-19,37,2,6,8,0.22,4,42,4.76,16,34615.0,15:35,0,0,0,0.0,24,30,1,12,-11,0,0,0,85.0,0:2,0,0,0,2418.0,1:5,2250000
8480208,Drake,Batherson,1998-04-27,C,R,2018-19,20,3,6,9,0.45,-2,18,16.67,6,16098.0,13:24,3,1,4,75.0,17,21,7,12,-5,2,1,3,2251.0,1:52,0,0,0,0.0,0:0,736666
8480314,Max,Veronneau,1995-12-12,RW,R,2018-19,12,2,2,4,0.33,-5,15,13.33,0,9015.0,12:31,0,0,0,0.0,0,5,1,3,-2,1,0,1,858.0,1:11,0,0,0,0.0,0:0,925000
8480326,Sheldon,Dries,1994-04-23,C,L,2018-19,40,3,3,6,0.15,-7,44,6.82,26,21777.0,9:4,66,65,131,50.38,66,20,7,7,0,0,0,0,183.0,0:4,1,0,1,2352.0,0:58,925000
8480336,Sean,Walker,1994-11-13,D,R,2018-19,39,3,7,10,0.26,-8,55,5.45,8,36110.0,15:25,0,0,0,0.0,43,40,14,16,-2,1,0,1,318.0,0:8,0,0,0,207.0,0:5,745000
8480341,Adam,Johnson,1994-06-22,C,L,2018-19,6,0,2,2,0.33,2,3,0.0,0,1910.0,5:18,0,0,0,0.0,11,3,2,1,1,0,0,0,0.0,0:0,0,0,0,0.0,0:0,925000
8480748,Kiefer,Sherwood,1995-03-31,RW,R,2018-19,50,6,6,12,0.24,1,60,10.0,8,34111.0,11:22,7,9,16,43.75,79,19,17,23,-6,0,0,0,364.0,0:7,0,0,0,810.0,0:16,925000
8480769,Joel,L'Esperance,1995-08-18,RW,R,2018-19,18,2,0,2,0.11,-4,24,8.33,6,13228.0,12:14,26,30,56,46.43,22,4,6,7,-1,1,0,1,1392.0,1:17,0,0,0,0.0,0:0,722500
8480771,Daniel,Brickley,1995-03-30,D,L,2018-19,4,0,1,1,0.25,-2,2,0.0,0,3074.0,12:48,0,0,0,0.0,5,4,0,2,-2,0,0,0,11.0,0:2,0,0,0,51.0,0:12,925000
8480776,Sheldon,Rempal,1995-08-07,RW,R,2018-19,7,0,0,0,0.0,-1,3,0.0,0,3670.0,8:44,0,0,0,0.0,0,1,0,4,-4,0,0,0,2.0,0:0,0,0,0,0.0,0:0,925000
8480780,Lukas,Radil,1990-08-05,C,R,2018-19,36,7,4,11,0.31,7,40,17.5,6,23074.0,10:40,6,3,9,66.67,29,9,14,9,5,0,0,0,60.0,0:1,0,0,0,0.0,0:0,750000
8480800,Quinn,Hughes,1999-10-14,D,L,2018-19,5,0,3,3,0.6,0,6,0.0,2,5424.0,18:4,0,0,0,0.0,1,1,3,2,1,0,2,2,384.0,1:16,0,0,0,0.0,0:0,916667
8480801,Brady,Tkachuk,1999-09-16,LW,L,2018-19,71,22,23,45,0.63,-10,214,10.28,75,68266.0,16:1,73,76,149,48.99,174,26,22,39,-17,4,6,10,9530.0,2:14,0,0,0,204.0,0:2,925000
8480803,Evan,Bouchard,1999-10-20,D,R,2018-19,7,1,0,1,0.14,-5,10,10.0,2,5189.0,12:21,0,0,0,0.0,6,8,3,2,1,1,0,1,611.0,1:27,0,0,0,36.0,0:5,925000
8480806,Isac,Lundestrom,1999-11-06,C,L,2018-19,15,0,2,2,0.13,-1,13,0.0,2,11726.0,13:1,21,43,64,32.81,4,5,3,5,-2,0,0,0,353.0,0:23,0,0,0,715.0,0:47,925000
8480821,Filip,Zadina,1999-11-27,RW,L,2018-19,9,1,2,3,0.33,-5,18,5.56,0,8308.0,15:23,3,3,6,50.0,6,3,5,5,0,1,1,2,1244.0,2:18,0,0,0,0.0,0:0,925000
8480829,Jesperi,Kotkaniemi,2000-07-06,C,L,2018-19,79,11,23,34,0.43,1,134,8.21,26,65135.0,13:44,359,426,785,45.73,66,41,32,50,-18,1,4,5,9144.0,1:55,0,0,0,38.0,0:0,925000
8480830,Andrei,Svechnikov,2000-03-26,RW,L,2018-19,82,20,17,37,0.45,0,189,10.58,62,72062.0,14:38,1,6,7,14.29,123,26,34,63,-29,0,5,5,9419.0,1:54,0,0,0,67.0,0:0,925000
8480839,Rasmus,Dahlin,2000-04-13,D,L,2018-19,82,9,35,44,0.54,-13,177,5.08,34,104085.0,21:9,0,0,0,0.0,97,66,38,79,-41,5,15,20,14029.0,2:51,0,0,0,779.0,0:9,925000
8480901,Karson,Kuhlman,1995-09-26,C,R,2018-19,11,3,2,5,0.45,5,15,20.0,2,8016.0,12:8,1,0,1,100.0,6,4,3,3,0,0,0,0,3.0,0:0,0,0,0,487.0,0:44,750000
8480935,Lawrence,Pilut,1995-12-30,D,L,2018-19,33,1,5,6,0.18,-8,37,2.7,20,34488.0,17:25,0,0,0,0.0,20,33,7,14,-7,0,0,0,1176.0,0:35,0,0,0,608.0,0:18,925000
8480943,Igor,Ozhiganov,1992-10-13,D,R,2018-19,53,3,4,7,0.13,0,43,6.98,14,44568.0,14:0,0,0,0,0.0,57,48,11,34,-23,0,0,0,91.0,0:1,0,0,0,218.0,0:4,925000
8480944,Par,Lindholm,1991-10-05,C,L,2018-19,65,1,12,13,0.2,5,65,1.54,18,44252.0,11:20,204,203,407,50.12,58,55,30,12,18,0,0,0,270.0,0:4,0,0,0,6190.0,1:35,925000
8480945,Juuso,Riikola,1993-11-09,D,L,2018-19,37,2,3,5,0.14,3,43,4.65,10,37040.0,16:41,0,0,0,0.0,86,38,13,16,-3,2,0,2,2255.0,1:0,0,0,0,163.0,0:4,925000
8480946,Dominik,Kahun,1995-07-02,C,L,2018-19,82,13,24,37,0.45,10,137,9.49,6,69620.0,14:9,22,39,61,36.07,13,27,32,24,8,1,1,2,5214.0,1:3,0,0,0,325.0,0:3,925000
8480948,Egor,Yakovlev,1991-09-17,D,L,2018-19,25,2,5,7,0.28,-6,24,8.33,6,23510.0,15:40,0,0,0,0.0,12,22,3,19,-16,0,0,0,173.0,0:6,0,0,0,46.0,0:1,925000
8480950,Ilya,Lyubushkin,1994-04-06,D,R,2018-19,41,0,4,4,0.1,-9,27,0.0,13,33799.0,13:44,0,0,0,0.0,150,61,6,22,-16,0,0,0,98.0,0:2,0,0,0,593.0,0:14,925000
8480955,Bogdan,Kiselevich,1990-02-14,D,L,2018-19,32,0,8,8,0.25,-3,14,0.0,12,28520.0,14:51,0,0,0,0.0,49,21,4,9,-5,0,0,0,18.0,0:0,0,0,0,1568.0,0:49,925000
8480965,Antti,Suomela,1994-03-17,C,L,2018-19,27,3,5,8,0.3,1,42,7.14,4,18334.0,11:19,102,127,229,44.54,10,11,5,7,-2,0,0,0,79.0,0:2,0,0,0,130.0,0:4,925000
8481186,Logan,O'Connor,1996-08-14,RW,R,2018-19,5,0,0,0,0.0,-2,1,0.0,0,2044.0,6:48,0,3,3,0.0,4,1,2,0,2,0,0,0,0.0,0:0,0,0,0,156.0,0:31,925000
8481426,Ryan,Kuffner,1996-06-12,LW,L,2018-19,10,0,0,0,0.0,-4,8,0.0,0,6561.0,10:56,0,2,2,0.0,4,5,2,1,1,0,0,0,537.0,0:53,0,0,0,0.0,0:0,925000
8481433,Taro,Hirose,1996-06-30,LW,L,2018-19,10,1,6,7,0.7,0,15,6.67,2,9183.0,15:18,1,0,1,100.0,1,9,5,7,-2,0,1,1,543.0,0:54,0,0,0,6.0,0:0,925000
8481442,Brady,Keeper,1996-06-05,D,R,2018-19,1,0,0,0,0.0,1,1,0.0,0,760.0,12:40,0,0,0,0.0,2,1,0,0,0,0,0,0,0.0,0:0,0,0,0,0.0,0:0,925000
8481477,Nico,Sturm,1995-05-03,C,L,2018-19,2,0,0,0,0.0,0,7,0.0,0,1534.0,12:47,5,12,17,29.41,3,2,0,0,0,0,0,0,14.0,0:7,0,0,0,86.0,0:43,4273500
8481479,Brogan,Rafferty,1995-05-28,D,R,2018-19,2,0,0,0,0.0,-1,3,0.0,0,1602.0,13:21,0,0,0,0.0,0,2,1,1,0,0,0,0,0.0,0:0,0,0,0,0.0,0:0,5133750
8481481,Blake,Lizotte,1997-12-13,C,L,2018-19,1,0,0,0,0.0,-1,1,0.0,0,672.0,11:12,4,4,8,50.0,0,1,1,0,1,0,0,0,0.0,0:0,0,0,0,0.0,0:0,925000
8481486,Jimmy,Schuldt,1995-05-11,D,L,2018-19,1,0,1,1,1.0,-1,1,0.0,0,1263.0,21:3,0,0,0,0.0,0,1,0,1,-1,0,0,0,109.0,1:49,0,0,0,2.0,0:2,6567500
8465009,Zdeno,Chara,1977-03-18,D,L,2019-20,71,5,10,15,0.21,24,88,5.68,60,88972.0,20:53,0,0,0,0.0,83,108,27,55,-28,0,0,0,242.0,0:3,0,0,0,13432.0,3:9,2000000
8466138,Joe,Thornton,1979-07-02,C,L,2019-20,70,7,24,31,0.44,-19,76,9.21,34,65102.0,15:30,323,331,654,49.39,20,29,55,30,25,3,5,8,8723.0,2:4,0,0,0,19.0,0:0,2000000
8466139,Patrick,Marleau,1979-09-15,C,L,2019-20,66,11,11,22,0.33,-5,117,9.4,14,61686.0,15:34,36,40,76,47.37,57,24,29,15,14,1,0,1,5863.0,1:28,0,0,0,1046.0,0:15,6250000
8468493,Ron,Hainsey,1981-03-24,D,L,2019-20,64,1,11,12,0.19,10,43,2.33,12,79418.0,20:40,0,0,0,0.0,51,102,9,56,-47,0,0,0,1067.0,0:16,0,3,3,12370.0,3:13,3500000
8468508,Justin,Williams,1981-10-04,RW,R,2019-20,20,8,3,11,0.55,2,60,13.33,6,16339.0,13:36,3,7,10,30.0,20,7,3,13,-10,2,1,3,2964.0,2:28,0,0,0,71.0,0:3,700000
8468674,Deryk,Engelland,1982-04-03,D,R,2019-20,49,1,5,6,0.12,5,59,1.69,37,51630.0,17:33,0,0,0,0.0,114,86,15,17,-2,0,0,0,36.0,0:0,0,1,1,10075.0,3:25,700000
8469454,Ilya,Kovalchuk,1983-04-15,RW,R,2019-20,49,10,17,27,0.55,-3,119,8.4,20,49426.0,16:48,8,16,24,33.33,58,24,11,28,-17,2,3,5,7266.0,2:28,0,0,0,26.0,0:0,6666666
8469455,Jason,Spezza,1983-06-13,C,R,2019-20,58,9,16,25,0.43,-3,73,12.33,18,37685.0,10:49,215,183,398,54.02,13,19,20,33,-13,2,5,7,4081.0,1:10,0,0,0,178.0,0:3,700000
8469459,Mikko,Koivu,1983-03-12,C,L,2019-20,55,4,17,21,0.38,2,74,5.41,28,51381.0,15:34,431,380,811,53.14,25,33,29,13,16,1,6,7,5411.0,1:38,0,1,1,5447.0,1:39,5500000
8469465,Dan,Hamhuis,1982-12-13,D,L,2019-20,60,0,8,8,0.13,6,44,0.0,35,52249.0,14:30,0,0,0,0.0,64,53,9,34,-25,0,0,0,53.0,0:0,0,0,0,8554.0,2:22,1250000
8470047,Valtteri,Filppula,1984-03-20,C,L,2019-20,70,6,15,21,0.3,-42,63,9.52,24,69772.0,16:36,324,398,722,44.88,28,31,17,43,-26,1,4,5,7945.0,1:53,1,0,1,7172.0,1:42,3000000
8470110,Trevor,Daley,1983-10-09,D,L,2019-20,43,0,7,7,0.16,-22,37,0.0,20,40396.0,15:39,0,0,0,0.0,9,44,5,21,-16,0,2,2,1987.0,0:46,0,0,0,1643.0,0:38,3166666
8470144,Frans,Nielsen,1984-04-24,C,L,2019-20,60,4,5,9,0.15,-13,86,4.65,8,49260.0,13:41,210,246,456,46.05,44,35,11,15,-4,0,2,2,3726.0,1:2,1,1,2,6320.0,1:45,5250000
8470151,Jay,Bouwmeester,1983-09-27,D,L,2019-20,56,1,8,9,0.16,5,53,1.89,20,72482.0,21:34,0,0,0,0.0,42,68,11,32,-21,0,0,0,111.0,0:1,0,1,1,8859.0,2:38,3250000
8470187,Johnny,Boychuk,1984-01-19,D,R,2019-20,64,2,9,11,0.17,-11,96,2.08,14,66376.0,17:17,0,0,0,0.0,135,128,6,50,-44,1,0,1,324.0,0:5,0,0,0,7921.0,2:3,6000000
8470257,Alexander,Steen,1984-03-01,LW,L,2019-20,58,7,10,17,0.29,5,71,9.86,16,48678.0,13:59,8,7,15,53.33,29,50,16,13,3,0,1,1,883.0,0:15,0,0,0,8326.0,2:23,5750000
8470281,Duncan,Keith,1983-07-16,D,L,2019-20,61,3,24,27,0.44,1,111,2.7,18,89251.0,24:23,0,0,0,0.0,26,117,42,74,-32,2,9,11,8351.0,2:16,0,0,0,10011.0,2:44,5538462
8470318,Jonathan,Ericsson,1984-03-02,D,L,2019-20,18,0,0,0,0.0,-12,16,0.0,4,15386.0,14:14,0,0,0,0.0,24,14,1,20,-19,0,0,0,12.0,0:0,0,0,0,1660.0,1:32,4250000
8470595,Eric,Staal,1984-10-29,C,L,2019-20,66,19,28,47,0.71,-9,113,16.81,28,67853.0,17:8,495,504,999,49.55,24,22,25,46,-21,5,9,14,10677.0,2:41,0,0,0,1080.0,0:16,3250000
8470600,Ryan,Suter,1985-01-21,D,L,2019-20,69,8,40,48,0.7,-6,111,7.21,12,102009.0,24:38,0,0,0,0.0,48,93,19,27,-8,2,16,18,12019.0,2:54,0,0,0,10007.0,2:25,7538462
8470601,Braydon,Coburn,1985-02-27,D,L,2019-20,40,1,3,4,0.1,5,44,2.27,16,33730.0,14:3,0,0,0,0.0,59,28,3,5,-2,0,0,0,146.0,0:3,0,0,0,2020.0,0:50,1700000
8470604,Jeff,Carter,1985-01-01,C,R,2019-20,60,17,10,27,0.45,-21,182,9.34,36,60894.0,16:54,382,364,746,51.21,66,23,13,20,-7,3,2,5,6605.0,1:50,0,0,0,4967.0,1:22,5272727
8470606,Dustin,Brown,1984-11-04,RW,R,2019-20,66,17,18,35,0.53,-1,169,10.06,22,72890.0,18:24,7,9,16,43.75,143,15,28,35,-7,1,4,5,9922.0,2:30,0,0,0,2666.0,0:40,5875000
8470607,Brent,Seabrook,1985-04-20,D,R,2019-20,32,3,1,4,0.12,1,40,7.5,8,34846.0,18:8,0,0,0,0.0,52,61,3,27,-24,1,0,1,1378.0,0:43,0,0,0,2932.0,1:31,6875000
8470610,Zach,Parise,1984-07-28,LW,L,2019-20,69,25,21,46,0.67,-11,155,16.13,8,71195.0,17:11,41,36,77,53.25,27,38,21,22,-1,12,6,18,11433.0,2:45,1,0,1,3735.0,0:54,7538462
8470612,Ryan,Getzlaf,1985-05-10,C,R,2019-20,69,13,29,42,0.61,-16,143,9.09,58,77512.0,18:43,530,504,1034,51.26,125,69,53,76,-23,3,6,9,10091.0,2:26,0,0,0,2906.0,0:42,8250000
8470613,Brent,Burns,1985-03-09,D,R,2019-20,70,12,33,45,0.64,-22,225,5.33,34,106726.0,25:24,0,0,0,0.0,72,115,49,76,-27,5,12,17,11622.0,2:46,0,1,1,10388.0,2:28,8000000
8470619,Brian,Boyle,1984-12-18,C,L,2019-20,39,6,9,15,0.38,-5,56,10.71,17,28958.0,12:22,197,179,376,52.39,65,34,16,13,3,1,0,1,2075.0,0:53,0,0,0,1205.0,0:30,940000
8470621,Corey,Perry,1985-05-16,RW,R,2019-20,60,6,16,22,0.37,-4,83,7.23,74,49420.0,13:43,4,6,10,40.0,66,35,17,30,-13,2,6,8,7711.0,2:8,0,0,0,63.0,0:1,8625000
8470626,Loui,Eriksson,1985-07-17,LW,L,2019-20,49,6,7,13,0.27,-2,59,10.17,12,36374.0,12:22,2,0,2,100.0,10,15,17,8,9,0,0,0,214.0,0:4,0,0,0,4198.0,1:25,6000000
8470638,Patrice,Bergeron,1985-07-24,C,R,2019-20,64,31,26,57,0.89,22,212,14.62,28,71830.0,18:42,812,583,1395,58.21,49,50,44,23,21,11,9,20,14029.0,3:39,1,0,1,6537.0,1:42,6875000
8470642,Shea,Weber,1985-08-14,D,R,2019-20,65,15,21,36,0.55,8,185,8.11,33,93630.0,24:0,0,0,0,0.0,112,114,18,79,-61,3,5,8,8451.0,2:10,0,0,0,12600.0,3:13,7857143
8470655,David,Backes,1984-05-01,RW,R,2019-20,22,1,5,6,0.27,-1,34,2.94,22,12406.0,9:23,27,44,71,38.03,38,8,5,9,-4,1,0,1,384.0,0:17,0,0,0,134.0,0:6,6000000
8470755,Brad,Richardson,1985-02-04,C,L,2019-20,59,6,5,11,0.19,1,76,7.89,20,48307.0,13:38,355,303,658,53.95,77,44,12,18,-6,0,0,0,132.0,0:2,1,1,2,9074.0,2:33,1250000
8470775,Nate,Thompson,1984-10-05,C,L,2019-20,73,5,11,16,0.22,0,70,7.14,30,56116.0,12:48,452,362,814,55.53,125,56,26,33,-7,0,0,0,254.0,0:3,0,1,1,9651.0,2:12,1000000
8470794,Joe,Pavelski,1984-07-11,C,R,2019-20,70,16,17,33,0.47,5,130,12.31,29,71326.0,16:58,365,312,677,53.91,64,53,38,29,9,6,5,11,11097.0,2:38,0,1,1,3308.0,0:47,7000000
8470966,Mark,Giordano,1983-10-03,D,L,2019-20,60,5,26,31,0.52,2,157,3.18,34,86011.0,23:53,0,0,0,0.0,42,148,36,51,-15,2,9,11,9619.0,2:40,0,2,2,9832.0,2:43,6750000
8471214,Alex,Ovechkin,1985-09-17,LW,R,2019-20,71,48,19,67,0.94,-12,321,14.95,30,88035.0,20:39,1,0,1,100.0,196,30,29,49,-20,13,5,18,20845.0,4:53,0,0,0,72.0,0:1,9538462
8471215,Evgeni,Malkin,1986-07-31,C,L,2019-20,55,25,49,74,1.35,7,171,14.62,58,64420.0,19:31,441,435,876,50.34,38,22,70,69,1,7,17,24,12186.0,3:41,0,0,0,90.0,0:1,9500000
8471217,Andrew,Ladd,1985-12-12,LW,L,2019-20,4,1,0,1,0.25,2,5,20.0,4,2871.0,11:57,0,0,0,0.0,23,0,0,1,-1,0,0,0,62.0,0:15,0,0,0,0.0,0:0,5500000
8471218,Blake,Wheeler,1986-08-31,RW,R,2019-20,71,22,43,65,0.92,1,180,12.22,37,82300.0,19:19,324,328,652,49.69,102,51,37,46,-9,4,18,22,13885.0,3:15,1,1,2,2776.0,0:39,8250000
8471228,Alexander,Radulov,1986-07-05,RW,L,2019-20,63,15,19,34,0.54,8,133,11.28,50,63415.0,16:46,4,10,14,28.57,52,42,29,46,-17,7,3,10,9715.0,2:34,0,0,0,28.0,0:0,6250000
8471233,Travis,Zajac,1985-05-13,C,R,2019-20,69,9,16,25,0.36,-12,72,12.5,28,70776.0,17:5,576,514,1090,52.84,58,39,36,17,19,1,0,1,2395.0,0:34,1,2,3,11825.0,2:51,5750000
8471242,Mike,Green,1985-10-12,D,R,2019-20,50,3,8,11,0.22,-34,76,3.95,32,62631.0,20:52,0,0,0,0.0,61,66,12,41,-29,1,3,4,7036.0,2:20,0,0,0,362.0,0:7,5375000
8471260,Blake,Comeau,1986-02-18,LW,R,2019-20,58,8,9,17,0.29,-6,77,10.39,36,51597.0,14:49,42,55,97,43.3,112,27,25,32,-7,0,0,0,535.0,0:9,1,1,2,7406.0,2:7,2400000
8471262,Carl,Soderberg,1985-10-12,C,L,2019-20,70,17,18,35,0.5,6,135,12.59,18,66765.0,15:53,245,296,541,45.29,77,41,28,24,4,6,5,11,9060.0,2:9,0,0,0,3880.0,0:55,4750000
8471274,Alex,Goligoski,1985-07-30,D,L,2019-20,70,4,28,32,0.46,8,101,3.96,24,96839.0,23:3,0,0,0,0.0,91,134,7,53,-46,2,9,11,8090.0,1:55,0,0,0,9918.0,2:21,5475000
8471276,David,Krejci,1986-04-28,C,R,2019-20,64,13,31,44,0.69,14,89,14.61,25,66177.0,17:14,385,384,769,50.07,38,33,32,40,-8,3,11,14,7129.0,1:51,0,0,0,179.0,0:2,7250000
8471284,Andrej,Sekera,1986-06-08,D,L,2019-20,60,2,6,8,0.13,7,65,3.08,14,64391.0,17:53,0,0,0,0.0,37,79,9,53,-44,0,0,0,270.0,0:4,1,0,1,8226.0,2:17,5500000
8471303,Alexander,Edler,1986-04-21,D,L,2019-20,59,5,28,33,0.56,14,118,4.24,62,80065.0,22:37,0,0,0,0.0,108,162,9,43,-34,1,6,7,4223.0,1:11,0,0,0,10909.0,3:4,6000000
8471392,Roman,Polak,1986-04-28,D,R,2019-20,41,0,4,4,0.1,-6,34,0.0,24,40992.0,16:39,0,0,0,0.0,104,94,4,22,-18,0,0,0,32.0,0:0,0,0,0,6840.0,2:46,1750000
8471426,Troy,Brouwer,1985-08-17,RW,R,2019-20,15,2,0,2,0.13,2,13,15.38,11,8587.0,9:32,1,1,2,50.0,28,6,2,2,0,0,0,0,28.0,0:1,0,0,0,198.0,0:13,4500000
8471669,Paul,Stastny,1985-12-27,C,L,2019-20,74,17,21,38,0.51,6,146,11.64,26,76135.0,17:8,648,541,1189,54.5,64,32,42,21,21,5,5,10,10560.0,2:22,0,1,1,4786.0,1:4,6500000
8471675,Sidney,Crosby,1987-08-07,C,L,2019-20,41,16,31,47,1.15,-8,109,14.68,15,49855.0,20:15,494,394,888,55.63,28,17,26,25,1,4,13,17,9473.0,3:51,0,0,0,707.0,0:17,8700000
8471676,Bobby,Ryan,1987-03-17,RW,R,2019-20,24,5,3,8,0.33,3,43,11.63,22,19465.0,13:31,3,2,5,60.0,41,13,12,18,-6,0,0,0,3572.0,2:28,0,0,0,8.0,0:0,7250000
8471677,Jack,Johnson,1987-01-13,D,L,2019-20,67,3,8,11,0.16,-1,63,4.76,26,78248.0,19:27,0,0,0,0.0,183,97,15,23,-8,0,0,0,272.0,0:4,1,0,1,8862.0,2:12,3250000
8471685,Anze,Kopitar,1987-08-24,C,L,2019-20,70,21,41,62,0.89,6,135,15.56,16,88368.0,21:2,776,631,1407,55.15,49,56,39,49,-10,7,14,21,12107.0,2:52,1,0,1,7522.0,1:47,10000000
8471686,Marc,Staal,1987-01-13,D,L,2019-20,52,2,9,11,0.21,5,46,4.35,16,55043.0,17:38,0,0,0,0.0,69,76,19,34,-15,0,0,0,175.0,0:3,0,0,0,8513.0,2:43,5700000
8471698,T.J.,Oshie,1986-12-23,RW,R,2019-20,72,27,23,50,0.69,4,142,19.01,35,78984.0,18:17,127,131,258,49.22,95,61,46,48,-2,10,2,12,15392.0,3:33,0,0,0,706.0,0:9,5750000
8471699,Andrew,Cogliano,1987-06-14,LW,L,2019-20,71,3,11,14,0.2,2,72,4.17,32,52945.0,12:25,19,20,39,48.72,94,33,26,21,5,0,0,0,427.0,0:6,0,0,0,6366.0,1:29,3250000
8471702,Matt,Niskanen,1986-12-06,D,R,2019-20,71,8,25,33,0.46,19,126,6.35,31,93359.0,21:54,0,0,0,0.0,128,90,14,60,-46,4,9,13,8672.0,2:2,1,0,1,11278.0,2:38,5750000
8471707,James,Neal,1987-09-03,LW,L,2019-20,55,19,12,31,0.56,-20,112,16.96,12,53814.0,16:18,11,20,31,35.48,88,17,24,29,-5,12,5,17,9530.0,2:53,0,0,0,76.0,0:1,5750000
8471709,Marc-Edouard,Vlasic,1987-03-30,D,L,2019-20,70,5,10,15,0.21,-10,74,6.76,10,85238.0,20:17,0,0,0,0.0,37,97,18,40,-22,0,0,0,1120.0,0:16,1,0,1,11754.0,2:47,7000000
8471716,Justin,Abdelkader,1987-02-25,LW,L,2019-20,49,0,3,3,0.06,-14,40,0.0,25,33909.0,11:32,38,31,69,55.07,103,26,10,18,-8,0,0,0,1428.0,0:29,0,0,0,3425.0,1:9,4250000
8471724,Kris,Letang,1987-04-24,D,R,2019-20,61,15,29,44,0.72,0,177,8.47,38,94155.0,25:43,0,0,0,0.0,101,91,31,80,-49,6,9,15,12859.0,3:30,0,0,0,8058.0,2:12,7250000
8471729,Kris,Russell,1987-05-02,D,L,2019-20,55,0,9,9,0.16,0,45,0.0,14,55373.0,16:46,0,0,0,0.0,71,101,31,38,-7,0,0,0,36.0,0:0,0,1,1,7655.0,2:19,4000000
8471735,Keith,Yandle,1986-09-09,D,L,2019-20,69,5,40,45,0.65,0,129,3.88,20,81544.0,19:41,0,1,1,0.0,18,51,25,66,-41,2,19,21,15342.0,3:42,0,0,0,231.0,0:3,6350000
8471743,Vladimir,Sobotka,1987-07-02,LW,L,2019-20,16,1,2,3,0.19,2,23,4.35,4,13695.0,14:15,39,31,70,55.71,26,7,3,3,0,0,0,0,5.0,0:0,0,0,0,1600.0,1:40,3500000
8471769,Niklas,Hjalmarsson,1987-06-06,D,L,2019-20,27,1,4,5,0.19,-2,18,5.56,14,30396.0,18:45,0,0,0,0.0,20,45,11,20,-9,0,0,0,38.0,0:1,0,1,1,4319.0,2:39,5000000
8471794,Darren,Helm,1987-01-21,LW,L,2019-20,68,9,7,16,0.24,-6,102,8.82,37,56032.0,13:44,15,13,28,53.57,88,26,24,30,-6,0,0,0,139.0,0:2,1,1,2,6786.0,1:39,3850000
8471804,Nathan,Gerbe,1987-07-24,C,L,2019-20,30,4,6,10,0.33,-7,55,7.27,22,24756.0,13:45,6,6,12,50.0,46,8,4,12,-8,0,0,0,555.0,0:18,0,0,0,720.0,0:24,675000
8471817,Ryan,Reaves,1987-01-20,RW,R,2019-20,74,8,9,17,0.23,-6,62,12.9,49,44856.0,10:6,24,29,53,45.28,328,25,17,7,10,0,0,0,1035.0,0:13,0,0,0,2.0,0:0,2775000
8471873,Anton,Stralman,1986-08-01,D,R,2019-20,69,5,14,19,0.28,-6,89,5.62,14,87211.0,21:3,0,0,0,0.0,68,96,40,48,-8,0,0,0,355.0,0:5,0,1,1,10316.0,2:29,5500000
8471887,Patric,Hornqvist,1987-01-01,RW,R,2019-20,52,17,15,32,0.62,9,168,10.12,36,49708.0,15:55,2,4,6,33.33,107,41,12,8,4,3,4,7,10435.0,3:20,0,0,0,8.0,0:0,5300000
8472382,Andy,Greene,1982-10-30,D,L,2019-20,63,2,12,14,0.22,1,60,3.33,16,73885.0,19:32,0,0,0,0.0,30,155,16,41,-25,0,1,1,102.0,0:1,0,2,2,12120.0,3:12,5000000
8473412,Bryan,Little,1987-11-12,C,R,2019-20,7,2,3,5,0.71,4,13,15.38,2,6783.0,16:9,48,58,106,45.28,3,3,2,2,0,0,0,0,654.0,1:33,0,0,0,564.0,1:20,5291667
8473415,Alex,Biega,1988-04-04,D,R,2019-20,49,0,3,3,0.06,-9,55,0.0,24,48278.0,16:25,0,0,0,0.0,115,46,4,30,-26,0,0,0,72.0,0:1,0,0,0,5059.0,1:43,825000
8473419,Brad,Marchand,1988-05-11,LW,L,2019-20,73,28,59,87,1.19,22,190,14.74,82,85192.0,19:27,24,29,53,45.28,56,20,43,77,-34,5,23,28,16255.0,3:42,1,2,3,6965.0,1:35,6125000
8473422,Nick,Foligno,1987-10-31,LW,L,2019-20,67,10,21,31,0.46,-3,131,7.63,62,75044.0,18:40,159,160,319,49.84,212,50,39,35,4,2,2,4,7678.0,1:54,0,1,1,6016.0,1:29,5500000
8473446,Erik,Johnson,1988-03-21,D,R,2019-20,62,3,13,16,0.26,11,109,2.75,20,77823.0,20:55,0,0,0,0.0,103,116,32,30,2,0,0,0,1356.0,0:21,0,0,0,11208.0,3:0,6000000
8473449,Kyle,Okposo,1988-04-16,RW,R,2019-20,52,9,10,19,0.37,-3,82,10.98,28,40084.0,12:50,38,33,71,53.52,55,15,15,13,2,1,0,1,2113.0,0:40,0,0,0,303.0,0:5,6000000
8473453,Trevor,Lewis,1987-01-08,C,R,2019-20,56,6,6,12,0.21,-7,92,6.52,16,40022.0,11:54,45,71,116,38.79,68,22,11,14,-3,0,0,0,217.0,0:3,0,0,0,2794.0,0:49,2000000
8473463,Leo,Komarov,1987-01-23,C,L,2019-20,48,4,10,14,0.29,2,46,8.7,10,36278.0,12:35,34,52,86,39.53,123,29,13,16,-3,0,0,0,82.0,0:1,0,1,1,3999.0,1:23,3000000
8473473,Milan,Lucic,1988-06-07,LW,L,2019-20,68,8,12,20,0.29,-6,83,9.64,54,54397.0,13:19,20,26,46,43.48,198,20,19,42,-23,5,3,8,6234.0,1:31,0,0,0,36.0,0:0,6000000
8473485,Chris,Stewart,1987-10-30,RW,R,2019-20,16,0,1,1,0.06,-7,5,0.0,21,7469.0,7:46,0,0,0,0.0,35,4,3,1,2,0,0,0,23.0,0:1,0,0,0,23.0,0:1,753757
8473504,Cal,Clutterbuck,1987-11-18,RW,R,2019-20,37,3,4,7,0.19,6,35,8.57,22,29803.0,13:25,4,5,9,44.44,127,38,12,21,-9,0,0,0,97.0,0:2,1,1,2,4949.0,2:13,3500000
8473507,Jeff,Petry,1987-12-09,D,R,2019-20,71,11,29,40,0.56,-10,158,6.96,26,100732.0,23:38,0,0,0,0.0,177,79,30,88,-58,3,9,12,10241.0,2:24,1,0,1,8889.0,2:5,5500000
8473512,Claude,Giroux,1988-01-12,C,R,2019-20,72,21,32,53,0.74,9,205,10.24,28,81660.0,18:54,686,476,1162,59.04,45,16,38,36,2,7,13,20,13513.0,3:7,1,1,2,3935.0,0:54,8275000
8473533,Jordan,Staal,1988-09-10,C,L,2019-20,68,8,19,27,0.4,3,125,6.4,40,71428.0,17:30,699,585,1284,54.44,149,36,30,41,-11,2,1,3,4712.0,1:9,0,0,0,9586.0,2:20,6000000
8473544,Derick,Brassard,1987-09-22,C,L,2019-20,66,10,22,32,0.48,-2,110,9.09,16,54239.0,13:41,197,160,357,55.18,115,24,26,40,-14,3,7,10,6815.0,1:43,0,0,0,163.0,0:2,1200000
8473546,Michael,Grabner,1987-10-05,RW,L,2019-20,46,8,3,11,0.24,-4,61,13.11,6,34133.0,12:22,0,4,4,0.0,21,12,31,11,20,0,0,0,88.0,0:1,1,0,1,6289.0,2:16,3350000
8473548,Phil,Kessel,1987-10-02,RW,R,2019-20,70,14,24,38,0.54,-21,153,9.15,22,72024.0,17:8,2,7,9,22.22,11,20,19,41,-22,9,8,17,13243.0,3:9,0,0,0,175.0,0:2,8000000
8473560,Korbinian,Holzer,1988-02-16,D,R,2019-20,49,1,3,4,0.08,-2,39,2.56,37,47132.0,16:1,0,0,0,0.0,97,96,2,28,-26,0,0,0,79.0,0:1,0,1,1,5016.0,1:42,850000
8473563,Nicklas,Backstrom,1987-11-23,C,L,2019-20,64,12,43,55,0.86,-1,135,8.89,14,73135.0,19:2,532,567,1099,48.41,32,46,36,43,-7,2,17,19,14365.0,3:44,0,0,0,1049.0,0:16,6700000
8473564,Michael,Frolik,1988-02-17,RW,L,2019-20,57,6,8,14,0.25,-12,70,8.57,28,42624.0,12:27,6,15,21,28.57,32,22,32,28,4,0,0,0,47.0,0:0,2,1,3,4679.0,1:22,4300000
8473573,Artem,Anisimov,1988-05-24,C,L,2019-20,49,15,5,20,0.41,-15,87,17.24,8,40715.0,13:50,185,185,370,50.0,6,25,19,16,3,5,1,6,4620.0,1:34,0,0,0,695.0,0:14,4550000
8473604,Jonathan,Toews,1988-04-29,C,L,2019-20,70,18,42,60,0.86,-2,172,10.47,48,83063.0,19:46,856,638,1494,57.3,56,35,58,40,18,1,7,8,13910.0,3:18,1,0,1,8075.0,1:55,10500000
8473618,Mathieu,Perreault,1988-01-05,C,L,2019-20,49,7,8,15,0.31,-9,71,9.86,10,38535.0,13:6,13,6,19,68.42,69,19,17,11,6,2,0,2,4253.0,1:26,0,0,0,0.0,0:0,4125000
8473914,Mark,Letestu,1985-02-04,C,R,2019-20,7,0,0,0,0.0,0,5,0.0,0,4451.0,10:35,25,21,46,54.35,3,5,0,1,-1,0,0,0,70.0,0:10,0,0,0,410.0,0:58,700000
8473986,Alex,Killorn,1989-09-14,LW,L,2019-20,71,27,25,52,0.73,17,133,20.3,22,76157.0,17:52,5,14,19,26.32,66,15,29,27,2,9,6,15,10856.0,2:32,0,0,0,9392.0,2:12,4450000
8473991,Karl,Alzner,1988-09-24,D,L,2019-20,4,0,0,0,0.0,-1,4,0.0,0,3340.0,13:55,0,0,0,0.0,1,4,0,1,-1,0,0,0,0.0,0:0,0,0,0,163.0,0:40,4625000
8473994,Jamie,Benn,1989-07-18,LW,L,2019-20,72,19,20,39,0.54,-8,170,11.18,53,70986.0,16:25,253,199,452,55.97,176,58,52,60,-8,8,6,14,10479.0,2:25,0,0,0,1151.0,0:15,9500000
8474000,Steven,Kampfer,1988-09-24,D,R,2019-20,10,0,2,2,0.2,2,13,0.0,2,8181.0,13:38,0,0,0,0.0,15,8,4,1,3,0,2,2,300.0,0:30,0,0,0,195.0,0:19,800000
8474009,Nick,Bonino,1988-04-20,C,L,2019-20,67,18,17,35,0.52,17,104,17.31,16,66407.0,16:31,488,440,928,52.59,17,89,47,22,25,1,0,1,5793.0,1:26,0,0,0,10471.0,2:36,4100000
8474013,Ian,Cole,1989-02-21,D,L,2019-20,68,4,22,26,0.38,20,94,4.26,36,72028.0,17:39,0,0,0,0.0,86,126,18,40,-22,0,0,0,71.0,0:1,0,0,0,9826.0,2:24,4250000
8474027,Justin,Braun,1987-02-10,D,R,2019-20,65,3,16,19,0.29,-2,73,4.11,18,67215.0,17:14,0,0,0,0.0,94,85,11,34,-23,0,1,1,219.0,0:3,0,0,0,7500.0,1:55,3800000
8474031,Kevin,Shattenkirk,1989-01-29,D,R,2019-20,73,8,26,34,0.47,20,135,5.93,38,82713.0,18:53,0,0,0,0.0,65,68,33,35,-2,1,6,7,5891.0,1:20,0,0,0,1344.0,0:18,6650000
8474034,Patrick,Maroon,1988-04-23,LW,L,2019-20,67,9,15,24,0.36,4,82,10.98,71,50013.0,12:26,6,3,9,66.67,114,14,14,17,-3,1,2,3,6014.0,1:29,0,0,0,83.0,0:1,900000
8474037,James,van Riemsdyk,1989-05-04,LW,L,2019-20,68,19,21,40,0.59,6,153,12.42,10,60459.0,14:49,8,15,23,34.78,27,19,17,16,1,4,5,9,10343.0,2:32,0,0,0,67.0,0:0,7000000
8474038,Paul,Byron,1989-04-27,LW,L,2019-20,29,4,6,10,0.34,5,29,13.79,4,24928.0,14:19,1,5,6,16.67,42,18,11,10,1,0,0,0,293.0,0:10,1,0,1,3172.0,1:49,3400000
8474040,Sam,Gagner,1989-08-10,C,R,2019-20,42,6,7,13,0.31,-10,79,7.59,12,33640.0,13:20,45,57,102,44.12,22,10,12,21,-9,2,1,3,2559.0,1:0,0,0,0,32.0,0:0,3150000
8474053,Logan,Couture,1989-03-28,C,L,2019-20,52,16,23,39,0.75,0,126,12.7,18,57806.0,18:31,195,248,443,44.02,54,45,28,26,2,0,9,9,8585.0,2:45,0,2,2,5276.0,1:41,8000000
8474056,P.K.,Subban,1989-05-13,D,R,2019-20,68,7,11,18,0.26,-21,151,4.64,79,90265.0,22:7,0,0,0,0.0,88,90,19,65,-46,2,4,6,9614.0,2:21,0,0,0,6690.0,1:38,9000000
8474062,Riley,Nash,1989-05-09,C,R,2019-20,64,5,9,14,0.22,6,64,7.81,10,45479.0,11:50,245,267,512,47.85,68,36,25,10,15,0,0,0,140.0,0:2,1,0,1,4154.0,1:4,2750000
8474068,Kyle,Turris,1989-08-14,C,R,2019-20,62,9,22,31,0.5,-9,88,10.23,22,57378.0,15:25,246,272,518,47.49,18,25,21,29,-8,2,8,10,8588.0,2:18,0,0,0,2390.0,0:38,6000000
8474090,Brendan,Smith,1989-02-08,D,L,2019-20,62,3,5,8,0.13,-12,45,6.67,71,41298.0,11:6,1,0,1,100.0,90,41,18,24,-6,0,0,0,187.0,0:3,1,1,2,7686.0,2:3,4350000
8474091,Brandon,Sutter,1989-02-14,C,R,2019-20,44,8,9,17,0.39,1,76,10.53,25,39203.0,14:50,185,193,378,48.94,18,15,15,9,6,1,2,3,2280.0,0:51,0,0,0,6256.0,2:22,4375000
8474098,Colton,Sceviour,1989-04-20,C,R,2019-20,69,6,10,16,0.23,2,114,5.26,6,54838.0,13:14,65,83,148,43.92,91,72,26,35,-9,0,0,0,83.0,0:1,0,0,0,10352.0,2:30,1200000
8474102,David,Perron,1988-05-28,LW,R,2019-20,74,27,35,62,0.84,1,172,15.7,54,81249.0,18:17,3,5,8,37.5,71,21,39,36,3,10,18,28,13441.0,3:1,0,0,0,141.0,0:1,4000000
8474125,Carl,Gunnarsson,1986-11-09,D,L,2019-20,38,2,5,7,0.18,8,33,6.06,20,35922.0,15:45,0,0,0,0.0,29,53,3,16,-13,0,0,0,38.0,0:1,0,1,1,4577.0,2:0,1750000
8474134,Yannick,Weber,1988-09-23,D,R,2019-20,41,1,2,3,0.07,-1,45,2.22,14,34469.0,14:0,0,0,0,0.0,37,38,11,11,0,0,0,0,158.0,0:3,0,0,0,607.0,0:14,675000
8474141,Patrick,Kane,1988-11-19,RW,L,2019-20,70,33,51,84,1.2,8,275,12.0,40,89631.0,21:20,1,3,4,25.0,24,19,43,41,2,8,15,23,15575.0,3:42,0,0,0,135.0,0:1,10500000
8474145,Robert,Bortuzzo,1989-03-18,D,R,2019-20,43,2,4,6,0.14,10,36,5.56,21,33746.0,13:4,0,0,0,0.0,69,44,2,11,-9,0,0,0,11.0,0:0,0,0,0,6478.0,2:30,1375000
8474149,Evgenii,Dadonov,1989-03-12,RW,L,2019-20,69,25,22,47,0.68,-7,167,14.97,10,70816.0,17:6,0,0,0,0.0,29,24,29,40,-11,11,6,17,13833.0,3:20,0,0,0,44.0,0:0,4000000
8474150,Mikael,Backlund,1989-03-17,C,L,2019-20,70,16,29,45,0.64,3,157,10.19,26,75283.0,17:55,368,410,778,47.3,44,11,64,55,9,3,7,10,5897.0,1:24,3,0,3,6687.0,1:35,5350000
8474151,Ryan,McDonagh,1989-06-13,D,L,2019-20,53,1,12,13,0.25,7,57,1.75,19,66581.0,20:56,0,0,0,0.0,42,108,25,34,-9,0,0,0,352.0,0:6,0,1,1,10399.0,3:16,6750000
8474157,Max,Pacioretty,1988-11-20,LW,L,2019-20,71,32,34,66,0.93,18,307,10.42,44,76319.0,17:54,51,45,96,53.12,90,35,32,55,-23,8,11,19,10443.0,2:27,0,0,0,135.0,0:1,7000000
8474161,Jakub,Voracek,1989-08-15,RW,L,2019-20,71,12,45,57,0.8,15,135,8.89,33,72726.0,17:4,7,13,20,35.0,18,21,30,31,-1,4,13,17,12798.0,3:0,0,0,0,122.0,0:1,8250000
8474162,Jake,Muzzin,1989-02-21,D,L,2019-20,53,6,17,23,0.43,12,99,6.06,40,68672.0,21:35,0,0,0,0.0,109,110,24,63,-39,0,0,0,849.0,0:16,0,1,1,8023.0,2:31,4000000
8474166,Alec,Martinez,1987-07-26,D,L,2019-20,54,3,13,16,0.3,-3,79,3.8,23,70069.0,21:37,0,0,0,0.0,45,126,15,35,-20,0,4,4,4633.0,1:25,0,0,0,5630.0,1:44,4000000
8474176,Carl,Hagelin,1988-08-23,LW,L,2019-20,61,8,18,26,0.43,12,108,7.41,18,52041.0,14:13,13,16,29,44.83,26,20,24,25,-1,0,0,0,49.0,0:0,1,2,3,10487.0,2:51,2750000
8474189,Lars,Eller,1989-05-08,C,L,2019-20,70,16,24,40,0.57,3,152,10.53,48,71446.0,17:0,544,499,1043,52.16,64,44,44,41,3,2,4,6,7201.0,1:42,1,1,2,10027.0,2:23,3500000
8474190,Wayne,Simmonds,1988-08-26,RW,R,2019-20,68,8,17,25,0.37,-21,119,6.72,66,60882.0,14:55,29,45,74,39.19,145,29,27,18,9,5,4,9,10586.0,2:35,0,0,0,3.0,0:0,5000000
8474207,Nick,Holden,1987-05-15,D,L,2019-20,64,6,9,15,0.23,-1,106,5.66,13,71140.0,18:31,0,0,0,0.0,142,75,26,35,-9,1,0,1,261.0,0:4,0,1,1,7150.0,1:51,2200000
8474218,Jason,Demers,1988-06-09,D,R,2019-20,50,0,11,11,0.22,5,53,0.0,25,61484.0,20:29,0,0,0,0.0,76,70,15,32,-17,0,0,0,493.0,0:9,0,1,1,6819.0,2:16,4500000
8474230,Micheal,Haley,1986-03-30,C,L,2019-20,22,1,0,1,0.05,-7,9,11.11,50,7295.0,5:31,7,5,12,58.33,36,6,1,5,-4,0,0,0,2.0,0:0,0,0,0,26.0,0:1,700000
8474250,Zack,Smith,1988-04-05,LW,L,2019-20,50,4,7,11,0.22,2,43,9.3,29,35360.0,11:47,88,102,190,46.32,112,18,21,14,7,0,0,0,525.0,0:10,1,1,2,3698.0,1:13,3250000
8474291,Jay,Beagle,1985-10-16,C,R,2019-20,55,2,6,8,0.15,-9,49,4.08,38,41461.0,12:33,401,277,678,59.14,69,42,14,7,7,0,0,0,173.0,0:3,1,1,2,10010.0,3:2,3000000
8474563,Drew,Doughty,1989-12-08,D,R,2019-20,67,7,28,35,0.52,-16,141,4.96,36,103776.0,25:48,0,0,0,0.0,106,87,15,82,-67,5,9,14,12511.0,3:6,0,1,1,8480.0,2:6,11000000
8474564,Steven,Stamkos,1990-02-07,C,R,2019-20,57,29,37,66,1.16,14,176,16.48,22,62997.0,18:25,365,307,672,54.32,69,38,24,33,-9,10,9,19,11237.0,3:17,0,0,0,1759.0,0:30,8500000
8474565,Alex,Pietrangelo,1990-01-18,D,R,2019-20,73,16,36,52,0.71,11,232,6.9,22,105689.0,24:7,0,0,0,0.0,48,98,43,47,-4,6,16,22,13719.0,3:7,0,1,1,8319.0,1:53,6500000
8474567,Zach,Bogosian,1990-07-15,D,R,2019-20,29,1,6,7,0.24,-1,35,2.86,24,29240.0,16:48,0,0,0,0.0,36,28,4,13,-9,0,0,0,121.0,0:4,0,1,1,3632.0,2:5,5142857
8474568,Luke,Schenn,1989-11-02,D,R,2019-20,25,1,2,3,0.12,-8,31,3.23,23,18677.0,12:27,0,0,0,0.0,83,21,5,10,-5,0,0,0,52.0,0:2,0,0,0,2426.0,1:37,700000
8474569,Colin,Wilson,1989-10-20,C,L,2019-20,9,0,4,4,0.44,6,12,0.0,0,6826.0,12:38,3,4,7,42.86,8,2,1,3,-2,0,0,0,921.0,1:42,0,0,0,0.0,0:0,2600000
8474571,Mikkel,Boedker,1989-12-16,LW,L,2019-20,20,2,2,4,0.2,-1,29,6.9,0,11657.0,9:42,1,3,4,25.0,12,5,1,8,-7,0,0,0,875.0,0:43,1,0,1,651.0,0:32,4000000
8474573,Josh,Bailey,1989-10-02,RW,L,2019-20,68,14,29,43,0.63,-12,94,14.89,10,68946.0,16:53,128,128,256,50.0,20,48,38,54,-16,2,7,9,7338.0,1:47,1,0,1,5860.0,1:26,5000000
8474574,Tyler,Myers,1990-02-01,D,R,2019-20,68,6,15,21,0.31,-7,134,4.48,49,87751.0,21:30,0,0,0,0.0,99,108,42,41,1,1,6,7,5368.0,1:18,1,0,1,6595.0,1:36,6000000
8474578,Erik,Karlsson,1990-05-31,D,R,2019-20,56,6,34,40,0.71,-15,120,5.0,16,82397.0,24:31,0,0,0,0.0,26,74,52,68,-16,1,12,13,10093.0,3:0,1,0,1,8654.0,2:34,11500000
8474579,Luca,Sbisa,1990-01-30,D,L,2019-20,44,2,8,10,0.23,1,49,4.08,37,47355.0,17:56,0,0,0,0.0,91,71,4,26,-22,0,0,0,74.0,0:1,0,0,0,5185.0,1:57,750000
8474581,Jake,Gardiner,1990-07-04,D,L,2019-20,68,4,20,24,0.35,-24,87,4.6,30,67973.0,16:39,0,0,0,0.0,43,42,32,39,-7,1,10,11,7308.0,1:47,0,0,0,172.0,0:2,4050000
8474584,Michael,Del Zotto,1990-06-24,D,L,2019-20,49,2,13,15,0.31,5,57,3.51,14,55033.0,18:43,0,0,0,0.0,101,55,9,33,-24,0,1,1,2327.0,0:47,0,0,0,4106.0,1:23,750000
8474586,Jordan,Eberle,1990-05-15,C,R,2019-20,58,16,24,40,0.69,1,136,11.76,12,61985.0,17:48,3,6,9,33.33,37,39,34,37,-3,4,7,11,9029.0,2:35,0,0,0,36.0,0:0,5500000
8474589,Tyler,Ennis,1989-10-06,LW,L,2019-20,70,16,21,37,0.53,-6,159,10.06,20,61776.0,14:42,7,8,15,46.67,96,26,26,19,7,5,5,10,9020.0,2:8,0,0,0,104.0,0:1,800000
8474590,John,Carlson,1990-01-10,D,R,2019-20,69,15,60,75,1.09,12,189,7.94,26,101954.0,24:37,0,1,1,0.0,55,108,42,80,-38,2,24,26,16663.0,4:1,0,0,0,6156.0,1:29,8000000
8474597,Cody,Goloubef,1989-11-30,D,R,2019-20,26,1,1,2,0.08,-3,18,5.56,8,23693.0,15:11,0,0,0,0.0,45,24,3,21,-18,0,0,0,48.0,0:1,0,0,0,2361.0,1:30,800000
8474600,Roman,Josi,1990-06-01,D,L,2019-20,69,16,49,65,0.94,22,260,6.15,41,106725.0,25:46,0,0,0,0.0,52,108,34,68,-34,4,19,23,13569.0,3:16,0,0,0,8311.0,2:0,4000000
8474602,Justin,Schultz,1990-07-06,D,R,2019-20,46,3,9,12,0.26,-13,86,3.49,6,54855.0,19:52,0,0,0,0.0,36,50,6,18,-12,0,6,6,7575.0,2:44,0,0,0,443.0,0:9,5500000
8474604,Aaron,Ness,1990-05-18,D,L,2019-20,24,0,1,1,0.04,1,11,0.0,0,18050.0,12:32,0,0,0,0.0,17,20,1,8,-7,0,0,0,54.0,0:2,0,0,0,241.0,0:10,725000
8474611,Cameron,Gaunce,1990-03-19,D,L,2019-20,3,1,3,4,1.33,2,5,20.0,4,2136.0,11:52,0,0,0,0.0,5,2,0,0,0,0,0,0,0.0,0:0,0,0,0,91.0,0:30,700000
8474612,Travis,Hamonic,1990-08-16,D,R,2019-20,50,3,9,12,0.24,-3,83,3.61,27,63584.0,21:11,0,0,0,0.0,39,110,21,36,-15,0,0,0,226.0,0:4,0,0,0,9338.0,3:6,3857143
8474613,Derek,Stepan,1990-06-18,C,R,2019-20,70,10,18,28,0.4,-4,158,6.33,16,74097.0,17:38,569,628,1197,47.54,43,54,38,28,10,1,6,7,7053.0,1:40,1,0,1,8336.0,1:59,6500000
8474618,Marco,Scandella,1990-02-23,D,L,2019-20,65,4,9,13,0.2,15,79,5.06,20,68830.0,17:38,0,0,0,0.0,80,63,18,50,-32,0,0,0,201.0,0:3,0,0,0,8235.0,2:6,4000000
8474628,Michael,Stone,1990-06-07,D,R,2019-20,33,2,5,7,0.21,-5,57,3.51,16,32285.0,16:18,0,0,0,0.0,52,54,6,9,-3,0,0,0,32.0,0:0,0,0,0,2370.0,1:11,3500000
8474641,Adam,Henrique,1990-02-06,C,L,2019-20,71,26,17,43,0.61,-2,169,15.38,22,71872.0,16:52,512,418,930,55.05,75,32,26,32,-6,5,4,9,9907.0,2:19,0,0,0,2387.0,0:33,5825000
8474668,Dale,Weise,1988-08-05,RW,R,2019-20,23,1,4,5,0.22,1,15,6.67,16,12788.0,9:16,0,0,0,0.0,70,10,8,12,-4,0,0,0,70.0,0:3,0,0,0,440.0,0:19,2350000
8474673,TJ,Brodie,1990-06-07,D,L,2019-20,64,4,15,19,0.3,7,65,6.15,36,78527.0,20:26,0,0,0,0.0,20,87,34,52,-18,0,1,1,2387.0,0:37,0,0,0,6355.0,1:39,4650400
8474679,Gustav,Nyquist,1989-09-01,RW,L,2019-20,70,15,27,42,0.6,4,151,9.93,16,75736.0,18:1,17,16,33,51.52,37,26,27,41,-14,3,6,9,10831.0,2:34,1,0,1,2756.0,0:39,5500000
8474683,Derek,Grant,1990-04-20,C,L,2019-20,59,15,11,26,0.44,2,98,15.31,30,48933.0,13:49,375,349,724,51.8,56,28,23,11,12,2,0,2,2496.0,0:42,3,2,5,8421.0,2:22,700000
8474685,Matt,Calvert,1989-12-24,LW,L,2019-20,53,12,13,25,0.47,12,96,12.5,41,44630.0,14:2,12,14,26,46.15,65,23,22,14,8,0,0,0,160.0,0:3,3,1,4,6942.0,2:10,2850000
8474688,Greg,Pateryn,1990-06-20,D,R,2019-20,20,0,3,3,0.15,1,22,0.0,6,18565.0,15:28,0,0,0,0.0,25,30,3,6,-3,0,0,0,123.0,0:6,0,0,0,2442.0,2:2,2250000
8474697,Mark,Borowiecki,1989-07-12,D,L,2019-20,53,7,11,18,0.34,1,63,11.11,58,57047.0,17:56,0,0,0,0.0,199,120,10,30,-20,0,0,0,95.0,0:1,1,0,1,7612.0,2:23,1200000
8474709,Matt,Martin,1989-05-08,LW,L,2019-20,55,5,3,8,0.15,-1,49,10.2,40,34397.0,10:25,3,4,7,42.86,242,24,11,17,-6,0,0,0,265.0,0:4,0,0,0,633.0,0:11,2500000
8474715,Cam,Atkinson,1989-06-05,RW,R,2019-20,44,12,14,26,0.59,2,148,8.11,6,47111.0,17:50,27,30,57,47.37,18,21,26,21,5,3,5,8,6021.0,2:16,0,0,0,4168.0,1:34,5875000
8474716,Jared,Spurgeon,1989-11-29,D,R,2019-20,62,12,20,32,0.52,-1,112,10.71,18,83972.0,22:34,0,1,1,0.0,61,102,10,23,-13,3,10,13,9207.0,2:28,0,0,0,9108.0,2:26,5187500
8474717,Mark,Barberio,1990-03-23,D,L,2019-20,21,0,2,2,0.1,3,29,0.0,16,17765.0,14:5,0,0,0,0.0,13,19,6,13,-7,0,0,0,133.0,0:6,0,0,0,1303.0,1:2,1450000
8474722,Luke,Witkowski,1990-04-14,RW,R,2019-20,12,1,2,3,0.25,-4,10,10.0,13,6338.0,8:48,0,0,0,0.0,38,3,2,2,0,0,0,0,34.0,0:2,0,0,0,67.0,0:5,700000
8474736,Zac,Rinaldo,1990-06-15,C,L,2019-20,19,3,2,5,0.26,-1,19,15.79,34,9427.0,8:16,0,0,0,0.0,69,8,5,5,0,0,0,0,12.0,0:0,0,0,0,0.0,0:0,700000
8474774,Dalton,Prout,1990-03-13,D,R,2019-20,2,0,0,0,0.0,0,2,0.0,7,1537.0,12:48,0,0,0,0.0,3,3,2,0,2,0,0,0,0.0,0:0,0,0,0,51.0,0:25,800000
8474818,Jordie,Benn,1987-07-26,D,L,2019-20,44,1,6,7,0.16,-7,58,1.72,17,42996.0,16:17,0,0,0,0.0,45,62,7,17,-10,0,0,0,123.0,0:2,0,0,0,6218.0,2:21,2000000
8474849,Antoine,Roussel,1989-11-21,LW,L,2019-20,41,7,6,13,0.32,0,55,12.73,43,29113.0,11:50,6,6,12,50.0,44,14,7,13,-6,1,1,2,3210.0,1:18,0,0,0,26.0,0:0,3000000
8474870,Tyler,Johnson,1990-07-29,C,R,2019-20,68,16,18,34,0.5,8,118,13.56,18,59211.0,14:30,177,189,366,48.36,67,23,15,20,-5,2,7,9,7965.0,1:57,0,0,0,291.0,0:4,5000000
8474873,Brian,Lashoff,1990-07-16,D,L,2019-20,9,0,1,1,0.11,1,6,0.0,6,7861.0,14:33,0,0,0,0.0,16,7,0,2,-2,0,0,0,1.0,0:0,0,0,0,731.0,1:21,700000
8474884,Mike,Hoffman,1989-11-24,LW,L,2019-20,69,29,30,59,0.86,-5,214,13.55,28,69708.0,16:50,7,8,15,46.67,33,22,31,52,-21,11,10,21,15143.0,3:39,0,0,0,98.0,0:1,5187500
8475098,Tyler,Bozak,1986-03-19,C,R,2019-20,70,13,17,30,0.43,0,115,11.3,10,64485.0,15:21,385,314,699,55.08,33,36,30,22,8,2,2,4,6879.0,1:38,1,0,1,6191.0,1:28,5000000
8475149,Marcus,Johansson,1990-10-06,LW,L,2019-20,60,9,21,30,0.5,-12,87,10.34,20,61730.0,17:8,196,294,490,40.0,39,22,15,24,-9,1,5,6,8872.0,2:27,0,0,0,1165.0,0:19,4500000
8475151,Kyle,Palmieri,1991-02-01,RW,R,2019-20,65,25,20,45,0.69,-4,155,16.13,41,66731.0,17:6,12,25,37,32.43,74,36,29,28,1,11,7,18,12377.0,3:10,0,0,0,840.0,0:12,4650000
8475158,Ryan,O'Reilly,1991-02-07,C,L,2019-20,74,12,52,64,0.86,12,122,9.84,10,91686.0,20:39,923,692,1615,57.15,17,43,71,24,47,2,17,19,12979.0,2:55,1,0,1,9914.0,2:13,7500000
8475160,Kyle,Clifford,1991-01-13,LW,L,2019-20,69,7,10,17,0.25,-7,110,6.36,68,46368.0,11:12,6,4,10,60.0,133,15,11,17,-6,0,0,0,428.0,0:6,0,0,0,497.0,0:7,1600000
8475163,Alex,Chiasson,1990-10-01,RW,R,2019-20,65,11,13,24,0.37,-3,97,11.34,42,51182.0,13:7,0,4,4,0.0,56,15,14,20,-6,6,7,13,8633.0,2:12,0,0,0,31.0,0:0,2150000
8475164,Jakob,Silfverberg,1990-10-13,RW,R,2019-20,66,21,18,39,0.59,0,155,13.55,14,70026.0,17:41,8,33,41,19.51,28,41,40,32,8,4,3,7,9423.0,2:22,2,0,2,6575.0,1:39,5250000
8475166,John,Tavares,1990-09-20,C,L,2019-20,63,26,34,60,0.95,-7,197,13.2,24,73897.0,19:32,617,499,1116,55.29,32,31,35,47,-12,7,14,21,11380.0,3:0,0,0,0,64.0,0:1,11000000
8475167,Victor,Hedman,1990-12-18,D,L,2019-20,69,11,45,56,0.81,27,158,6.96,31,97936.0,23:39,0,0,0,0.0,75,101,48,40,8,4,19,23,12304.0,2:58,0,0,0,9623.0,2:19,7875000
8475168,Matt,Duchene,1991-01-16,C,L,2019-20,66,13,29,42,0.64,-4,136,9.56,24,66847.0,16:52,390,305,695,56.12,40,22,31,36,-5,5,6,11,10478.0,2:38,0,0,0,92.0,0:1,8000000
8475169,Evander,Kane,1991-08-02,LW,L,2019-20,64,26,21,47,0.73,-12,216,12.04,122,75028.0,19:32,106,95,201,52.74,135,25,45,51,-6,14,4,18,10444.0,2:43,2,0,2,5217.0,1:21,7000000
8475170,Brayden,Schenn,1991-08-22,C,L,2019-20,74,25,35,60,0.81,1,141,17.73,44,81538.0,18:21,359,382,741,48.45,124,22,27,40,-13,10,12,22,12845.0,2:53,0,0,0,1052.0,0:14,5125000
8475171,Oliver,Ekman-Larsson,1991-07-17,D,L,2019-20,66,9,21,30,0.45,-3,135,6.67,38,91114.0,23:0,0,0,0,0.0,129,65,19,45,-26,2,5,7,10577.0,2:40,1,0,1,8192.0,2:4,8250000
8475172,Nazem,Kadri,1990-10-06,C,L,2019-20,54,20,20,40,0.74,8,147,13.61,97,56843.0,17:32,427,335,762,56.04,65,9,22,30,-8,5,9,14,12483.0,3:51,0,0,0,369.0,0:6,4500000
8475176,Ryan,Ellis,1991-01-03,D,R,2019-20,49,8,30,38,0.78,16,114,7.02,19,69103.0,23:30,0,0,0,0.0,48,96,24,36,-12,2,7,9,6518.0,2:13,0,0,0,6915.0,2:21,6250000
8475177,Calvin,de Haan,1991-05-09,D,L,2019-20,29,1,5,6,0.21,10,42,2.38,10,34645.0,19:54,0,0,0,0.0,93,73,9,29,-20,0,0,0,183.0,0:6,0,0,0,4678.0,2:41,4550000
8475178,Zack,Kassian,1991-01-24,RW,R,2019-20,59,15,19,34,0.58,0,99,15.15,69,55444.0,15:39,1,2,3,33.33,157,8,26,45,-19,0,0,0,1457.0,0:24,0,0,0,76.0,0:1,1950000
8475179,Dmitry,Kulikov,1990-10-29,D,L,2019-20,51,2,8,10,0.2,-4,54,3.7,32,61259.0,20:1,0,0,0,0.0,104,77,16,55,-39,0,0,0,380.0,0:7,0,0,0,4188.0,1:22,4333333
8475181,Nick,Leddy,1991-03-20,D,L,2019-20,60,3,18,21,0.35,-1,72,4.17,14,76004.0,21:6,0,0,0,0.0,62,72,17,52,-35,1,3,4,4214.0,1:10,0,0,0,2973.0,0:49,5500000
8475184,Chris,Kreider,1991-04-30,LW,L,2019-20,63,24,21,45,0.71,13,156,15.38,58,65204.0,17:14,53,70,123,43.09,116,42,22,61,-39,9,4,13,13113.0,3:28,0,0,0,114.0,0:1,4625000
8475186,John,Moore,1990-11-19,D,L,2019-20,24,2,1,3,0.12,-2,33,6.06,11,23822.0,16:32,0,0,0,0.0,36,27,2,7,-5,0,0,0,261.0,0:10,0,0,0,2734.0,1:53,2750000
8475188,Brayden,McNabb,1991-01-21,D,L,2019-20,74,2,8,10,0.14,2,76,2.63,44,88795.0,19:59,0,0,0,0.0,209,140,32,33,-1,0,0,0,251.0,0:3,1,0,1,13621.0,3:4,2500000
8475191,Reilly,Smith,1991-04-01,RW,L,2019-20,74,27,29,56,0.76,20,173,15.61,20,79360.0,17:52,3,9,12,25.0,60,30,59,42,17,3,3,6,8556.0,1:55,2,2,4,8566.0,1:55,5000000
8475193,Tomas,Tatar,1990-12-01,LW,L,2019-20,68,22,39,61,0.9,5,162,13.58,36,66480.0,16:17,9,16,25,36.0,79,24,31,29,2,8,6,14,8918.0,2:11,0,0,0,115.0,0:1,5300000
8475197,Tyson,Barrie,1991-07-26,D,R,2019-20,70,5,34,39,0.56,-7,169,2.96,16,91885.0,21:52,0,0,0,0.0,47,76,16,62,-46,1,11,12,11204.0,2:40,0,0,0,145.0,0:2,5500000
8475200,Dmitry,Orlov,1991-07-23,D,L,2019-20,72,4,24,28,0.39,4,111,3.6,38,96675.0,22:22,0,0,0,0.0,111,88,50,68,-18,1,5,6,6530.0,1:30,0,1,1,3768.0,0:52,5100000
8475204,Brandon,Pirri,1991-04-10,RW,L,2019-20,16,0,2,2,0.12,-4,24,0.0,8,12062.0,12:33,6,3,9,66.67,16,5,8,4,4,0,0,0,1682.0,1:45,0,0,0,7.0,0:0,775000
8475208,Brian,Dumoulin,1991-09-06,D,L,2019-20,28,1,7,8,0.29,17,35,2.86,10,35373.0,21:3,0,0,0,0.0,44,35,13,13,0,0,1,1,1102.0,0:39,1,0,1,3580.0,2:7,4100000
8475209,Richard,Panik,1991-02-07,RW,L,2019-20,62,10,13,23,0.37,16,68,14.71,38,42353.0,11:23,11,8,19,57.89,79,21,23,31,-8,0,0,0,774.0,0:12,0,0,0,2096.0,0:33,2750000
8475218,Mattias,Ekholm,1990-05-24,D,L,2019-20,68,8,25,33,0.49,-1,154,5.19,32,95363.0,23:22,0,0,0,0.0,49,100,51,50,1,0,5,5,5414.0,1:19,1,1,2,11540.0,2:49,3750000
8475220,Marcus,Foligno,1991-08-10,LW,L,2019-20,59,11,14,25,0.42,8,86,12.79,30,51636.0,14:35,9,15,24,37.5,184,36,31,17,14,0,0,0,115.0,0:1,0,0,0,6434.0,1:49,2875000
8475222,Sami,Vatanen,1991-06-03,D,R,2019-20,47,5,18,23,0.49,-12,95,5.26,22,61336.0,21:45,0,0,0,0.0,50,80,14,24,-10,1,9,10,8582.0,3:2,0,1,1,5544.0,1:57,4875000
8475224,Jordan,Szwarz,1991-05-14,RW,R,2019-20,3,0,0,0,0.0,0,2,0.0,2,886.0,4:55,4,5,9,44.44,6,1,0,0,0,0,0,0,0.0,0:0,0,0,0,0.0,0:0,800000
8475225,Craig,Smith,1989-09-05,RW,R,2019-20,69,18,13,31,0.45,18,184,9.78,34,55578.0,13:25,14,15,29,48.28,60,19,26,26,0,4,3,7,9507.0,2:17,0,0,0,37.0,0:0,4250000
8475231,Casey,Cizikas,1991-02-27,C,L,2019-20,48,10,4,14,0.29,12,67,14.93,41,41166.0,14:17,368,320,688,53.49,133,39,38,28,10,0,0,0,134.0,0:2,3,2,5,6720.0,2:20,3350000
8475233,David,Savard,1990-10-22,D,R,2019-20,68,0,11,11,0.16,-3,97,0.0,35,84397.0,20:41,0,0,0,0.0,129,163,18,43,-25,0,2,2,868.0,0:12,0,0,0,7484.0,1:50,4250000
8475235,Nicolas,Deslauriers,1991-02-22,LW,L,2019-20,59,7,6,13,0.22,-1,64,10.94,92,34613.0,9:46,0,0,0,0.0,137,32,10,10,0,0,0,0,182.0,0:3,0,0,0,93.0,0:1,950000
8475236,Cody,Eakin,1991-05-24,C,L,2019-20,49,5,10,15,0.31,-3,61,8.2,16,42855.0,14:34,312,329,641,48.67,49,16,23,21,2,0,1,1,1227.0,0:25,0,0,0,5536.0,1:52,3850000
8475246,Kevin,Connauton,1990-02-23,D,L,2019-20,4,0,0,0,0.0,-2,4,0.0,0,3720.0,15:30,0,0,0,0.0,6,6,0,0,0,0,0,0,25.0,0:6,0,0,0,289.0,1:12,1375000
8475254,Gabriel,Dumont,1990-10-06,C,R,2019-20,3,0,0,0,0.0,-1,3,0.0,0,2071.0,11:30,6,9,15,40.0,9,2,1,0,1,0,0,0,24.0,0:8,0,0,0,12.0,0:4,700000
8475268,Gabriel,Bourque,1990-09-23,LW,L,2019-20,52,2,4,6,0.12,-1,33,6.06,7,26841.0,8:36,2,3,5,40.0,125,40,5,14,-9,0,0,0,252.0,0:4,0,0,0,820.0,0:15,700000
8475279,Ben,Chiarot,1991-05-09,D,L,2019-20,69,9,12,21,0.3,5,130,6.92,61,95773.0,23:8,0,0,0,0.0,152,128,18,86,-68,0,0,0,1116.0,0:16,0,0,0,12624.0,3:2,3500000
8475287,Erik,Haula,1991-03-23,LW,L,2019-20,48,12,12,24,0.5,1,92,13.04,22,45592.0,15:49,381,323,704,54.12,27,15,21,29,-8,4,4,8,6623.0,2:17,0,0,0,2214.0,0:46,2750000
8475314,Anders,Lee,1990-07-03,LW,L,2019-20,68,20,23,43,0.63,8,195,10.26,47,74649.0,18:17,90,109,199,45.23,102,50,24,44,-20,2,5,7,9321.0,2:17,0,0,0,59.0,0:0,7000000
8475324,Nick,Jensen,1990-09-21,D,R,2019-20,71,0,8,8,0.11,0,63,0.0,13,75606.0,17:44,0,0,0,0.0,60,74,28,55,-27,0,1,1,235.0,0:3,0,0,0,10012.0,2:21,2500000
8475343,Nic,Dowd,1990-05-27,C,R,2019-20,59,7,8,15,0.25,9,55,12.73,28,38739.0,10:56,284,292,576,49.31,124,28,23,7,16,0,0,0,65.0,0:1,3,0,3,8748.0,2:28,750000
8475413,Justin,Dowling,1990-10-01,C,L,2019-20,29,3,3,6,0.21,-3,29,10.34,8,19061.0,10:57,42,54,96,43.75,25,12,15,9,6,0,0,0,2137.0,1:13,0,0,0,138.0,0:4,750000
8475430,Brandon,Manning,1990-06-04,D,L,2019-20,9,1,0,1,0.11,-1,8,12.5,17,5965.0,11:2,0,0,0,0.0,10,6,1,8,-7,0,0,0,0.0,0:0,0,0,0,0.0,0:0,2250000
8475455,Brenden,Dillon,1990-11-13,D,L,2019-20,72,1,13,14,0.19,-1,63,1.59,106,84491.0,19:33,0,0,0,0.0,206,80,16,29,-13,0,0,0,201.0,0:2,0,1,1,9202.0,2:7,3270000
8475461,Andrew,Agozzino,1991-01-03,LW,L,2019-20,22,1,2,3,0.14,3,10,10.0,4,9709.0,7:21,38,37,75,50.67,25,7,5,4,1,0,0,0,598.0,0:27,0,0,0,85.0,0:3,700000
8475462,Radko,Gudas,1990-06-05,D,R,2019-20,65,2,15,17,0.26,15,91,2.2,40,65182.0,16:42,0,0,0,0.0,167,79,23,36,-13,0,0,0,216.0,0:3,0,0,0,10625.0,2:43,3350000
8475625,Matt,Irwin,1987-11-29,D,L,2019-20,36,0,3,3,0.08,-15,58,0.0,15,31260.0,14:28,0,0,0,0.0,80,54,8,13,-5,0,0,0,93.0,0:2,0,0,0,2029.0,0:56,675000
8475690,Christopher,Tanev,1989-12-20,D,R,2019-20,69,2,18,20,0.29,4,45,4.44,41,80860.0,19:31,0,0,0,0.0,32,159,20,45,-25,0,1,1,304.0,0:4,0,1,1,14113.0,3:24,4450000
8475692,Mats,Zuccarello,1987-09-01,RW,L,2019-20,65,15,22,37,0.57,-9,96,15.62,18,62164.0,15:56,9,5,14,64.29,13,36,33,17,16,3,4,7,9562.0,2:27,0,0,0,113.0,0:1,6000000
8475714,Calle,Jarnkrok,1991-09-25,C,R,2019-20,64,15,19,34,0.53,4,136,11.03,14,61191.0,15:56,33,37,70,47.14,28,27,19,11,8,2,7,9,6908.0,1:47,2,0,2,6055.0,1:34,2000000
8475716,Martin,Marincin,1992-02-18,D,L,2019-20,26,1,3,4,0.15,-1,28,3.57,14,23699.0,15:11,0,0,0,0.0,22,43,9,22,-13,0,0,0,27.0,0:1,0,0,0,2594.0,1:39,700000
8475718,Justin,Holl,1992-01-30,D,R,2019-20,68,2,16,18,0.26,13,89,2.25,43,75517.0,18:30,0,0,0,0.0,89,83,21,59,-38,0,0,0,167.0,0:2,0,0,0,8074.0,1:58,675000
8475722,Jason,Zucker,1992-01-16,LW,L,2019-20,60,20,21,41,0.68,-4,111,18.02,21,58814.0,16:20,12,29,41,29.27,53,23,31,25,6,7,5,12,8229.0,2:17,0,0,0,376.0,0:6,5500000
8475726,Tyler,Toffoli,1992-04-24,C,R,2019-20,68,24,20,44,0.65,-1,203,11.82,20,68671.0,16:49,4,10,14,28.57,48,16,35,34,1,5,5,10,8838.0,2:9,0,0,0,3723.0,0:54,4600000
8475728,Johan,Larsson,1992-07-25,C,L,2019-20,62,6,12,18,0.29,8,60,10.0,26,55424.0,14:53,322,346,668,48.2,85,31,24,23,1,0,0,0,293.0,0:4,0,0,0,7477.0,2:0,1550000
8475730,Stephen,Johns,1992-04-18,D,R,2019-20,20,2,3,5,0.25,-2,37,5.41,10,20994.0,17:29,0,0,0,0.0,64,24,6,12,-6,0,0,0,107.0,0:5,0,0,0,995.0,0:49,2350000
8475735,Greg,McKegg,1992-06-17,C,L,2019-20,53,5,4,9,0.17,-2,40,12.5,17,30416.0,9:33,104,107,211,49.29,69,24,14,13,1,0,0,0,61.0,0:1,1,1,2,2996.0,0:56,750000
8475738,Jordan,Weal,1992-04-15,C,R,2019-20,49,8,7,15,0.31,-8,86,9.3,14,40023.0,13:36,96,97,193,49.74,32,21,22,12,10,2,3,5,5719.0,1:56,0,0,0,89.0,0:1,1400000
8475744,Evgeny,Kuznetsov,1992-05-19,C,L,2019-20,66,20,33,53,0.8,-3,134,14.93,44,70328.0,17:45,367,481,848,43.28,39,16,24,47,-23,7,6,13,12456.0,3:8,0,0,0,68.0,0:1,7800000
8475745,Charlie,Coyle,1992-03-02,C,R,2019-20,73,16,21,37,0.51,7,150,10.67,21,74085.0,16:54,348,391,739,47.09,88,35,51,33,18,1,4,5,8426.0,1:55,2,0,2,3969.0,0:54,3200000
8475747,Patrik,Nemeth,1992-02-08,D,L,2019-20,64,1,8,9,0.14,-10,89,1.12,28,84626.0,22:2,0,0,0,0.0,80,92,10,54,-44,0,0,0,366.0,0:5,0,1,1,13194.0,3:26,3000000
8475750,Jon,Merrill,1992-02-03,D,L,2019-20,49,2,5,7,0.14,9,37,5.41,32,53373.0,18:9,0,0,0,0.0,51,71,14,27,-13,0,0,0,612.0,0:12,0,1,1,4078.0,1:23,1375000
8475752,Tyler,Pitlick,1991-11-01,C,R,2019-20,66,9,12,21,0.32,13,80,11.25,12,47983.0,12:7,5,13,18,27.78,138,43,29,17,12,0,0,0,203.0,0:3,0,0,0,4285.0,1:4,1000000
8475753,Justin,Faulk,1992-03-20,D,R,2019-20,72,5,11,16,0.22,-1,150,3.33,32,88907.0,20:34,0,0,0,0.0,90,80,25,41,-16,1,2,3,4537.0,1:3,0,1,1,5390.0,1:14,4833333
8475754,Brock,Nelson,1991-10-15,C,L,2019-20,68,26,28,54,0.79,6,175,14.86,32,76948.0,18:51,615,573,1188,51.77,49,44,26,52,-26,4,3,7,8284.0,2:1,0,0,0,6432.0,1:34,6000000
8475760,Nick,Bjugstad,1992-07-17,C,R,2019-20,13,1,1,2,0.15,3,18,5.56,8,9542.0,12:14,38,58,96,39.58,19,7,3,5,-2,0,0,0,971.0,1:14,0,0,0,300.0,0:23,4100000
8475762,Derek,Forbort,1992-03-04,D,L,2019-20,20,0,1,1,0.05,-5,22,0.0,4,21375.0,17:48,0,0,0,0.0,35,30,2,16,-14,0,0,0,0.0,0:0,0,0,0,1792.0,1:29,2525000
8475763,Kevin,Hayes,1992-05-08,C,L,2019-20,72,23,22,45,0.62,-2,182,12.64,34,76572.0,17:43,443,430,873,50.74,93,24,48,35,13,4,3,7,7200.0,1:40,4,0,4,8645.0,2:0,7142857
8475764,Cam,Fowler,1991-12-05,D,L,2019-20,59,9,20,29,0.49,0,117,7.69,20,77842.0,21:59,0,0,0,0.0,25,58,21,31,-10,2,6,8,9071.0,2:33,0,0,0,2394.0,0:40,6500000
8475765,Vladimir,Tarasenko,1991-12-13,RW,L,2019-20,12,3,7,10,0.83,-3,31,9.68,0,11583.0,16:5,0,0,0,0.0,17,8,6,5,1,1,2,3,1852.0,2:34,0,0,0,14.0,0:1,7500000
8475766,Austin,Watson,1992-01-13,LW,R,2019-20,53,6,8,14,0.26,-9,50,12.0,65,36952.0,11:37,6,6,12,50.0,131,48,18,20,-2,0,0,0,210.0,0:3,0,2,2,3421.0,1:4,1100000
8475768,Jaden,Schwartz,1992-06-25,LW,L,2019-20,74,22,35,57,0.77,1,164,13.41,20,80466.0,18:7,9,12,21,42.86,62,30,52,30,22,9,11,20,12655.0,2:51,0,0,0,978.0,0:13,5350000
8475772,Riley,Sheahan,1991-12-07,C,L,2019-20,66,8,7,15,0.23,-13,70,11.43,6,50660.0,12:47,409,425,834,49.04,26,33,36,25,11,0,0,0,124.0,0:1,1,1,2,9293.0,2:20,900000
8475780,Chris,Wagner,1991-05-27,RW,R,2019-20,70,8,4,12,0.17,-8,84,9.52,47,51875.0,12:21,117,135,252,46.43,204,33,16,21,-5,0,0,0,274.0,0:3,1,0,1,6081.0,1:26,1250000
8475784,Jeff,Skinner,1992-05-16,LW,L,2019-20,59,14,9,23,0.39,-22,183,7.65,18,58354.0,16:29,32,54,86,37.21,29,11,28,24,4,0,3,3,8770.0,2:28,0,0,0,3.0,0:0,9000000
8475786,Zach,Hyman,1992-06-09,C,R,2019-20,51,21,16,37,0.73,13,106,19.81,23,58434.0,19:5,70,90,160,43.75,52,23,32,16,16,3,3,6,3364.0,1:5,1,0,1,5717.0,1:52,2250000
8475790,Erik,Gudbranson,1992-01-07,D,R,2019-20,51,4,5,9,0.18,0,78,5.13,95,59254.0,19:21,0,0,0,0.0,89,58,0,33,-33,0,0,0,387.0,0:7,0,1,1,6271.0,2:2,4000000
8475791,Taylor,Hall,1991-11-14,LW,L,2019-20,65,16,36,52,0.8,-14,232,6.9,34,74778.0,19:10,20,31,51,39.22,47,29,41,52,-11,4,14,18,13505.0,3:27,0,0,0,808.0,0:12,6000000
8475792,Brett,Connolly,1992-05-02,RW,R,2019-20,69,19,14,33,0.48,-3,117,16.24,26,60006.0,14:29,6,11,17,35.29,56,17,28,22,6,4,2,6,5406.0,1:18,0,0,0,37.0,0:0,3500000
8475793,Ryan,Johansen,1992-07-31,C,R,2019-20,68,14,22,36,0.53,-5,101,13.86,45,69585.0,17:3,549,483,1032,53.2,39,34,38,24,14,3,6,9,10970.0,2:41,1,0,1,3657.0,0:53,8000000
8475794,Tyler,Seguin,1992-01-31,C,R,2019-20,71,17,33,50,0.7,-6,250,6.8,24,81352.0,19:5,551,398,949,58.06,95,32,35,54,-19,3,12,15,10737.0,2:31,0,0,0,3166.0,0:44,9850000
8475795,Dylan,McIlrath,1992-04-20,D,R,2019-20,16,0,0,0,0.0,-4,14,0.0,23,14227.0,14:49,0,0,0,0.0,48,12,4,8,-4,0,0,0,0.0,0:0,0,0,0,2569.0,2:40,700000
8475796,Mark,Pysyk,1992-01-11,D,R,2019-20,58,9,9,18,0.31,4,64,14.06,20,44375.0,12:45,3,3,6,50.0,47,38,26,15,11,0,0,0,35.0,0:0,0,0,0,2125.0,0:36,2733333
8475797,Jarred,Tinordi,1992-02-20,D,L,2019-20,28,1,4,5,0.18,-1,20,5.0,34,27911.0,16:36,0,0,0,0.0,71,36,1,18,-17,0,0,0,15.0,0:0,0,1,1,2461.0,1:27,700000
8475798,Mikael,Granlund,1992-02-26,RW,L,2019-20,63,17,13,30,0.48,-4,130,13.08,28,67293.0,17:48,73,77,150,48.67,42,55,24,34,-10,4,2,6,9248.0,2:26,1,0,1,2951.0,0:46,5750000
8475799,Nino,Niederreiter,1992-09-08,RW,L,2019-20,67,11,18,29,0.43,-3,115,9.57,42,59567.0,14:49,1,3,4,25.0,52,19,35,42,-7,4,7,11,7543.0,1:52,0,0,0,121.0,0:1,5250000
8475807,Joakim,Nordstrom,1992-02-25,LW,L,2019-20,51,4,4,8,0.16,-6,51,7.84,17,36610.0,11:57,1,6,7,14.29,98,33,12,12,0,0,0,0,92.0,0:1,0,0,0,5700.0,1:51,1000000
8475808,Michael,Chaput,1992-04-09,C,L,2019-20,2,0,0,0,0.0,-2,2,0.0,2,1201.0,10:0,7,6,13,53.85,3,2,0,1,-1,0,0,0,0.0,0:0,0,0,0,87.0,0:43,675000
8475810,Bryan,Rust,1992-05-11,RW,R,2019-20,55,27,29,56,1.02,14,151,17.88,30,65225.0,19:45,2,8,10,20.0,71,35,29,37,-8,8,9,17,9237.0,2:47,1,1,2,5398.0,1:38,3500000
8475820,Joonas,Donskoi,1992-04-13,RW,R,2019-20,68,18,18,36,0.53,4,116,15.52,28,65614.0,16:4,10,14,24,41.67,26,39,28,21,7,4,2,6,8945.0,2:11,0,0,0,2319.0,0:34,3900000
8475825,Jani,Hakanpaa,1992-03-31,D,R,2019-20,5,1,0,1,0.2,1,4,25.0,2,5436.0,18:7,0,0,0,0.0,15,7,0,1,-1,0,0,0,112.0,0:22,0,0,0,393.0,1:18,850000
8475832,Tom,Kuhnhackl,1992-01-21,RW,L,2019-20,28,3,3,6,0.21,-4,28,10.71,2,18982.0,11:17,0,0,0,0.0,31,22,4,11,-7,0,0,0,43.0,0:1,0,1,1,2184.0,1:18,850000
8475834,Marcus,Sorensen,1992-04-07,LW,L,2019-20,66,7,11,18,0.27,-12,78,8.97,26,54824.0,13:50,3,17,20,15.0,56,18,28,18,10,0,0,0,855.0,0:12,1,0,1,5869.0,1:28,1500000
8475841,Tim,Heed,1991-01-27,D,R,2019-20,38,1,4,5,0.13,-10,44,2.27,2,29646.0,13:0,0,1,1,0.0,16,30,10,17,-7,0,1,1,1856.0,0:48,0,0,0,350.0,0:9,960000
8475842,Sam,Carrick,1992-02-04,C,R,2019-20,9,1,1,2,0.22,-3,16,6.25,0,7434.0,13:46,33,39,72,45.83,13,8,1,5,-4,0,0,0,693.0,1:17,1,0,1,219.0,0:24,700000
8475848,Brendan,Gallagher,1992-05-06,RW,R,2019-20,59,22,21,43,0.73,9,226,9.73,29,59863.0,16:54,12,17,29,41.38,53,29,39,18,21,1,4,5,7266.0,2:3,0,0,0,88.0,0:1,3750000
8475855,Jesper,Fast,1991-12-02,RW,R,2019-20,69,12,17,29,0.42,16,84,14.29,20,68753.0,16:36,9,17,26,34.62,125,53,24,32,-8,0,0,0,435.0,0:6,2,0,2,9755.0,2:21,1850000
8475857,Kevin,Gravel,1992-03-06,D,L,2019-20,3,0,0,0,0.0,0,2,0.0,0,1996.0,11:5,0,0,0,0.0,2,3,0,1,-1,0,0,0,0.0,0:0,0,0,0,133.0,0:44,700000
8475868,Anthony,Bitetto,1990-07-15,D,L,2019-20,51,0,8,8,0.16,3,54,0.0,32,46393.0,15:9,0,0,0,0.0,145,50,16,22,-6,0,0,0,173.0,0:3,0,1,1,6683.0,2:11,700000
8475869,Brandon,Davidson,1991-08-21,D,L,2019-20,12,0,0,0,0.0,-3,17,0.0,0,8982.0,12:28,0,0,0,0.0,24,20,3,9,-6,0,0,0,10.0,0:0,0,0,0,166.0,0:13,700000
8475902,Zach,Trotman,1990-08-26,D,R,2019-20,8,0,0,0,0.0,-1,11,0.0,4,7063.0,14:42,0,0,0,0.0,21,10,0,6,-6,0,0,0,350.0,0:43,0,0,0,183.0,0:22,700000
8475906,John,Klingberg,1992-08-14,D,R,2019-20,60,6,27,33,0.55,-12,124,4.84,24,80084.0,22:14,0,0,0,0.0,29,73,26,73,-47,2,15,17,9271.0,2:34,0,0,0,1127.0,0:18,4250000
8475907,Micheal,Ferland,1992-04-20,LW,L,2019-20,14,1,4,5,0.36,-3,15,6.67,7,8228.0,9:47,2,0,2,100.0,40,2,2,1,1,0,0,0,743.0,0:53,0,0,0,0.0,0:0,3500000
8475913,Mark,Stone,1992-05-13,RW,R,2019-20,68,23,45,68,1.0,16,174,13.22,27,79003.0,19:21,17,30,47,36.17,59,54,80,40,40,6,12,18,10481.0,2:34,0,1,1,7687.0,1:53,9500000
8475958,Michael,Sgarbossa,1992-07-25,C,L,2019-20,2,0,0,0,0.0,0,1,0.0,0,973.0,8:6,3,3,6,50.0,3,0,2,1,1,0,0,0,0.0,0:0,0,0,0,0.0,0:0,700000
8476043,Ben,Street,1987-02-13,C,L,2019-20,3,0,1,1,0.33,1,4,0.0,0,1463.0,8:7,5,6,11,45.45,3,0,0,0,0,0,0,0,0.0,0:0,0,0,0,0.0,0:0,750000
8476166,Taylor,Fedun,1988-06-04,D,R,2019-20,27,2,7,9,0.33,3,40,5.0,8,22278.0,13:45,0,0,0,0.0,16,19,2,12,-10,0,0,0,181.0,0:6,0,0,0,599.0,0:22,737500
8476195,Cory,Conacher,1989-12-14,C,L,2019-20,4,0,1,1,0.25,-2,5,0.0,4,2661.0,11:5,0,0,0,0.0,3,1,5,1,4,0,0,0,158.0,0:39,0,0,0,0.0,0:0,700000
8476207,Brian,Gibbons,1988-02-26,LW,L,2019-20,15,0,0,0,0.0,-7,9,0.0,4,8784.0,9:45,0,0,0,0.0,7,9,8,7,1,0,0,0,46.0,0:3,0,0,0,616.0,0:41,725000
8476278,Colin,Blackwell,1993-03-28,C,R,2019-20,27,3,7,10,0.37,7,31,9.68,10,17746.0,10:57,37,29,66,56.06,43,23,6,7,-1,0,0,0,143.0,0:5,0,0,0,1.0,0:0,675000
8476285,Matthew,Peca,1993-04-27,C,L,2019-20,14,0,2,2,0.14,-4,7,0.0,0,8772.0,10:26,43,36,79,54.43,15,4,0,1,-1,0,0,0,24.0,0:1,0,0,0,484.0,0:34,1300000
8476288,Ryan,Dzingel,1992-03-09,LW,L,2019-20,64,8,21,29,0.45,3,98,8.16,30,54353.0,14:9,9,20,29,31.03,36,25,15,19,-4,4,5,9,8437.0,2:11,0,0,0,124.0,0:1,3375000
8476292,Ondrej,Palat,1991-03-28,LW,L,2019-20,72,17,25,42,0.58,24,135,12.59,22,69929.0,16:11,8,15,23,34.78,148,64,44,37,7,4,4,8,5641.0,1:18,1,0,1,3459.0,0:48,5300000
8476293,Scott,Wilson,1992-04-24,C,L,2019-20,6,1,1,2,0.33,1,8,12.5,2,4187.0,11:37,0,0,0,0.0,3,0,5,0,5,0,0,0,9.0,0:1,0,0,0,0.0,0:0,1050000
8476312,Josh,Manson,1991-10-07,D,R,2019-20,50,1,8,9,0.18,-10,64,1.56,37,61893.0,20:37,0,0,0,0.0,113,65,21,41,-20,0,0,0,344.0,0:6,0,1,1,7512.0,2:30,4100000
8476326,Josh,Archibald,1992-10-06,RW,R,2019-20,62,12,9,21,0.34,-8,64,18.75,12,49221.0,13:13,0,2,2,0.0,165,44,24,11,13,0,0,0,204.0,0:3,2,1,3,8497.0,2:17,1000000
8476329,Travis,Boyd,1993-09-14,C,L,2019-20,26,4,7,11,0.42,10,28,14.29,2,18224.0,11:40,56,82,138,40.58,15,9,7,6,1,0,1,1,1315.0,0:50,0,0,0,436.0,0:16,800000
8476331,Dylan,DeMelo,1993-05-01,D,R,2019-20,59,0,10,10,0.17,4,74,0.0,37,71306.0,20:8,0,0,0,0.0,105,77,9,42,-33,0,0,0,2713.0,0:45,0,2,2,8074.0,2:16,900000
8476344,Tyler,Graovac,1993-04-27,C,L,2019-20,8,2,0,2,0.25,-2,5,40.0,2,3006.0,6:15,8,14,22,36.36,6,3,1,2,-1,2,0,2,361.0,0:45,0,0,0,0.0,0:0,700000
8476346,Johnny,Gaudreau,1993-08-13,LW,L,2019-20,70,18,40,58,0.83,-10,209,8.61,12,78834.0,18:46,1,3,4,25.0,1,11,40,71,-31,6,12,18,12170.0,2:53,0,0,0,54.0,0:0,6750000
8476356,Tobias,Rieder,1993-01-10,C,L,2019-20,55,4,6,10,0.18,-12,77,5.19,6,36612.0,11:5,11,42,53,20.75,30,26,17,8,9,0,0,0,95.0,0:1,1,1,2,5299.0,1:36,700000
8476368,Fredrik,Claesson,1992-11-24,D,L,2019-20,5,1,1,2,0.4,1,1,100.0,0,4346.0,14:29,0,0,0,0.0,5,7,1,1,0,0,0,0,0.0,0:0,0,0,0,244.0,0:48,700000
8476372,Nick,Seeler,1993-06-03,D,L,2019-20,12,0,1,1,0.08,-8,5,0.0,15,8588.0,11:55,0,0,0,0.0,19,21,1,7,-6,0,0,0,21.0,0:1,0,0,0,468.0,0:39,725000
8476374,Sean,Kuraly,1993-01-20,C,L,2019-20,72,6,18,24,0.33,-3,99,6.06,36,57155.0,13:13,270,283,553,48.82,151,33,29,27,2,0,1,1,113.0,0:1,0,1,1,6906.0,1:35,1275000
8476381,Andrew,Shaw,1991-07-20,RW,R,2019-20,26,3,7,10,0.38,-4,46,6.52,33,22554.0,14:27,42,51,93,45.16,74,9,12,15,-3,1,1,2,3506.0,2:14,0,0,0,233.0,0:8,3900000
8476389,Vincent,Trocheck,1993-07-11,C,R,2019-20,62,11,27,38,0.61,-8,141,7.8,49,62219.0,16:43,434,398,832,52.16,101,37,51,64,-13,1,6,7,7341.0,1:58,1,0,1,1929.0,0:31,4750000
8476391,TJ,Tynan,1992-02-25,C,R,2019-20,16,0,1,1,0.06,-1,7,0.0,2,8135.0,8:28,3,15,18,16.67,7,3,5,0,5,0,0,0,511.0,0:31,0,0,0,0.0,0:0,700000
8476392,Adam,Lowry,1993-03-29,C,L,2019-20,49,4,6,10,0.2,-4,68,5.88,23,43987.0,14:57,349,300,649,53.78,137,22,31,11,20,0,0,0,688.0,0:14,1,1,2,6519.0,2:13,2916667
8476393,Nick,Cousins,1993-07-20,C,L,2019-20,68,10,18,28,0.41,-1,118,8.47,35,54984.0,13:28,36,46,82,43.9,102,32,29,22,7,3,3,6,6647.0,1:37,0,0,0,57.0,0:0,1000000
8476396,Steven,Fogarty,1993-04-19,C,R,2019-20,7,0,0,0,0.0,-1,2,0.0,0,2474.0,5:53,6,3,9,66.67,4,4,2,2,0,0,0,0,0.0,0:0,0,0,0,73.0,0:10,700000
8476399,Blake,Coleman,1991-11-28,C,L,2019-20,69,21,11,32,0.46,-1,205,10.24,67,68677.0,16:35,47,102,149,31.54,205,46,48,21,27,1,2,3,1746.0,0:25,3,1,4,10709.0,2:35,1800000
8476400,Logan,Shaw,1992-10-05,RW,R,2019-20,35,3,2,5,0.14,0,20,15.0,0,14327.0,6:49,11,9,20,55.0,24,13,2,5,-3,0,1,1,160.0,0:4,0,0,0,185.0,0:5,700000
8476404,Andy,Andreoff,1991-05-17,LW,L,2019-20,14,0,1,1,0.07,-3,14,0.0,2,7168.0,8:32,4,4,8,50.0,20,4,1,0,1,0,0,0,7.0,0:0,0,0,0,0.0,0:0,750000
8476406,Nick,Shore,1992-09-26,C,R,2019-20,63,3,3,6,0.1,1,45,6.67,20,34697.0,9:10,210,170,380,55.26,55,20,14,16,-2,0,0,0,120.0,0:1,0,0,0,5289.0,1:23,750000
8476409,Alan,Quine,1993-02-25,C,L,2019-20,9,1,0,1,0.11,-1,12,8.33,4,5295.0,9:48,1,0,1,100.0,6,2,2,1,1,0,0,0,10.0,0:1,0,0,0,0.0,0:0,735000
8476410,Josh,Leivo,1993-05-26,LW,R,2019-20,36,7,12,19,0.53,1,69,10.14,4,32425.0,15:0,10,7,17,58.82,17,8,11,15,-4,0,4,4,4000.0,1:51,0,0,0,122.0,0:3,1500000
8476419,Jean-Gabriel,Pageau,1992-11-11,C,R,2019-20,67,26,16,42,0.63,4,151,17.22,49,77011.0,19:9,615,534,1149,53.52,128,53,33,32,1,5,5,10,7151.0,1:46,3,3,6,9076.0,2:15,3100000
8476422,Mike,Reilly,1993-07-13,D,L,2019-20,44,1,15,16,0.36,-6,85,1.18,24,47573.0,18:1,0,0,0,0.0,39,46,9,39,-30,1,8,9,4303.0,1:37,0,1,1,872.0,0:19,1500000
8476428,Rocco,Grimaldi,1993-02-08,C,R,2019-20,66,10,21,31,0.47,10,122,8.2,10,50093.0,12:38,1,5,6,16.67,23,14,27,20,7,0,0,0,523.0,0:7,0,0,0,65.0,0:0,1000000
8476429,Scott,Mayfield,1992-10-14,D,R,2019-20,67,5,8,13,0.19,8,98,5.1,53,80166.0,19:56,0,0,0,0.0,93,117,21,70,-49,0,0,0,219.0,0:3,0,2,2,10041.0,2:29,1450000
8476430,Tomas,Jurco,1992-12-28,LW,L,2019-20,12,0,2,2,0.17,1,7,0.0,4,7183.0,9:58,2,2,4,50.0,4,3,6,2,4,0,0,0,178.0,0:14,0,0,0,0.0,0:0,750000
8476432,Boone,Jenner,1993-06-15,C,L,2019-20,70,11,13,24,0.34,-14,179,6.15,36,76089.0,18:6,643,523,1166,55.15,109,80,24,28,-4,2,2,4,7465.0,1:46,0,1,1,7550.0,1:47,3750000
8476437,Victor,Rask,1993-03-01,C,L,2019-20,43,5,8,13,0.3,7,38,13.16,6,27044.0,10:28,120,152,272,44.12,26,8,13,5,8,0,0,0,632.0,0:14,0,0,0,81.0,0:1,4000000
8476438,Brandon,Saad,1992-10-27,LW,L,2019-20,58,21,12,33,0.57,2,140,15.0,16,58281.0,16:44,23,35,58,39.66,36,19,40,25,15,1,0,1,4295.0,1:14,2,0,2,6095.0,1:45,6000000
8476439,Brett,Ritchie,1993-07-01,RW,R,2019-20,27,2,4,6,0.22,-3,34,5.88,21,16854.0,10:24,2,3,5,40.0,89,3,3,4,-1,0,1,1,834.0,0:30,0,0,0,4.0,0:0,1000000
8476440,Markus,Granlund,1993-04-16,C,L,2019-20,34,3,1,4,0.12,-1,26,11.54,14,22092.0,10:49,25,32,57,43.86,15,18,11,7,4,0,0,0,121.0,0:3,0,0,0,2386.0,1:10,1300000
8476441,Joel,Edmundson,1993-06-28,D,L,2019-20,68,7,13,20,0.29,7,97,7.22,72,75273.0,18:26,0,0,0,0.0,118,91,23,45,-22,0,0,0,73.0,0:1,0,0,0,11452.0,2:48,3100000
8476442,Matt,Nieto,1992-11-05,LW,L,2019-20,72,8,13,21,0.29,6,86,9.3,8,58333.0,13:30,2,3,5,40.0,41,23,19,17,2,0,0,0,139.0,0:1,2,0,2,10164.0,2:21,1975000
8476443,Xavier,Ouellet,1993-07-29,D,L,2019-20,12,0,2,2,0.17,0,8,0.0,4,10006.0,13:53,0,0,0,0.0,24,15,1,4,-3,0,0,0,0.0,0:0,0,0,0,681.0,0:56,700000
8476447,Miikka,Salomaki,1993-03-09,RW,L,2019-20,5,1,0,1,0.2,2,2,50.0,4,3644.0,12:8,0,0,0,0.0,9,3,1,3,-2,0,0,0,89.0,0:17,0,0,0,64.0,0:12,750000
8476448,William,Karlsson,1993-01-08,C,L,2019-20,66,16,33,49,0.74,14,146,10.96,16,74851.0,18:54,506,480,986,51.32,44,39,56,38,18,2,7,9,8078.0,2:2,2,3,5,7610.0,1:55,5900000
8476449,Scott,Harrington,1993-03-10,D,L,2019-20,39,1,7,8,0.21,-3,37,2.7,16,32633.0,13:56,0,0,0,0.0,46,48,5,9,-4,0,0,0,73.0,0:1,0,0,0,1423.0,0:36,1633333
8476453,Nikita,Kucherov,1993-06-17,RW,L,2019-20,71,34,53,87,1.23,24,220,15.45,42,80468.0,18:53,0,1,1,0.0,39,20,33,62,-29,4,21,25,14742.0,3:27,0,0,0,22.0,0:0,9500000
8476454,Ryan,Nugent-Hopkins,1993-04-12,C,L,2019-20,65,22,39,61,0.94,1,172,12.79,33,79820.0,20:28,205,199,404,50.74,33,44,54,39,15,7,17,24,14609.0,3:44,0,0,0,6671.0,1:42,6000000
8476455,Gabriel,Landeskog,1992-11-23,LW,L,2019-20,57,21,25,46,0.81,-1,153,13.73,53,68781.0,20:6,279,218,497,56.14,91,35,39,26,13,6,11,17,13458.0,3:56,0,0,0,164.0,0:2,5571429
8476456,Jonathan,Huberdeau,1993-06-04,LW,L,2019-20,69,23,55,78,1.13,5,152,15.13,30,77713.0,18:46,24,37,61,39.34,51,26,42,70,-28,5,24,29,14786.0,3:34,0,0,0,98.0,0:1,5900000
8476457,Adam,Larsson,1992-11-12,D,R,2019-20,49,1,5,6,0.12,0,61,1.64,35,58304.0,19:49,0,0,0,0.0,112,82,16,35,-19,0,0,0,61.0,0:1,0,0,0,4738.0,1:36,4166666
8476458,Ryan,Strome,1993-07-11,C,R,2019-20,70,18,41,59,0.84,21,154,11.69,48,82262.0,19:35,496,548,1044,47.51,45,32,27,54,-27,3,14,17,12397.0,2:57,0,1,1,9411.0,2:14,3100000
8476459,Mika,Zibanejad,1993-04-18,C,R,2019-20,57,41,34,75,1.32,9,208,19.71,14,73970.0,21:37,592,612,1204,49.17,51,49,42,43,-1,15,12,27,12551.0,3:40,3,2,5,8968.0,2:37,5350000
8476460,Mark,Scheifele,1993-03-15,C,R,2019-20,71,29,44,73,1.03,2,170,17.06,45,92887.0,21:48,604,685,1289,46.86,34,49,57,46,11,10,10,20,14088.0,3:18,0,0,0,1053.0,0:14,6125000
8476461,Sean,Couturier,1992-12-07,C,L,2019-20,72,22,39,61,0.85,24,190,11.58,32,85525.0,19:47,559,387,946,59.09,68,27,41,36,5,4,9,13,12094.0,2:47,0,0,0,8820.0,2:2,4333333
8476462,Dougie,Hamilton,1993-06-17,D,R,2019-20,47,14,26,40,0.85,30,170,8.24,32,65661.0,23:17,0,0,0,0.0,52,63,22,40,-18,2,10,12,8919.0,3:9,0,1,1,6562.0,2:19,5750000
8476463,Jonas,Brodin,1993-07-12,D,L,2019-20,69,2,26,28,0.41,15,103,1.94,24,89223.0,21:33,0,0,0,0.0,41,112,14,16,-2,0,1,1,1602.0,0:23,0,2,2,8478.0,2:2,4166667
8476466,Sven,Baertschi,1992-10-05,LW,L,2019-20,6,0,2,2,0.33,-2,7,0.0,4,4256.0,11:49,0,0,0,0.0,5,0,1,1,0,0,2,2,573.0,1:35,0,0,0,0.0,0:0,3366666
8476467,Jamie,Oleksiak,1992-12-21,D,L,2019-20,72,4,7,11,0.15,-5,81,4.94,41,68951.0,15:57,0,0,0,0.0,161,63,24,50,-26,0,0,0,135.0,0:1,0,0,0,2764.0,0:38,2137500
8476468,J.T.,Miller,1993-03-14,C,L,2019-20,69,27,45,72,1.04,11,165,16.36,47,83226.0,20:6,425,293,718,59.19,123,38,52,36,16,9,16,25,16020.0,3:52,0,2,2,2513.0,0:36,5250000
8476469,Joel,Armia,1993-05-31,RW,R,2019-20,58,16,14,30,0.52,2,155,10.32,28,59947.0,17:13,4,7,11,36.36,146,25,47,27,20,3,1,4,7019.0,2:1,3,1,4,5616.0,1:36,2600000
8476470,Nathan,Beaulieu,1992-12-05,D,L,2019-20,38,1,7,8,0.21,15,38,2.63,29,38751.0,16:59,0,0,0,0.0,62,47,6,23,-17,0,0,0,85.0,0:2,0,0,0,5254.0,2:18,1000000
8476472,Oscar,Klefbom,1993-07-20,D,L,2019-20,62,5,29,34,0.55,-17,159,3.14,24,94530.0,25:24,0,0,0,0.0,45,180,36,58,-22,2,16,18,13508.0,3:37,0,0,0,9256.0,2:29,4167000
8476473,Connor,Murphy,1993-03-26,D,R,2019-20,58,5,14,19,0.33,2,117,4.27,27,73952.0,21:15,0,0,0,0.0,128,138,17,44,-27,0,0,0,241.0,0:4,0,1,1,9582.0,2:45,3850000
8476474,Stefan,Noesen,1993-02-12,RW,R,2019-20,40,7,2,9,0.22,-1,67,10.45,32,27676.0,11:31,7,11,18,38.89,74,17,16,8,8,1,0,1,1662.0,0:41,0,0,0,22.0,0:0,700000
8476479,Phillip,Danault,1993-02-24,C,L,2019-20,71,13,34,47,0.66,18,131,9.92,32,80276.0,18:50,728,608,1336,54.49,119,37,34,50,-16,1,3,4,6663.0,1:33,0,0,0,10692.0,2:30,3083333
8476480,Vladislav,Namestnikov,1992-11-22,C,L,2019-20,68,18,14,32,0.47,-4,103,17.48,45,61028.0,14:57,22,25,47,46.81,115,49,25,28,-3,2,2,4,6243.0,1:31,4,2,6,7016.0,1:43,4000000
8476483,Rickard,Rakell,1993-05-05,C,R,2019-20,65,15,27,42,0.65,-5,186,8.06,12,70838.0,18:9,10,3,13,76.92,81,29,30,42,-12,3,6,9,9212.0,2:21,0,3,3,2546.0,0:39,3789444
8476525,Colin,Miller,1992-10-29,D,R,2019-20,51,1,10,11,0.22,-9,79,1.27,22,52430.0,17:8,0,0,0,0.0,87,40,9,29,-20,0,3,3,4171.0,1:21,0,0,0,927.0,0:18,3875000
8476539,Jonathan,Marchessault,1990-12-27,C,R,2019-20,69,24,25,49,0.71,9,242,9.92,32,71504.0,17:16,59,79,138,42.75,106,13,39,49,-10,7,6,13,9485.0,2:17,0,0,0,48.0,0:0,5000000
8476624,Barclay,Goodrow,1993-02-26,RW,L,2019-20,73,8,18,26,0.36,-8,106,7.55,99,69282.0,15:49,394,412,806,48.88,172,66,44,24,20,0,2,2,2790.0,0:38,0,1,1,10529.0,2:24,925000
8476779,Brad,Hunt,1988-08-24,D,L,2019-20,59,8,11,19,0.32,-7,106,7.55,6,53586.0,15:8,0,0,0,0.0,12,39,15,14,1,3,7,10,7996.0,2:15,0,0,0,200.0,0:3,700000
8476792,Torey,Krug,1991-04-12,D,L,2019-20,64,9,41,50,0.78,-6,149,6.04,40,79009.0,20:34,0,0,0,0.0,37,49,23,50,-27,2,26,28,14948.0,3:53,0,0,0,357.0,0:5,5250000
8476807,Matt,Tennyson,1990-04-23,D,R,2019-20,20,0,3,3,0.15,-2,14,0.0,6,14576.0,12:8,0,0,0,0.0,27,18,2,8,-6,0,0,0,8.0,0:0,0,0,0,59.0,0:2,700000
8476822,Luke,Glendening,1989-04-28,RW,R,2019-20,60,6,3,9,0.15,-29,76,7.89,14,55276.0,15:21,393,307,700,56.14,147,68,10,18,-8,0,0,0,417.0,0:6,1,0,1,10366.0,2:52,1800000
8476826,Yanni,Gourde,1991-12-15,C,L,2019-20,73,10,21,31,0.42,-5,112,8.93,56,61600.0,14:3,105,95,200,52.5,85,21,53,15,38,1,5,6,3129.0,0:42,2,1,3,6347.0,1:26,5166666
8476850,Ryan,Murray,1993-09-27,D,L,2019-20,27,2,7,9,0.33,-9,32,6.25,4,32328.0,19:57,0,0,0,0.0,12,50,6,15,-9,0,2,2,1395.0,0:51,0,0,0,3308.0,2:2,4600000
8476851,Alex,Galchenyuk,1994-02-12,LW,L,2019-20,59,8,16,24,0.41,-5,86,9.3,16,43545.0,12:18,67,64,131,51.15,52,17,5,20,-15,2,5,7,5872.0,1:39,0,0,0,39.0,0:0,4900000
8476853,Morgan,Rielly,1994-03-09,D,L,2019-20,47,3,24,27,0.57,6,123,2.44,24,68246.0,24:12,0,1,1,0.0,38,67,17,42,-25,0,7,7,6598.0,2:20,0,0,0,5595.0,1:59,5000000
8476854,Hampus,Lindholm,1994-01-20,D,L,2019-20,55,2,20,22,0.4,-10,109,1.83,34,76123.0,23:4,0,0,0,0.0,34,71,20,53,-33,1,7,8,6008.0,1:49,0,2,2,8763.0,2:39,5205556
8476856,Matt,Dumba,1994-07-25,D,R,2019-20,69,6,18,24,0.35,-7,167,3.59,41,93149.0,22:29,0,0,0,0.0,98,88,20,35,-15,1,7,8,10997.0,2:39,0,1,1,4586.0,1:6,6000000
8476857,Pontus,Aberg,1993-09-23,LW,R,2019-20,5,0,1,1,0.2,0,4,0.0,0,2611.0,8:42,0,0,0,0.0,1,1,1,2,-1,0,0,0,0.0,0:0,0,0,0,0.0,0:0,700000
8476858,Phillip,Di Giuseppe,1993-10-09,LW,L,2019-20,20,1,3,4,0.2,1,35,2.86,2,13546.0,11:17,0,2,2,0.0,38,20,3,4,-1,0,0,0,20.0,0:1,0,0,0,87.0,0:4,700000
8476869,Brady,Skjei,1994-03-26,D,L,2019-20,67,8,16,24,0.36,-10,139,5.76,45,83177.0,20:41,0,0,0,0.0,103,96,36,55,-19,0,0,0,470.0,0:7,0,2,2,10264.0,2:33,5250000
8476870,Stefan,Matteau,1994-02-23,C,L,2019-20,9,2,1,3,0.33,0,18,11.11,5,6675.0,12:21,0,0,0,0.0,27,10,2,1,1,0,0,0,14.0,0:1,0,0,0,160.0,0:17,725000
8476871,Tanner,Pearson,1992-08-10,LW,L,2019-20,69,21,24,45,0.65,-4,164,12.8,27,68360.0,16:30,3,14,17,17.65,96,40,37,33,4,3,7,10,6587.0,1:35,2,1,3,4390.0,1:3,3750000
8476872,Scott,Laughton,1994-05-30,C,L,2019-20,52,16,16,32,0.62,17,79,20.25,38,45484.0,14:34,148,128,276,53.62,114,28,23,21,2,0,0,0,354.0,0:6,0,0,0,5286.0,1:41,2300000
8476873,Mark,Jankowski,1994-09-13,C,L,2019-20,56,5,2,7,0.12,-12,38,13.16,14,37289.0,11:5,190,235,425,44.71,14,33,32,20,12,0,0,0,416.0,0:7,0,0,0,6852.0,2:2,1675000
8476874,Olli,Maatta,1994-08-22,D,L,2019-20,65,4,13,17,0.26,0,80,5.0,20,71838.0,18:25,0,0,0,0.0,119,110,22,57,-35,0,0,0,945.0,0:14,0,2,2,7377.0,1:53,4083333
8476875,Mike,Matheson,1994-02-27,D,L,2019-20,59,8,12,20,0.34,-1,104,7.69,14,63846.0,18:2,0,0,0,0.0,44,53,41,54,-13,1,1,2,744.0,0:12,0,0,0,4300.0,1:12,4875000
8476878,Zemgus,Girgensons,1994-01-05,C,L,2019-20,69,12,7,19,0.28,-1,85,14.12,10,57106.0,13:47,30,43,73,41.1,110,20,13,11,2,0,0,0,171.0,0:2,1,0,1,8837.0,2:8,1600000
8476879,Cody,Ceci,1993-12-21,D,R,2019-20,56,1,7,8,0.14,7,48,2.08,20,69018.0,20:32,0,0,0,0.0,92,79,13,30,-17,0,0,0,250.0,0:4,0,0,0,9541.0,2:50,4500000
8476880,Tom,Wilson,1994-03-29,RW,R,2019-20,71,22,23,45,0.63,-4,158,13.92,99,77643.0,18:13,19,42,61,31.15,267,63,26,41,-15,5,2,7,7872.0,1:50,1,1,2,8538.0,2:0,5166666
8476881,Tomas,Hertl,1993-11-12,C,L,2019-20,48,16,20,36,0.75,-18,117,13.68,16,53122.0,18:26,433,357,790,54.81,29,25,25,18,7,2,5,7,7441.0,2:35,2,0,2,4174.0,1:26,5625000
8476882,Teuvo,Teravainen,1994-09-11,LW,L,2019-20,68,15,48,63,0.93,20,182,8.24,8,78308.0,19:11,26,27,53,49.06,18,30,44,44,0,4,17,21,12268.0,3:0,1,3,4,7237.0,1:46,5400000
8476884,Derrick,Pouliot,1994-01-16,D,L,2019-20,2,0,0,0,0.0,-1,1,0.0,2,1000.0,8:20,0,0,0,0.0,2,1,0,1,-1,0,0,0,0.0,0:0,0,0,0,0.0,0:0,700000
8476885,Jacob,Trouba,1994-02-26,D,R,2019-20,70,7,20,27,0.39,-12,168,4.17,61,94770.0,22:33,0,0,0,0.0,173,128,43,69,-26,4,4,8,7501.0,1:47,0,2,2,10509.0,2:30,8000000
8476886,Slater,Koekkoek,1994-02-18,D,L,2019-20,42,1,9,10,0.24,3,47,2.13,42,42230.0,16:45,0,0,0,0.0,64,58,9,27,-18,0,0,0,75.0,0:1,0,0,0,3344.0,1:19,925000
8476887,Filip,Forsberg,1994-08-13,LW,R,2019-20,63,21,27,48,0.76,-7,198,10.61,29,65585.0,17:21,1,2,3,33.33,82,27,58,45,13,7,7,14,10825.0,2:51,0,0,0,1484.0,0:23,6000000
8476889,Radek,Faksa,1994-01-09,C,L,2019-20,69,11,9,20,0.29,-7,112,9.82,42,65464.0,15:48,424,431,855,49.59,86,44,34,29,5,3,0,3,6144.0,1:29,0,0,0,6062.0,1:27,2200000
8476891,Matt,Grzelcyk,1994-01-05,D,L,2019-20,70,4,17,21,0.3,14,112,3.57,34,75877.0,18:3,0,0,0,0.0,59,69,22,41,-19,1,6,7,6609.0,1:34,0,1,1,4180.0,0:59,1400000
8476892,Colton,Parayko,1993-05-12,D,R,2019-20,67,12,18,30,0.45,7,173,6.94,16,92632.0,23:2,0,0,0,0.0,94,117,36,43,-7,3,2,5,3444.0,0:51,0,1,1,7900.0,1:57,5500000
8476894,Brendan,Leipsic,1994-05-19,LW,L,2019-20,61,3,8,11,0.18,3,49,6.12,13,33527.0,9:9,9,12,21,42.86,57,20,8,24,-16,0,1,1,1634.0,0:26,0,0,0,0.0,0:0,700000
8476897,Oskar,Sundqvist,1994-03-23,C,R,2019-20,60,12,11,23,0.38,4,101,11.88,28,51690.0,14:21,117,139,256,45.7,63,30,37,12,25,0,0,0,667.0,0:11,1,1,2,6238.0,1:43,2750000
8476902,Esa,Lindell,1994-05-23,D,L,2019-20,72,3,20,23,0.32,0,106,2.83,14,101308.0,23:27,0,0,0,0.0,95,134,32,66,-34,1,6,7,4905.0,1:8,0,3,3,16452.0,3:48,5800000
8476905,Chandler,Stephenson,1994-04-22,C,L,2019-20,68,12,15,27,0.4,25,78,15.38,16,58958.0,14:27,238,288,526,45.25,56,35,38,22,16,1,1,2,2616.0,0:38,2,1,3,5145.0,1:15,1050000
8476906,Shayne,Gostisbehere,1993-04-20,D,L,2019-20,43,5,9,14,0.33,-2,75,6.67,20,47022.0,18:13,0,0,0,0.0,14,39,9,28,-19,1,4,5,6754.0,2:37,0,0,0,185.0,0:4,4500000
8476907,Mackenzie,MacEachern,1994-03-09,LW,L,2019-20,52,7,3,10,0.19,1,64,10.94,33,27879.0,8:56,1,3,4,25.0,85,13,14,11,3,0,0,0,93.0,0:1,0,0,0,151.0,0:2,750000
8476913,Devin,Shore,1994-07-19,C,L,2019-20,45,5,7,12,0.27,-10,50,10.0,8,31444.0,11:38,47,53,100,47.0,52,14,12,8,4,0,2,2,1257.0,0:27,0,0,0,528.0,0:11,2300000
8476915,Jujhar,Khaira,1994-08-13,LW,L,2019-20,64,6,4,10,0.16,-19,69,8.7,38,48127.0,12:31,34,32,66,51.52,136,30,15,36,-21,0,0,0,414.0,0:6,0,0,0,6087.0,1:35,1200000
8476917,Adam,Pelech,1994-08-16,D,L,2019-20,38,1,8,9,0.24,4,49,2.04,20,48181.0,21:7,0,0,0,0.0,81,83,32,48,-16,0,0,0,135.0,0:3,0,2,2,6345.0,2:46,1600000
8476918,Jimmy,Vesey,1993-05-26,LW,L,2019-20,64,9,11,20,0.31,12,93,9.68,15,53005.0,13:48,0,5,5,0.0,43,20,26,16,10,0,1,1,1443.0,0:22,1,0,1,3666.0,0:57,2275000
8476919,Chris,Tierney,1994-07-01,C,L,2019-20,71,11,26,37,0.52,-6,102,10.78,20,73229.0,17:11,521,497,1018,51.18,44,37,32,42,-10,1,1,2,4014.0,0:56,4,1,5,9898.0,2:19,2937500
8476921,Jordan,Martinook,1992-07-25,LW,L,2019-20,45,2,11,13,0.29,-2,44,4.55,22,30401.0,11:15,66,62,128,51.56,72,23,24,19,5,0,0,0,45.0,0:1,0,2,2,3464.0,1:16,2000000
8476923,Damon,Severson,1994-08-07,D,R,2019-20,69,8,23,31,0.45,-20,114,7.02,52,95066.0,22:57,0,0,0,0.0,81,97,35,73,-38,3,7,10,8242.0,1:59,0,0,0,10154.0,2:27,4166666
8476924,Martin,Frk,1993-10-05,RW,R,2019-20,17,6,2,8,0.47,-1,26,23.08,4,14115.0,13:50,0,0,0,0.0,14,3,2,10,-8,1,0,1,1508.0,1:28,0,0,0,1.0,0:0,700000
8476925,Colton,Sissons,1993-11-05,C,R,2019-20,57,9,6,15,0.26,-2,52,17.31,20,49012.0,14:19,283,269,552,51.27,84,41,14,25,-11,0,0,0,731.0,0:12,1,0,1,8043.0,2:21,2857143
8476927,Teddy,Blueger,1994-08-15,C,L,2019-20,69,9,13,22,0.32,2,102,8.82,25,65460.0,15:48,402,488,890,45.17,83,35,29,22,7,0,0,0,466.0,0:6,0,2,2,9866.0,2:22,750000
8476931,Jake,McCabe,1993-10-12,D,L,2019-20,66,3,10,13,0.2,-11,75,4.0,41,73374.0,18:31,0,0,0,0.0,91,90,19,21,-2,0,0,0,182.0,0:2,1,0,1,9023.0,2:16,2850000
8476934,Brock,McGinn,1994-02-02,LW,L,2019-20,68,7,10,17,0.25,-4,93,7.53,17,53864.0,13:12,15,24,39,38.46,80,28,19,10,9,0,0,0,181.0,0:2,2,0,2,9881.0,2:25,2100000
8476941,Connor,Carrick,1994-04-13,D,R,2019-20,29,1,5,6,0.21,-6,25,4.0,17,25073.0,14:24,0,0,0,0.0,27,39,5,12,-7,0,0,0,149.0,0:5,0,0,0,803.0,0:27,1500000
8476947,Nikolai,Prokhorkin,1993-09-17,LW,L,2019-20,43,4,10,14,0.33,-6,63,6.35,6,31232.0,12:6,101,111,212,47.64,38,7,19,14,5,0,3,3,1521.0,0:35,0,0,0,14.0,0:0,925000
8476948,Charles,Hudon,1994-06-23,LW,L,2019-20,15,1,1,2,0.13,-9,22,4.55,0,10387.0,11:32,1,3,4,25.0,25,2,5,2,3,0,0,0,953.0,1:3,0,0,0,0.0,0:0,800000
8476952,Dominic,Toninato,1994-03-09,C,L,2019-20,46,4,7,11,0.24,4,38,10.53,37,30752.0,11:8,128,144,272,47.06,57,28,17,13,4,0,0,0,290.0,0:6,0,0,0,1201.0,0:26,775000
8476953,Trevor,Carrick,1994-07-04,D,L,2019-20,3,0,0,0,0.0,0,1,0.0,5,1042.0,5:47,0,0,0,0.0,1,0,0,2,-2,0,0,0,91.0,0:30,0,0,0,0.0,0:0,700000
8476958,Jaccob,Slavin,1994-05-01,D,L,2019-20,68,6,30,36,0.53,30,145,4.14,10,95495.0,23:24,0,0,0,0.0,43,107,81,49,32,0,3,3,3732.0,0:54,0,1,1,12655.0,3:6,5300000
8476960,Andreas,Athanasiou,1994-08-06,LW,L,2019-20,55,11,15,26,0.47,-46,129,8.53,30,52287.0,15:50,43,60,103,41.75,36,24,15,31,-16,3,4,7,6675.0,2:1,0,0,0,143.0,0:2,3000000
8476966,Gemel,Smith,1994-04-16,C,L,2019-20,3,1,0,1,0.33,0,1,100.0,4,1651.0,9:10,13,7,20,65.0,1,2,1,0,1,0,0,0,10.0,0:3,0,0,0,112.0,0:37,700000
8476967,Brett,Kulak,1994-01-06,D,L,2019-20,56,0,7,7,0.12,-1,101,0.0,12,57589.0,17:8,0,0,0,0.0,59,50,13,36,-23,0,0,0,186.0,0:3,0,0,0,722.0,0:12,1850000
8476975,Cedric,Paquette,1993-08-13,C,L,2019-20,64,7,11,18,0.28,-1,82,8.54,42,50080.0,13:2,325,310,635,51.18,190,50,17,9,8,0,0,0,255.0,0:3,1,1,2,7057.0,1:50,1650000
8476979,Erik,Gustafsson,1992-03-14,D,L,2019-20,66,6,23,29,0.44,-9,103,5.83,27,80710.0,20:22,0,0,0,0.0,86,58,21,58,-37,2,7,9,10668.0,2:41,0,0,0,697.0,0:10,1200000
8476981,Josh,Anderson,1994-05-07,RW,R,2019-20,26,1,3,4,0.15,-8,63,1.59,17,25052.0,16:3,7,12,19,36.84,68,13,9,12,-3,0,0,0,2714.0,1:44,0,0,0,2537.0,1:37,1850000
8476983,Paul,LaDue,1992-09-06,D,R,2019-20,2,0,1,1,0.5,0,2,0.0,0,1536.0,12:48,0,0,0,0.0,2,3,1,1,0,0,0,0,0.0,0:0,0,0,0,30.0,0:15,825000
8476987,Jake,Bischoff,1994-07-25,D,L,2019-20,4,0,0,0,0.0,-2,6,0.0,4,3744.0,15:36,0,0,0,0.0,8,8,0,2,-2,0,0,0,32.0,0:8,0,0,0,141.0,0:35,716667
8476988,Matt,Benning,1994-05-25,D,R,2019-20,43,1,7,8,0.19,8,38,2.63,15,34126.0,13:13,0,0,0,0.0,78,34,12,19,-7,0,0,0,10.0,0:0,0,0,0,1645.0,0:38,1900000
8476994,Vinnie,Hinostroza,1994-04-03,LW,R,2019-20,68,5,17,22,0.32,1,132,3.79,14,53474.0,13:6,26,35,61,42.62,51,26,30,20,10,0,1,1,284.0,0:4,0,1,1,3217.0,0:47,1500000
8477003,Riley,Barber,1994-02-07,RW,R,2019-20,9,0,0,0,0.0,-1,6,0.0,2,4459.0,8:15,1,0,1,100.0,15,1,0,2,-2,0,0,0,0.0,0:0,0,0,0,0.0,0:0,700000
8477010,Joseph,Blandisi,1994-07-18,LW,L,2019-20,21,2,3,5,0.24,-3,12,16.67,10,10346.0,8:12,33,48,81,40.74,26,9,8,1,7,0,0,0,24.0,0:1,0,0,0,64.0,0:3,700000
8477015,Connor,Brown,1994-01-14,RW,R,2019-20,71,16,27,43,0.61,-6,173,9.25,24,85689.0,20:6,29,39,68,42.65,39,35,52,40,12,3,1,4,7104.0,1:40,0,2,2,11107.0,2:36,2100000
8477018,Ben,Hutton,1993-04-20,D,L,2019-20,65,4,12,16,0.25,5,114,3.51,14,71254.0,18:16,0,0,0,0.0,51,76,12,41,-29,0,0,0,497.0,0:7,0,0,0,5511.0,1:24,1500000
8477021,Alexander,Kerfoot,1994-08-11,C,L,2019-20,65,9,19,28,0.43,-2,88,10.23,32,57600.0,14:46,191,216,407,46.93,48,41,28,33,-5,1,2,3,4893.0,1:15,0,0,0,1055.0,0:16,3500000
8477038,Nikita,Gusev,1992-07-08,LW,R,2019-20,66,13,31,44,0.67,-15,158,8.23,12,58185.0,14:41,1,2,3,33.33,12,7,22,40,-18,5,10,15,9850.0,2:29,0,0,0,10.0,0:0,4500000
8477043,Christian,Djoos,1994-08-06,D,L,2019-20,11,1,2,3,0.27,3,13,7.69,0,12609.0,19:6,0,0,0,0.0,2,12,2,6,-4,0,1,1,1439.0,2:10,0,0,0,811.0,1:13,1250000
8477046,Joakim,Ryan,1993-06-17,D,L,2019-20,35,1,4,5,0.14,-10,54,1.85,10,40166.0,19:7,0,0,0,0.0,24,46,6,28,-22,0,0,0,122.0,0:3,0,0,0,3474.0,1:39,725000
8477073,Kurtis,MacDermid,1994-03-25,D,L,2019-20,45,3,5,8,0.18,-9,51,5.88,47,36990.0,13:42,0,0,0,0.0,95,43,5,26,-21,0,0,0,11.0,0:0,0,1,1,3085.0,1:8,675000
8477085,Ashton,Sautner,1994-05-27,D,L,2019-20,1,0,0,0,0.0,0,1,0.0,0,169.0,2:49,0,0,0,0.0,0,0,0,0,0,0,0,0,0.0,0:0,0,0,0,0.0,0:0,675000
8477126,Jayson,Megna,1990-02-01,C,R,2019-20,8,0,0,0,0.0,-1,4,0.0,2,3222.0,6:42,0,1,1,0.0,10,5,0,1,-1,0,0,0,4.0,0:0,0,0,0,0.0,0:0,700000
8477149,Scott,Sabourin,1992-07-30,RW,R,2019-20,35,2,4,6,0.17,-6,29,6.9,33,14730.0,7:0,0,1,1,0.0,74,13,5,6,-1,0,0,0,5.0,0:0,0,0,0,0.0,0:0,700000
8477210,Buddy,Robinson,1991-09-30,RW,R,2019-20,5,1,0,1,0.2,0,6,16.67,7,3671.0,12:14,0,0,0,0.0,14,5,2,1,1,0,0,0,0.0,0:0,0,0,0,155.0,0:31,700000
8477213,Tim,Schaller,1990-11-16,C,L,2019-20,53,5,1,6,0.11,-14,49,10.2,14,36771.0,11:33,7,11,18,38.89,51,28,14,9,5,0,0,0,124.0,0:2,1,0,1,8584.0,2:41,1900000
8477215,Danny,DeKeyser,1990-03-07,D,L,2019-20,8,0,4,4,0.5,0,12,0.0,4,10589.0,22:3,0,0,0,0.0,6,18,0,8,-8,0,0,0,6.0,0:0,0,0,0,1686.0,3:30,5000000
8477220,Nate,Schmidt,1991-07-16,D,L,2019-20,62,8,26,34,0.55,12,122,6.56,16,81219.0,21:49,0,0,0,0.0,27,93,35,41,-6,1,6,7,4199.0,1:7,0,0,0,5925.0,1:35,5950000
8477240,Carter,Rowney,1989-05-10,RW,R,2019-20,71,8,11,19,0.27,5,63,12.7,14,54630.0,12:49,47,56,103,45.63,189,42,24,26,-2,0,0,0,374.0,0:5,2,2,4,10093.0,2:22,1133333
8477244,Chad,Ruhwedel,1990-05-07,D,R,2019-20,41,2,4,6,0.15,4,44,4.55,12,36332.0,14:46,0,0,0,0.0,74,25,7,17,-10,0,0,0,74.0,0:1,0,0,0,3142.0,1:16,700000
8477290,Michael,Raffl,1988-12-01,LW,L,2019-20,59,9,13,22,0.37,0,68,13.24,16,43673.0,12:20,100,99,199,50.25,74,25,19,23,-4,0,1,1,167.0,0:2,1,0,1,4430.0,1:15,1600000
8477320,Anton,Blidh,1995-03-14,LW,L,2019-20,7,0,0,0,0.0,-1,9,0.0,0,4837.0,11:31,0,1,1,0.0,20,5,2,1,1,0,0,0,0.0,0:0,0,0,0,586.0,1:23,700000
8477330,Dominik,Kubalik,1995-08-21,LW,L,2019-20,68,30,16,46,0.68,2,157,19.11,16,58648.0,14:22,6,13,19,31.58,79,17,23,25,-2,4,4,8,7953.0,1:56,0,0,0,101.0,0:1,925000
8477337,John,Gilmour,1993-05-17,D,L,2019-20,4,0,0,0,0.0,-2,5,0.0,0,4090.0,17:2,0,0,0,0.0,3,3,0,3,-3,0,0,0,0.0,0:0,0,0,0,310.0,1:17,700000
8477341,Andreas,Johnsson,1994-11-21,LW,L,2019-20,43,8,13,21,0.49,0,78,10.26,14,40647.0,15:45,0,2,2,0.0,43,21,13,20,-7,4,1,5,5213.0,2:1,0,0,0,567.0,0:13,3400000
8477343,Tyler,Lewington,1994-12-05,D,R,2019-20,6,0,0,0,0.0,-2,2,0.0,17,3657.0,10:9,0,0,0,0.0,13,7,1,3,-2,0,0,0,0.0,0:0,0,0,0,140.0,0:23,675000
8477346,MacKenzie,Weegar,1994-01-07,D,R,2019-20,45,7,11,18,0.4,6,77,9.09,33,54315.0,20:7,0,0,0,0.0,76,71,25,38,-13,0,0,0,558.0,0:12,0,0,0,4842.0,1:47,1600000
8477353,Tyler,Motte,1995-03-10,C,L,2019-20,34,4,4,8,0.24,-10,38,10.53,10,26758.0,13:7,8,11,19,42.11,118,37,16,9,7,0,0,0,103.0,0:3,0,0,0,4085.0,2:0,975000
8477355,Will,Butcher,1995-01-06,D,L,2019-20,56,4,17,21,0.38,-8,62,6.45,6,60202.0,17:55,0,0,0,0.0,31,75,10,27,-17,0,1,1,4355.0,1:17,0,0,0,751.0,0:13,3733333
8477359,Tucker,Poolman,1993-06-08,D,R,2019-20,57,4,12,16,0.28,-1,64,6.25,24,59673.0,17:26,0,0,0,0.0,58,59,14,46,-32,0,0,0,601.0,0:10,1,0,1,2444.0,0:42,775000
8477365,Connor,Clifton,1995-04-28,D,R,2019-20,32,2,0,2,0.06,3,22,9.09,14,27763.0,14:27,0,0,0,0.0,95,34,12,8,4,0,0,0,154.0,0:4,0,0,0,858.0,0:26,725000
8477366,Luke,Johnson,1994-09-19,C,R,2019-20,3,0,0,0,0.0,-3,1,0.0,0,2085.0,11:35,16,16,32,50.0,6,0,0,0,0,0,0,0,109.0,0:36,0,0,0,76.0,0:25,700000
8477369,Carson,Soucy,1994-07-27,D,L,2019-20,55,7,7,14,0.25,16,61,11.48,18,51575.0,15:37,0,0,0,0.0,69,50,17,16,1,0,0,0,118.0,0:2,1,0,1,3773.0,1:8,750000
8477380,Jonny,Brodzinski,1993-06-19,C,L,2019-20,3,0,1,1,0.33,0,5,0.0,0,1332.0,7:24,0,1,1,0.0,3,0,0,0,0,0,0,0,76.0,0:25,0,0,0,0.0,0:0,700000
8477384,Josh,Brown,1994-01-21,D,R,2019-20,56,3,5,8,0.14,1,48,6.25,39,45084.0,13:25,0,0,0,0.0,77,53,10,24,-14,0,0,0,12.0,0:0,0,0,0,1430.0,0:25,675000
8477401,John,Hayden,1995-02-14,RW,R,2019-20,43,3,1,4,0.09,-2,39,7.69,77,25066.0,9:42,4,15,19,21.05,87,27,13,7,6,0,0,0,133.0,0:3,0,0,0,532.0,0:12,750000
8477402,Pavel,Buchnevich,1995-04-17,RW,L,2019-20,68,16,30,46,0.68,2,148,10.81,24,69073.0,16:55,4,19,23,17.39,80,22,38,64,-26,4,5,9,9380.0,2:17,0,0,0,69.0,0:1,3250000
8477404,Jake,Guentzel,1994-10-06,C,L,2019-20,39,20,23,43,1.1,11,127,15.75,14,48270.0,20:37,22,24,46,47.83,46,19,21,12,9,6,4,10,7426.0,3:10,0,0,0,572.0,0:14,6000000
8477406,Mattias,Janmark,1992-12-08,C,L,2019-20,65,6,16,22,0.34,-5,92,6.52,16,57175.0,14:39,31,40,71,43.66,25,37,28,32,-4,1,4,5,2426.0,0:37,1,1,2,6292.0,1:36,2300000
8477407,Anthony,Duclair,1995-08-26,LW,L,2019-20,66,23,17,40,0.61,-5,184,12.5,18,64393.0,16:15,3,3,6,50.0,53,39,18,46,-28,5,3,8,10190.0,2:34,2,0,2,3693.0,0:55,1650000
8477409,Carter,Verhaeghe,1995-08-14,C,L,2019-20,52,9,4,13,0.25,-9,57,15.79,8,29208.0,9:21,14,17,31,45.16,29,8,19,11,8,1,0,1,763.0,0:14,0,0,0,79.0,0:1,700000
8477416,Oliver,Bjorkstrand,1995-04-10,RW,R,2019-20,49,21,15,36,0.73,8,162,12.96,12,52748.0,17:56,6,13,19,31.58,43,16,32,27,5,3,3,6,7296.0,2:28,0,0,0,28.0,0:0,2500000
8477425,Miles,Wood,1995-09-13,LW,L,2019-20,68,11,12,23,0.34,-19,141,7.8,57,53992.0,13:14,0,1,1,0.0,102,26,15,22,-7,0,0,0,3227.0,0:47,0,0,0,247.0,0:3,2750000
8477426,Nick,Paul,1995-03-20,LW,L,2019-20,56,9,11,20,0.36,0,103,8.74,24,48525.0,14:26,191,182,373,51.21,122,39,27,19,8,0,1,1,1729.0,0:30,0,0,0,1471.0,0:26,750000
8477429,Andrew,Copp,1994-07-08,C,L,2019-20,63,10,16,26,0.41,-3,121,8.26,10,66892.0,17:41,310,275,585,52.99,59,27,38,27,11,1,0,1,4475.0,1:11,0,3,3,8625.0,2:16,2280000
8477435,Ryan,Graves,1995-05-21,D,L,2019-20,72,10,17,27,0.38,43,138,7.25,45,81898.0,18:57,0,0,0,0.0,118,155,19,41,-22,0,0,0,254.0,0:3,0,2,2,12277.0,2:50,735000
8477444,Andre,Burakovsky,1995-02-09,LW,L,2019-20,61,21,27,48,0.79,13,105,20.0,22,55230.0,15:5,5,9,14,35.71,27,35,27,33,-6,3,9,12,8885.0,2:25,0,0,0,12.0,0:0,3250000
8477447,Shea,Theodore,1995-08-03,D,L,2019-20,74,15,35,50,0.68,14,230,6.52,27,99061.0,22:18,0,0,0,0.0,20,73,55,55,0,2,16,18,13937.0,3:8,1,0,1,650.0,0:8,5200000
8477448,Marko,Dano,1994-11-30,C,L,2019-20,3,0,0,0,0.0,-1,2,0.0,2,1291.0,7:10,0,0,0,0.0,5,3,1,1,0,0,0,0,0.0,0:0,0,0,0,0.0,0:0,800000
8477450,Jason,Dickinson,1995-07-04,C,L,2019-20,68,9,12,21,0.31,6,90,10.0,6,61417.0,15:3,211,270,481,43.87,97,58,48,32,16,0,0,0,292.0,0:4,0,1,1,9005.0,2:12,1500000
8477451,Ryan,Hartman,1994-09-20,RW,R,2019-20,69,9,11,20,0.29,4,114,7.89,69,50738.0,12:15,83,69,152,54.61,44,54,34,14,20,1,0,1,360.0,0:5,0,0,0,4473.0,1:4,1900000
8477454,Adam,Erne,1995-04-20,LW,L,2019-20,56,2,3,5,0.09,-24,63,3.17,28,39701.0,11:48,20,13,33,60.61,142,25,5,27,-22,0,0,0,2917.0,0:52,0,0,0,184.0,0:3,1050000
8477455,Jacob,de la Rose,1995-05-20,LW,L,2019-20,50,2,7,9,0.18,2,46,4.35,10,32174.0,10:43,118,156,274,43.07,120,16,13,8,5,0,0,0,53.0,0:1,0,0,0,3549.0,1:10,900000
8477456,J.T.,Compher,1995-04-08,LW,R,2019-20,70,12,21,33,0.47,12,112,10.71,18,69559.0,16:33,359,388,747,48.06,37,62,22,21,1,1,4,5,8509.0,2:1,0,3,3,9533.0,2:16,3500000
8477458,Valentin,Zykov,1995-05-15,LW,R,2019-20,15,1,3,4,0.27,-2,19,5.26,6,10990.0,12:12,0,1,1,0.0,20,3,5,12,-7,1,0,1,1204.0,1:20,0,0,0,7.0,0:0,675000
8477462,Robert,Hagg,1995-02-08,D,L,2019-20,51,3,10,13,0.25,12,39,7.69,32,47690.0,15:35,0,0,0,0.0,141,81,7,32,-25,1,0,1,100.0,0:1,0,0,0,3397.0,1:6,1150000
8477463,Steven,Santini,1995-03-07,D,R,2019-20,2,0,0,0,0.0,1,1,0.0,2,1146.0,9:33,0,0,0,0.0,3,0,0,0,0,0,0,0,0.0,0:0,0,0,0,35.0,0:17,1416667
8477464,Nic,Petan,1995-03-22,LW,L,2019-20,16,0,3,3,0.19,-4,19,0.0,4,10674.0,11:7,1,3,4,25.0,7,4,4,2,2,0,0,0,778.0,0:48,0,0,0,0.0,0:0,775000
8477467,Gustav,Olofsson,1994-12-01,D,L,2019-20,3,0,0,0,0.0,-4,2,0.0,2,1459.0,8:6,0,0,0,0.0,1,6,0,1,-1,0,0,0,0.0,0:0,0,0,0,0.0,0:0,700000
8477472,Carl,Dahlstrom,1995-01-28,D,L,2019-20,15,0,1,1,0.07,-4,9,0.0,6,13288.0,14:45,0,0,0,0.0,5,13,4,14,-10,0,0,0,67.0,0:4,0,0,0,897.0,0:59,850000
8477473,Justin,Bailey,1995-07-01,RW,R,2019-20,2,0,0,0,0.0,0,1,0.0,0,639.0,5:19,0,0,0,0.0,4,0,0,1,-1,0,0,0,0.0,0:0,0,0,0,0.0,0:0,750000
8477474,Madison,Bowey,1995-04-22,D,R,2019-20,53,3,14,17,0.32,-16,70,4.29,34,56947.0,17:54,0,0,0,0.0,53,58,14,45,-31,0,1,1,2176.0,0:41,0,0,0,4318.0,1:21,1000000
8477476,Artturi,Lehkonen,1995-07-04,LW,L,2019-20,70,13,14,27,0.39,2,140,9.29,24,64797.0,15:25,12,14,26,46.15,120,38,30,22,8,0,0,0,760.0,0:10,1,0,1,10150.0,2:25,2400000
8477478,William,Carrier,1994-12-20,LW,L,2019-20,74,8,12,20,0.27,0,106,7.55,41,43570.0,9:48,9,5,14,64.29,221,11,23,8,15,0,0,0,264.0,0:3,0,0,0,191.0,0:2,725000
8477479,Tyler,Bertuzzi,1995-02-24,LW,L,2019-20,71,21,27,48,0.68,-23,129,16.28,40,82279.0,19:18,4,2,6,66.67,71,30,25,57,-32,3,11,14,13391.0,3:8,0,0,0,778.0,0:10,1400000
8477482,Zach,Sanford,1994-11-09,LW,L,2019-20,61,16,16,32,0.52,14,93,17.2,30,50460.0,13:47,2,8,10,20.0,114,39,19,19,0,1,0,1,2480.0,0:40,0,0,0,1942.0,0:31,1500000
8477488,Brett,Pesce,1994-11-15,D,R,2019-20,61,4,14,18,0.3,7,104,3.85,27,80088.0,21:52,0,0,0,0.0,22,91,42,39,3,0,0,0,1071.0,0:17,0,2,2,11930.0,3:15,4025000
8477492,Nathan,MacKinnon,1995-09-01,C,R,2019-20,72,36,60,96,1.33,15,333,10.81,16,91872.0,21:16,381,499,880,43.3,58,31,39,53,-14,13,20,33,18276.0,4:13,0,0,0,303.0,0:4,6300000
8477493,Aleksander,Barkov,1995-09-02,C,L,2019-20,66,20,42,62,0.94,2,172,11.63,18,79260.0,20:0,653,550,1203,54.28,21,35,51,52,-1,7,13,20,13425.0,3:23,0,1,1,4409.0,1:6,5900000
8477494,Jonathan,Drouin,1995-03-28,LW,L,2019-20,27,7,8,15,0.56,-6,51,13.73,14,25436.0,15:42,4,8,12,33.33,25,5,12,11,1,1,3,4,3894.0,2:24,0,0,0,27.0,0:1,5500000
8477495,Seth,Jones,1994-10-03,D,R,2019-20,56,6,24,30,0.54,10,126,4.76,20,84941.0,25:16,0,0,0,0.0,62,123,29,37,-8,2,7,9,8647.0,2:34,0,1,1,8123.0,2:25,5400000
8477496,Elias,Lindholm,1994-12-02,C,R,2019-20,70,29,25,54,0.77,-8,169,17.16,22,82878.0,19:43,395,406,801,49.31,93,41,38,33,5,8,11,19,11886.0,2:49,0,0,0,8796.0,2:5,4850000
8477497,Sean,Monahan,1994-10-12,C,L,2019-20,70,22,26,48,0.69,-16,166,13.25,25,75939.0,18:4,549,495,1044,52.59,65,22,43,36,7,8,8,16,12031.0,2:51,0,0,0,123.0,0:1,6375000
8477498,Darnell,Nurse,1995-02-04,D,L,2019-20,71,5,28,33,0.46,-2,170,2.94,48,99916.0,23:27,0,0,0,0.0,172,141,26,54,-28,0,5,5,4521.0,1:3,0,0,0,8668.0,2:2,3200000
8477499,Rasmus,Ristolainen,1994-10-27,D,R,2019-20,69,6,27,33,0.48,-2,128,4.69,46,94389.0,22:47,0,0,0,0.0,203,82,17,24,-7,2,7,9,9631.0,2:19,0,1,1,9328.0,2:15,5400000
8477500,Bo,Horvat,1995-04-05,C,L,2019-20,69,22,31,53,0.77,-14,178,12.36,21,81690.0,19:43,850,633,1483,57.32,55,66,28,27,1,11,4,15,15353.0,3:42,0,0,0,1691.0,0:24,5500000
8477501,Valeri,Nichushkin,1995-03-04,RW,L,2019-20,68,13,14,27,0.4,26,117,11.11,14,57504.0,14:5,2,3,5,40.0,91,22,39,21,18,1,0,1,6490.0,1:35,1,0,1,2331.0,0:34,2950000
8477503,Max,Domi,1995-03-02,LW,L,2019-20,71,17,27,44,0.62,-3,179,9.5,35,72835.0,17:5,385,403,788,48.86,32,13,42,64,-22,1,10,11,9890.0,2:19,0,0,0,84.0,0:1,3150000
8477504,Josh,Morrissey,1995-03-28,D,L,2019-20,65,5,26,31,0.48,1,120,4.17,24,88804.0,22:46,0,0,0,0.0,34,59,22,46,-24,1,11,12,6810.0,1:44,0,0,0,3733.0,0:57,3150000
8477505,Alexander,Wennberg,1994-09-22,C,L,2019-20,57,5,17,22,0.39,-5,72,6.94,16,57055.0,16:40,309,363,672,45.98,21,31,20,25,-5,1,4,5,7100.0,2:4,0,0,0,5105.0,1:29,4900000
8477506,Ryan,Pulock,1994-10-06,D,R,2019-20,68,10,25,35,0.51,8,163,6.13,14,91424.0,22:24,0,0,0,0.0,110,139,15,64,-49,3,5,8,7208.0,1:46,0,0,0,6084.0,1:29,2000000
8477507,Nikita,Zadorov,1995-04-16,D,L,2019-20,67,4,9,13,0.19,5,67,5.97,67,70864.0,17:37,0,0,0,0.0,183,69,23,35,-12,0,0,0,272.0,0:4,0,0,0,6789.0,1:41,3200000
8477508,Curtis,Lazar,1995-02-02,C,R,2019-20,38,5,5,10,0.26,-3,33,15.15,9,26979.0,11:49,185,176,361,51.25,70,24,13,10,3,0,0,0,49.0,0:1,0,1,1,4050.0,1:46,700000
8477509,Mirco,Mueller,1995-03-21,D,L,2019-20,50,2,5,7,0.14,-13,29,6.9,23,52927.0,17:38,0,0,0,0.0,63,91,9,27,-18,0,1,1,363.0,0:7,0,0,0,6218.0,2:4,1400000
8477511,Anthony,Mantha,1994-09-16,RW,L,2019-20,43,16,22,38,0.88,-7,137,11.68,34,48745.0,18:53,16,22,38,42.11,49,25,22,30,-8,6,3,9,7881.0,3:3,0,0,0,40.0,0:0,3300000
8477512,Frederik,Gauthier,1995-04-26,C,L,2019-20,61,7,5,12,0.2,-4,42,16.67,10,34360.0,9:23,208,172,380,54.74,66,23,7,13,-6,0,0,0,84.0,0:1,0,0,0,3476.0,0:56,675000
8477527,Ross,Johnston,1994-02-18,LW,L,2019-20,32,3,1,4,0.12,1,16,18.75,78,15336.0,7:59,1,0,1,100.0,93,14,2,4,-2,0,0,0,6.0,0:0,0,0,0,0.0,0:0,1000000
8477529,Colby,Cave,1994-12-26,C,L,2019-20,11,1,0,1,0.09,-3,5,20.0,4,6364.0,9:38,36,41,77,46.75,17,3,3,1,2,0,0,0,5.0,0:0,0,0,0,598.0,0:54,675000
8477541,Dakota,Mermis,1994-01-05,D,L,2019-20,10,1,3,4,0.4,7,17,5.88,4,11530.0,19:13,0,0,0,0.0,20,21,1,7,-6,0,0,0,16.0,0:1,0,0,0,1202.0,2:0,700000
8477573,Nathan,Walker,1994-02-07,LW,L,2019-20,5,1,1,2,0.4,-2,6,16.67,4,3339.0,11:7,1,0,1,100.0,10,1,0,1,-1,0,0,0,0.0,0:0,0,0,0,0.0,0:0,700000
8477810,Joel,Hanley,1991-06-08,D,L,2019-20,8,0,2,2,0.25,0,4,0.0,6,5451.0,11:21,0,0,0,0.0,3,8,0,5,-5,0,0,0,16.0,0:2,0,0,0,96.0,0:12,700000
8477839,Conor,Sheary,1992-06-08,LW,L,2019-20,63,10,13,23,0.37,-5,102,9.8,10,49549.0,13:6,1,3,4,25.0,28,26,19,18,1,1,2,3,4482.0,1:11,0,0,0,81.0,0:1,3000000
8477845,Trevor,van Riemsdyk,1991-07-24,D,R,2019-20,49,1,7,8,0.16,-7,58,1.72,10,43707.0,14:51,0,0,0,0.0,21,37,13,17,-4,0,0,0,100.0,0:2,0,0,0,3615.0,1:13,2300000
8477846,Ryan,Carpenter,1991-01-18,C,R,2019-20,69,3,12,15,0.22,-6,80,3.75,28,58264.0,14:4,263,347,610,43.11,117,48,30,29,1,0,0,0,984.0,0:14,1,2,3,9966.0,2:24,1000000
8477850,Christian,Folin,1991-02-09,D,R,2019-20,16,1,1,2,0.12,-1,13,7.69,13,13856.0,14:26,0,0,0,0.0,38,21,1,8,-7,0,0,0,5.0,0:0,0,0,0,536.0,0:33,800000
8477851,Jordan,Oesterle,1992-06-25,D,L,2019-20,58,3,10,13,0.22,-9,69,4.35,14,59211.0,17:0,0,0,0,0.0,48,88,11,37,-26,0,2,2,3447.0,0:59,0,0,0,2281.0,0:39,1400000
8477887,Patrick,Brown,1992-05-29,C,R,2019-20,1,1,0,1,1.0,0,2,50.0,0,604.0,10:4,0,0,0,0.0,6,0,0,1,-1,0,0,0,0.0,0:0,0,0,0,0.0,0:0,700000
8477901,Daniel,Carr,1991-11-01,LW,L,2019-20,11,1,0,1,0.09,-5,14,7.14,4,6822.0,10:20,0,1,1,0.0,10,2,8,1,7,0,0,0,111.0,0:10,0,0,0,19.0,0:1,700000
8477903,Garnet,Hathaway,1991-11-23,RW,R,2019-20,69,9,7,16,0.23,4,83,10.84,81,44728.0,10:48,9,20,29,31.03,197,49,21,16,5,0,0,0,160.0,0:2,0,1,1,5386.0,1:18,1500000
8477922,Melker,Karlsson,1990-07-18,C,R,2019-20,61,6,6,12,0.2,-7,56,10.71,20,44905.0,12:16,14,17,31,45.16,38,39,26,11,15,0,0,0,147.0,0:2,0,0,0,7789.0,2:7,2000000
8477930,Pierre-Edouard,Bellemare,1985-03-06,LW,L,2019-20,72,9,13,22,0.31,1,89,10.11,19,57769.0,13:22,434,387,821,52.86,45,49,54,17,37,0,0,0,294.0,0:4,2,2,4,9001.0,2:5,1800000
8477931,Tomas,Nosek,1992-09-01,LW,L,2019-20,70,8,8,16,0.23,-3,94,8.51,22,48733.0,11:36,230,225,455,50.55,98,38,22,16,6,0,0,0,277.0,0:3,1,0,1,5293.0,1:15,1000000
8477932,Aaron,Ekblad,1996-02-07,D,R,2019-20,67,5,36,41,0.61,12,147,3.4,26,92365.0,22:58,0,0,0,0.0,34,84,37,74,-37,0,6,6,5807.0,1:26,0,1,1,8169.0,2:1,7500000
8477933,Sam,Reinhart,1995-11-06,C,R,2019-20,69,22,28,50,0.72,-15,144,15.28,20,85402.0,20:37,40,72,112,35.71,36,27,21,33,-12,5,7,12,14340.0,3:27,0,0,0,202.0,0:2,3650000
8477934,Leon,Draisaitl,1995-10-27,C,L,2019-20,71,43,67,110,1.55,-7,218,19.72,18,96324.0,22:36,661,608,1269,52.09,27,19,60,91,-31,16,28,44,16380.0,3:50,0,0,0,3724.0,0:52,8500000
8477935,Sam,Bennett,1996-06-20,C,L,2019-20,52,8,4,12,0.23,-1,82,9.76,36,39035.0,12:30,89,83,172,51.74,101,13,19,22,-3,0,1,1,2279.0,0:43,0,0,0,212.0,0:4,2550000
8477936,Michael,Dal Colle,1996-06-20,LW,L,2019-20,53,4,6,10,0.19,-8,59,6.78,12,37519.0,11:47,5,2,7,71.43,81,21,10,18,-8,0,0,0,876.0,0:16,0,0,0,25.0,0:0,700000
8477937,Jake,Virtanen,1996-08-17,RW,R,2019-20,69,18,18,36,0.52,-4,150,12.0,41,54173.0,13:5,5,13,18,27.78,102,28,37,31,6,6,3,9,3684.0,0:53,0,0,0,117.0,0:1,1250000
8477938,Haydn,Fleury,1996-07-08,D,L,2019-20,45,4,10,14,0.31,-2,65,6.15,8,36896.0,13:39,0,0,0,0.0,48,45,17,26,-9,0,0,0,21.0,0:0,0,1,1,2100.0,0:46,850000
8477939,William,Nylander,1996-05-01,C,R,2019-20,68,31,28,59,0.87,-2,197,15.74,12,74291.0,18:12,106,106,212,50.0,9,14,42,41,1,9,8,17,11767.0,2:53,0,0,0,57.0,0:0,6962366
8477940,Nikolaj,Ehlers,1996-02-14,LW,L,2019-20,71,25,33,58,0.82,14,203,12.32,30,70390.0,16:31,0,2,2,0.0,36,28,32,39,-7,3,2,5,5666.0,1:19,1,0,1,119.0,0:1,6000000
8477941,Nick,Ritchie,1995-12-05,LW,L,2019-20,50,9,12,21,0.42,1,79,11.39,97,42538.0,14:10,2,7,9,22.22,106,17,11,20,-9,2,1,3,4657.0,1:33,0,0,0,181.0,0:3,1498925
8477942,Kevin,Fiala,1996-07-22,LW,L,2019-20,64,23,31,54,0.84,-1,175,13.14,42,59139.0,15:24,2,7,9,22.22,25,18,33,35,-2,9,9,18,9146.0,2:22,0,0,0,111.0,0:1,3000000
8477943,Brendan,Perlini,1996-04-27,LW,L,2019-20,40,1,3,4,0.1,-18,48,2.08,10,25670.0,10:41,0,0,0,0.0,22,10,7,8,-1,0,0,0,2922.0,1:13,0,0,0,11.0,0:0,874125
8477944,Jakub,Vrana,1996-02-28,LW,L,2019-20,72,25,27,52,0.72,2,193,12.95,18,64187.0,14:51,6,5,11,54.55,32,16,33,46,-13,1,11,12,8389.0,1:56,0,0,0,84.0,0:1,3350000
8477946,Dylan,Larkin,1996-07-30,C,L,2019-20,71,19,34,53,0.75,-21,223,8.52,39,90521.0,21:14,714,648,1362,52.42,52,45,43,81,-38,5,9,14,13751.0,3:13,0,0,0,3229.0,0:45,6100000
8477947,Sonny,Milano,1996-05-12,LW,L,2019-20,55,7,16,23,0.42,-7,75,9.33,26,43220.0,13:5,0,0,0,0.0,26,13,22,30,-8,1,2,3,3999.0,1:12,0,0,0,58.0,0:1,874125
8477948,Travis,Sanheim,1996-03-29,D,L,2019-20,72,9,18,27,0.38,9,116,7.76,34,86874.0,20:6,0,0,0,0.0,44,91,23,57,-34,0,4,4,3972.0,0:55,0,0,0,7772.0,1:47,3250000
8477949,Alex,Tuch,1996-05-10,RW,R,2019-20,45,11,9,20,0.44,-9,106,10.38,8,39654.0,14:41,8,22,30,26.67,62,22,27,30,-3,4,4,8,4951.0,1:50,0,0,0,272.0,0:6,4750000
8477951,Nick,Schmaltz,1996-02-23,C,R,2019-20,70,11,34,45,0.64,3,95,11.58,20,65247.0,15:32,160,216,376,42.55,12,35,52,27,25,2,11,13,9431.0,2:14,0,0,0,54.0,0:0,5850000
8477952,Robby,Fabbri,1996-01-22,C,L,2019-20,61,15,17,32,0.52,-33,111,13.51,20,59104.0,16:8,27,40,67,40.3,75,14,13,39,-26,6,3,9,9306.0,2:32,0,0,0,45.0,0:0,900000
8477953,Kasperi,Kapanen,1996-07-23,RW,R,2019-20,69,13,23,36,0.52,0,121,10.74,22,65371.0,15:47,2,13,15,13.33,73,17,36,29,7,0,3,3,5191.0,1:15,2,0,2,6845.0,1:39,3200000
8477955,Jared,McCann,1996-05-31,C,L,2019-20,66,14,21,35,0.53,6,150,9.33,17,60365.0,15:14,265,306,571,46.41,89,27,33,29,4,2,4,6,6683.0,1:41,0,0,0,1960.0,0:29,1250000
8477956,David,Pastrnak,1996-05-25,RW,R,2019-20,73,48,47,95,1.3,18,292,16.44,40,83365.0,19:1,8,11,19,42.11,49,23,51,93,-42,20,18,38,16652.0,3:48,0,0,0,39.0,0:0,6666667
8477960,Adrian,Kempe,1996-09-13,LW,L,2019-20,69,11,21,32,0.46,-10,148,7.43,29,66290.0,16:0,92,131,223,41.26,71,17,24,27,-3,2,8,10,10303.0,2:29,2,2,4,3753.0,0:54,2000000
8477961,John,Quenneville,1996-04-16,C,L,2019-20,9,0,0,0,0.0,-1,14,0.0,0,5966.0,11:2,3,1,4,75.0,21,3,2,5,-3,0,0,0,396.0,0:44,0,0,0,19.0,0:2,750000
8477962,Brendan,Lemieux,1996-03-15,LW,L,2019-20,59,6,12,18,0.31,-14,86,6.98,111,45561.0,12:52,18,31,49,36.73,164,52,15,30,-15,2,3,5,4628.0,1:18,1,1,2,2251.0,0:38,925000
8477963,Jayce,Hawryluk,1996-01-01,C,R,2019-20,26,3,7,10,0.38,1,26,11.54,16,17306.0,11:5,4,8,12,33.33,65,9,11,12,-1,0,0,0,229.0,0:8,0,0,0,24.0,0:0,874125
8477964,Ivan,Barbashev,1995-12-14,C,L,2019-20,70,11,15,26,0.37,4,77,14.29,23,56403.0,13:25,152,179,331,45.92,151,34,33,31,2,0,0,0,455.0,0:6,2,1,3,6735.0,1:36,1475000
8477969,Marcus,Pettersson,1996-05-08,D,L,2019-20,69,2,20,22,0.32,9,79,2.53,35,80320.0,19:24,0,0,0,0.0,106,84,17,38,-21,0,2,2,3616.0,0:52,0,0,0,5273.0,1:16,874125
8477971,Andreas,Englund,1996-01-21,D,L,2019-20,24,0,3,3,0.12,-8,10,0.0,12,15705.0,10:54,0,0,0,0.0,58,16,4,5,-1,0,0,0,42.0,0:1,0,0,0,1568.0,1:5,700000
8477972,Josh,Jacobs,1996-02-15,D,R,2019-20,2,0,0,0,0.0,1,3,0.0,2,1991.0,16:35,0,0,0,0.0,3,4,1,0,1,0,0,0,0.0,0:0,0,0,0,41.0,0:20,700000
8477973,Vladislav,Kamenev,1996-08-12,C,L,2019-20,38,1,7,8,0.21,-2,32,3.12,8,20466.0,8:58,57,50,107,53.27,34,16,18,7,11,0,2,2,2423.0,1:3,0,0,0,144.0,0:3,750000
8477974,Ryan,MacInnis,1996-02-14,C,L,2019-20,10,0,1,1,0.1,1,13,0.0,0,5611.0,9:21,10,17,27,37.04,8,3,3,2,1,0,0,0,51.0,0:5,0,0,0,0.0,0:0,874125
8477979,Nicolas,Aube-Kubel,1996-05-10,RW,R,2019-20,39,9,8,17,0.44,2,55,16.36,21,26497.0,11:19,1,2,3,33.33,93,17,14,12,2,2,1,3,2105.0,0:53,0,0,0,390.0,0:10,700000
8477983,Maxim,Letunov,1996-02-20,C,L,2019-20,3,1,0,1,0.33,0,3,33.33,0,1634.0,9:4,3,3,6,50.0,0,1,2,1,1,0,0,0,0.0,0:0,0,0,0,0.0,0:0,700000
8477986,Brandon,Montour,1994-04-11,D,R,2019-20,54,5,13,18,0.33,13,86,5.81,28,63175.0,19:29,0,0,0,0.0,60,53,12,27,-15,0,2,2,2138.0,0:39,0,0,0,3732.0,1:9,3387500
8477987,Ryan,Donato,1996-04-09,C,L,2019-20,62,14,9,23,0.37,5,95,14.74,12,39562.0,10:38,40,62,102,39.22,53,14,21,13,8,0,2,2,2709.0,0:43,0,0,0,17.0,0:0,1900000
8477989,Christian,Dvorak,1996-02-02,C,L,2019-20,70,18,20,38,0.54,6,134,13.43,12,70124.0,16:41,523,426,949,55.11,39,36,20,23,-3,6,4,10,11466.0,2:43,0,0,0,1233.0,0:17,4450000
8477998,Warren,Foegele,1996-04-01,LW,L,2019-20,68,13,17,30,0.44,9,129,10.08,34,55935.0,13:42,18,20,38,47.37,64,17,39,30,9,0,0,0,216.0,0:3,3,0,3,4447.0,1:5,746667
8478010,Brayden,Point,1996-03-13,C,R,2019-20,69,26,41,67,0.97,26,148,17.57,17,78126.0,18:52,424,394,818,51.83,25,32,32,20,12,8,6,14,13206.0,3:11,0,0,0,235.0,0:3,6750000
8478013,Jake,Walman,1996-02-20,D,L,2019-20,1,0,0,0,0.0,1,1,0.0,0,664.0,11:4,0,0,0,0.0,0,1,0,0,0,0,0,0,0.0,0:0,0,0,0,0.0,0:0,925000
8478017,Mark,Friedman,1995-12-25,D,R,2019-20,6,0,1,1,0.17,0,2,0.0,2,4892.0,13:35,0,0,0,0.0,8,5,1,0,1,0,0,0,28.0,0:4,0,0,0,0.0,0:0,749167
8478020,Michael,Amadio,1996-05-13,C,R,2019-20,68,6,10,16,0.24,-11,99,6.06,10,53053.0,13:0,232,248,480,48.33,21,22,31,25,6,0,3,3,5825.0,1:25,0,0,0,613.0,0:9,700000
8478021,William,Lagesson,1996-02-22,D,L,2019-20,8,0,0,0,0.0,-4,8,0.0,0,5695.0,11:51,0,0,0,0.0,4,12,0,7,-7,0,0,0,0.0,0:0,0,0,0,628.0,1:18,741666
8478027,Lucas,Wallmark,1995-09-05,C,L,2019-20,67,12,13,25,0.37,0,84,14.29,18,51388.0,12:46,379,374,753,50.33,57,26,22,17,5,3,3,6,4217.0,1:2,0,1,1,4385.0,1:5,675000
8478029,Chase,De Leo,1995-10-25,C,L,2019-20,1,0,0,0,0.0,0,1,0.0,0,899.0,14:59,0,1,1,0.0,1,0,0,0,0,0,0,0,44.0,0:44,0,0,0,0.0,0:0,750000
8478036,Christoffer,Ehn,1996-04-05,C,L,2019-20,54,2,2,4,0.07,-21,36,5.56,2,33729.0,10:24,96,130,226,42.48,59,18,6,12,-6,0,0,0,79.0,0:1,0,0,0,4027.0,1:14,759167
8478038,Devon,Toews,1994-02-21,D,L,2019-20,68,6,22,28,0.41,1,122,4.92,16,83690.0,20:30,0,0,0,0.0,55,75,32,57,-25,1,5,6,9136.0,2:14,0,0,0,341.0,0:5,700000
8478042,Viktor,Arvidsson,1993-04-08,LW,R,2019-20,57,15,13,28,0.49,-4,127,11.81,26,55411.0,16:12,11,8,19,57.89,27,24,15,24,-9,4,4,8,8443.0,2:28,0,0,0,1993.0,0:34,4250000
8478043,Sam,Lafferty,1995-03-06,C,R,2019-20,50,6,7,13,0.26,5,56,10.71,23,28862.0,9:37,117,119,236,49.58,95,17,17,12,5,0,0,0,77.0,0:1,0,0,0,1841.0,0:36,767500
8478046,Danton,Heinen,1995-07-05,C,L,2019-20,67,10,16,26,0.39,-2,109,9.17,10,58169.0,14:28,5,8,13,38.46,35,34,19,30,-11,3,3,6,8742.0,2:10,0,0,0,475.0,0:7,2800000
8478056,Clark,Bishop,1996-03-29,C,L,2019-20,5,0,1,1,0.2,-2,4,0.0,4,2295.0,7:39,13,21,34,38.24,5,0,1,1,0,0,0,0,26.0,0:5,0,0,0,35.0,0:7,700000
8478067,Oskar,Lindblom,1996-08-15,LW,L,2019-20,30,11,7,18,0.6,4,72,15.28,4,31695.0,17:36,13,19,32,40.62,31,16,15,13,2,3,1,4,4050.0,2:15,0,0,0,2646.0,1:28,925000
8478073,Anton,Lindholm,1994-11-29,D,L,2019-20,4,0,1,1,0.25,1,1,0.0,0,2827.0,11:46,0,0,0,0.0,5,5,0,0,0,0,0,0,0.0,0:0,0,0,0,90.0,0:22,742500
8478074,Anthony,Angello,1996-03-06,C,R,2019-20,8,1,0,1,0.12,-1,5,20.0,4,2745.0,5:43,0,1,1,0.0,13,5,1,0,1,0,0,0,0.0,0:0,0,0,0,16.0,0:2,833750
8478075,Anders,Bjork,1996-08-05,LW,L,2019-20,61,9,10,19,0.31,3,72,12.5,10,47193.0,12:53,2,4,6,33.33,46,22,22,15,7,1,0,1,1165.0,0:19,0,0,0,1774.0,0:29,925000
8478099,Kevin,Labanc,1995-12-12,RW,R,2019-20,70,14,19,33,0.47,-33,176,7.95,38,67494.0,16:4,2,10,12,16.67,46,24,33,33,0,3,6,9,10140.0,2:24,0,0,0,154.0,0:2,1000000
8478104,Sammy,Blais,1996-06-17,LW,L,2019-20,43,6,8,14,0.33,-1,57,10.53,24,32159.0,12:27,0,0,0,0.0,166,15,13,19,-6,0,0,0,2128.0,0:49,0,0,0,28.0,0:0,850000
8478106,Dylan,Sikura,1995-06-01,RW,L,2019-20,9,1,2,3,0.33,1,10,10.0,0,5345.0,9:53,0,3,3,0.0,0,2,2,0,2,0,0,0,0.0,0:0,0,0,0,0.0,0:0,750000
8478109,Victor,Olofsson,1995-07-18,RW,L,2019-20,54,20,22,42,0.78,-1,127,15.75,6,59563.0,18:23,1,1,2,50.0,10,16,12,26,-14,11,6,17,10763.0,3:19,0,0,0,416.0,0:7,767500
8478115,Pierre,Engvall,1996-05-31,LW,L,2019-20,48,8,7,15,0.31,4,72,11.11,6,34369.0,11:56,41,64,105,39.05,29,10,15,23,-8,0,0,0,16.0,0:0,1,1,2,3742.0,1:17,925000
8478131,Ondrej,Kase,1995-11-08,RW,R,2019-20,56,7,18,25,0.45,-6,144,4.86,14,55350.0,16:28,6,23,29,20.69,14,18,42,30,12,0,2,2,5740.0,1:42,1,0,1,2153.0,0:38,2600000
8478133,Jake,Evans,1996-06-02,C,R,2019-20,13,2,1,3,0.23,1,14,14.29,0,8075.0,10:21,29,27,56,51.79,16,5,5,3,2,0,0,0,382.0,0:29,0,0,0,441.0,0:33,925000
8478136,Jacob,Middleton,1996-01-02,D,L,2019-20,10,0,2,2,0.2,-2,9,0.0,9,6460.0,10:46,0,0,0,0.0,18,5,1,1,0,0,0,0,0.0,0:0,0,0,0,455.0,0:45,735000
8478146,Matthew,Highmore,1996-02-27,C,L,2019-20,36,2,4,6,0.17,-1,35,5.71,6,21196.0,9:48,1,3,4,25.0,38,9,15,9,6,0,0,0,146.0,0:4,0,0,0,754.0,0:20,775833
8478176,Joe,Hicketts,1996-05-04,D,L,2019-20,6,0,2,2,0.33,-5,6,0.0,2,6579.0,18:16,0,0,0,0.0,14,13,2,3,-1,0,0,0,294.0,0:49,0,0,0,552.0,1:32,700000
8478211,Dryden,Hunt,1995-11-24,LW,L,2019-20,21,0,4,4,0.19,0,33,0.0,24,13221.0,10:29,0,0,0,0.0,37,7,4,4,0,0,0,0,96.0,0:4,0,0,0,0.0,0:0,715000
8478233,Andrew,Mangiapane,1996-04-04,LW,L,2019-20,68,17,15,32,0.47,4,109,15.6,18,55900.0,13:42,12,31,43,27.91,73,25,38,29,9,0,1,1,2106.0,0:30,0,0,0,58.0,0:0,715000
8478366,Frank,Vatrano,1994-03-14,C,L,2019-20,69,16,18,34,0.49,-8,162,9.88,30,62170.0,15:1,12,28,40,30.0,102,43,32,18,14,2,0,2,6027.0,1:27,2,0,2,5196.0,1:15,2533333
8478367,Cole,Bardreau,1993-07-22,C,R,2019-20,10,1,1,2,0.2,-2,10,10.0,6,5322.0,8:52,21,29,50,42.0,21,1,4,4,0,0,0,0,0.0,0:0,0,0,0,329.0,0:32,700000
8478396,Noah,Hanifin,1997-01-25,D,L,2019-20,70,5,17,22,0.31,-12,132,3.79,12,88968.0,21:10,0,0,0,0.0,82,89,38,63,-25,1,4,5,5453.0,1:17,0,0,0,6980.0,1:39,4950000
8478397,Rasmus,Andersson,1996-10-27,D,R,2019-20,70,5,17,22,0.31,-7,124,4.03,57,83814.0,19:57,0,0,0,0.0,51,83,19,39,-20,0,4,4,6245.0,1:29,0,0,0,2999.0,0:42,755833
8478398,Kyle,Connor,1996-12-09,LW,L,2019-20,71,38,35,73,1.03,4,239,15.9,34,89833.0,21:5,2,11,13,15.38,18,17,43,39,4,9,8,17,14051.0,3:17,1,1,2,4446.0,1:2,7142857
8478399,Jonas,Siegenthaler,1997-05-06,D,L,2019-20,67,2,7,9,0.13,7,52,3.85,43,63089.0,15:41,0,0,0,0.0,57,109,14,35,-21,0,0,0,75.0,0:1,0,0,0,12521.0,3:6,714166
8478400,Colin,White,1997-01-30,C,R,2019-20,61,7,16,23,0.38,-12,83,8.43,39,57487.0,15:42,275,305,580,47.41,47,30,23,29,-6,1,3,4,7960.0,2:10,0,0,0,82.0,0:1,4750000
8478401,Pavel,Zacha,1997-04-06,C,L,2019-20,65,8,24,32,0.49,-12,97,8.25,14,63443.0,16:16,283,371,654,43.27,62,19,35,31,4,3,5,8,6400.0,1:38,2,2,4,7926.0,2:1,2250000
8478402,Connor,McDavid,1997-01-13,C,L,2019-20,64,34,63,97,1.52,-6,212,16.04,28,83964.0,21:51,320,350,670,47.76,37,18,53,75,-22,11,32,43,14927.0,3:53,0,0,0,401.0,0:6,12500000
8478403,Jack,Eichel,1996-10-28,C,R,2019-20,68,36,42,78,1.15,5,227,15.86,34,90172.0,22:6,614,697,1311,46.83,40,42,44,66,-22,11,16,27,15829.0,3:52,1,0,1,1133.0,0:16,10000000
8478407,Vince,Dunn,1996-10-29,D,L,2019-20,74,9,15,24,0.32,12,142,6.34,31,72187.0,16:15,0,0,0,0.0,54,49,14,32,-18,4,6,10,6743.0,1:31,0,0,0,247.0,0:3,722500
8478408,Travis,Dermott,1996-12-22,D,L,2019-20,56,4,7,11,0.2,14,65,6.15,37,58157.0,17:18,0,0,0,0.0,76,58,23,44,-21,0,0,0,161.0,0:2,0,0,0,3865.0,1:9,863333
8478409,Anthony,Richard,1996-12-20,C,L,2019-20,1,0,0,0,0.0,-1,2,0.0,0,250.0,4:10,0,0,0,0.0,0,0,0,0,0,0,0,0,0.0,0:0,0,0,0,0.0,0:0,688333
8478413,Jordan,Greenway,1997-02-16,LW,L,2019-20,67,8,20,28,0.42,2,93,8.6,54,56929.0,14:9,15,12,27,55.56,95,44,41,30,11,0,3,3,1227.0,0:18,0,0,0,3538.0,0:52,916666
8478414,Timo,Meier,1996-10-08,RW,L,2019-20,70,22,27,49,0.7,-22,199,11.06,42,72588.0,17:16,12,25,37,32.43,155,38,39,31,8,2,7,9,8853.0,2:6,0,0,0,2917.0,0:41,6000000
8478416,Erik,Cernak,1997-05-28,D,R,2019-20,70,5,7,12,0.17,11,129,3.88,61,80015.0,19:3,0,0,0,0.0,180,105,19,28,-9,0,0,0,540.0,0:7,0,0,0,12396.0,2:57,697500
8478420,Mikko,Rantanen,1996-10-29,RW,L,2019-20,45,19,26,45,1.0,1,118,16.1,14,51620.0,19:7,49,36,85,57.65,32,23,37,19,18,8,7,15,10000.0,3:42,0,0,0,35.0,0:0,9250000
8478424,Jansen,Harkins,1997-05-23,C,L,2019-20,29,2,5,7,0.24,-2,29,6.9,5,18481.0,10:37,0,5,5,0.0,8,10,7,7,0,0,0,0,122.0,0:4,0,0,0,0.0,0:0,767500
8478425,Brendan,Guhle,1997-07-29,D,L,2019-20,30,4,4,8,0.27,-2,39,10.26,10,30738.0,17:4,0,0,0,0.0,21,43,6,25,-19,0,0,0,176.0,0:5,0,0,0,1382.0,0:46,697500
8478427,Sebastian,Aho,1997-07-26,RW,L,2019-20,68,38,28,66,0.97,10,206,18.45,26,79249.0,19:25,409,480,889,46.01,55,20,71,58,13,8,9,17,11621.0,2:50,4,1,5,7364.0,1:48,8454000
8478430,Oliver,Kylington,1997-05-19,D,L,2019-20,48,2,5,7,0.15,-6,37,5.41,16,39475.0,13:42,0,0,0,0.0,36,34,8,29,-21,0,0,0,92.0,0:1,0,0,0,107.0,0:2,730833
8478431,Evgeny,Svechnikov,1996-10-31,RW,L,2019-20,4,0,0,0,0.0,-1,7,0.0,2,1998.0,8:19,0,0,0,0.0,5,1,0,3,-3,0,0,0,175.0,0:43,0,0,0,0.0,0:0,863333
8478432,Christian,Fischer,1997-04-15,RW,R,2019-20,56,6,3,9,0.16,2,83,7.23,16,37030.0,11:1,3,8,11,27.27,140,22,6,10,-4,0,0,0,318.0,0:5,0,0,0,8.0,0:0,821666
8478434,Keegan,Kolesar,1997-04-08,RW,R,2019-20,1,0,0,0,0.0,0,1,0.0,0,726.0,12:6,1,0,1,100.0,2,0,0,0,0,0,0,0,0.0,0:0,0,0,0,0.0,0:0,702500
8478436,David,Kase,1997-01-28,RW,L,2019-20,6,1,0,1,0.17,1,5,20.0,0,3520.0,9:46,1,0,1,100.0,4,1,2,1,1,0,0,0,14.0,0:2,0,0,0,39.0,0:6,768333
8478439,Travis,Konecny,1997-03-11,C,R,2019-20,69,24,39,63,0.91,2,145,16.55,30,69584.0,16:48,25,26,51,49.02,66,33,30,49,-19,5,18,23,12020.0,2:54,0,0,0,73.0,0:1,5500000
8478440,Dylan,Strome,1997-03-07,C,L,2019-20,58,12,26,38,0.66,1,97,12.37,16,55471.0,15:56,277,304,581,47.68,23,29,30,26,4,2,6,8,9062.0,2:36,0,0,0,88.0,0:1,863333
8478443,Brandon,Carlo,1996-11-26,D,R,2019-20,70,4,15,19,0.27,15,116,3.45,37,85573.0,20:22,0,0,0,0.0,128,78,32,33,-1,0,0,0,210.0,0:3,0,0,0,12720.0,3:1,2850000
8478444,Brock,Boeser,1997-02-25,RW,R,2019-20,57,16,29,45,0.79,5,169,9.47,14,63516.0,18:34,11,19,30,36.67,28,14,20,22,-2,5,9,14,14099.0,4:7,0,0,0,76.0,0:1,5875000
8478445,Mathew,Barzal,1997-05-26,C,R,2019-20,68,19,41,60,0.88,5,171,11.11,44,81775.0,20:2,228,320,548,41.61,22,43,70,103,-33,4,8,12,10751.0,2:38,0,0,0,36.0,0:0,863333
8478447,Nicholas,Merkley,1997-05-23,RW,L,2019-20,4,1,1,2,0.5,0,8,12.5,2,2727.0,11:21,0,0,0,0.0,9,2,2,2,0,0,0,0,147.0,0:36,0,0,0,0.0,0:0,863333
8478449,Roope,Hintz,1996-11-17,LW,L,2019-20,63,19,15,34,0.54,4,125,15.2,18,55859.0,14:46,182,183,365,49.86,75,29,25,36,-11,3,12,15,7437.0,1:58,2,0,2,1235.0,0:19,811667
8478451,Ethan,Bear,1997-06-26,D,R,2019-20,71,5,16,21,0.3,-4,99,5.05,33,93582.0,21:58,0,0,0,0.0,59,106,44,84,-40,1,1,2,3135.0,0:44,0,0,0,7937.0,1:51,720000
8478452,Caleb,Jones,1997-06-06,D,L,2019-20,43,4,5,9,0.21,-1,38,10.53,10,36456.0,14:7,0,0,0,0.0,33,46,8,26,-18,0,1,1,241.0,0:5,0,0,0,114.0,0:2,720000
8478455,Austin,Wagner,1997-06-23,LW,L,2019-20,65,6,5,11,0.17,-5,124,4.84,39,45797.0,11:44,3,6,9,33.33,145,19,20,21,-1,0,0,0,278.0,0:4,0,0,0,159.0,0:2,759167
8478458,Jack,Roslovic,1997-01-29,C,R,2019-20,71,12,17,29,0.41,4,117,10.26,12,63470.0,14:53,70,78,148,47.3,58,21,24,38,-14,1,1,2,5584.0,1:18,0,0,0,2.0,0:0,894166
8478460,Zach,Werenski,1997-07-19,D,L,2019-20,63,20,21,41,0.65,9,187,10.7,10,90665.0,23:59,0,0,0,0.0,36,58,32,47,-15,5,8,13,10314.0,2:43,1,0,1,7487.0,1:58,5000000
8478462,Nicolas,Roy,1997-02-05,C,R,2019-20,31,6,7,13,0.42,2,44,13.64,10,21852.0,11:44,108,115,223,48.43,41,8,12,9,3,1,0,1,181.0,0:5,0,0,0,1297.0,0:41,720000
8478463,Anthony,Beauvillier,1997-06-08,C,L,2019-20,68,18,21,39,0.57,-11,132,13.64,15,70421.0,17:15,9,4,13,69.23,86,36,29,51,-22,3,4,7,7249.0,1:46,1,0,1,2630.0,0:38,2100000
8478466,Daniel,Sprong,1997-03-17,RW,R,2019-20,8,1,1,2,0.25,-2,17,5.88,0,6768.0,14:6,0,0,0,0.0,4,3,1,0,1,1,0,1,803.0,1:40,0,0,0,0.0,0:0,750000
8478468,Jeremy,Lauzon,1997-04-28,D,L,2019-20,22,1,1,2,0.09,4,21,4.76,43,20311.0,15:23,0,0,0,0.0,40,25,3,6,-3,0,0,0,9.0,0:0,0,0,0,2160.0,1:38,747500
8478469,Thomas,Chabot,1997-01-30,D,L,2019-20,71,6,33,39,0.55,-18,186,3.23,42,110776.0,26:0,0,0,0,0.0,79,85,42,87,-45,0,11,11,13877.0,3:15,0,0,0,1038.0,0:14,863333
8478472,Mathieu,Joseph,1997-02-09,RW,L,2019-20,37,4,3,7,0.19,-2,35,11.43,16,25578.0,11:31,4,10,14,28.57,47,10,17,12,5,0,0,0,186.0,0:5,0,1,1,1718.0,0:46,728333
8478474,Lawson,Crouse,1997-06-23,LW,L,2019-20,66,15,10,25,0.38,0,109,13.76,33,53783.0,13:34,24,23,47,51.06,201,29,28,22,6,0,0,0,101.0,0:1,1,0,1,5606.0,1:24,1533333
8478476,Kyle,Capobianco,1997-08-13,D,L,2019-20,9,1,0,1,0.11,-1,10,10.0,2,7972.0,14:45,0,0,0,0.0,14,10,1,4,-3,0,0,0,81.0,0:9,0,0,0,444.0,0:49,745000
8478477,Mitchell,Stephens,1997-02-05,C,R,2019-20,41,4,3,7,0.17,-9,47,8.51,10,26692.0,10:51,200,187,387,51.68,43,10,6,4,2,0,0,0,154.0,0:3,0,0,0,2592.0,1:3,833333
8478483,Mitchell,Marner,1997-05-05,C,R,2019-20,59,16,51,67,1.14,6,154,10.39,16,76301.0,21:33,7,19,26,26.92,24,37,64,71,-7,6,18,24,11406.0,3:13,0,1,1,7784.0,2:11,10893000
8478485,Zach,Senyshyn,1997-03-30,RW,R,2019-20,4,0,2,2,0.5,1,1,0.0,0,2023.0,8:25,1,0,1,100.0,2,1,1,1,0,0,0,0,0.0,0:0,0,0,0,0.0,0:0,863333
8478488,Filip,Chlapik,1997-06-03,C,L,2019-20,31,3,3,6,0.19,-7,27,11.11,10,16312.0,8:46,12,19,31,38.71,71,11,8,6,2,0,0,0,162.0,0:5,0,0,0,34.0,0:1,728333
8478491,Jacob,Larsson,1997-04-29,D,L,2019-20,60,2,9,11,0.18,-9,58,3.45,12,58096.0,16:8,0,0,0,0.0,34,57,6,31,-25,0,0,0,186.0,0:3,0,0,0,3681.0,1:1,894166
8478493,Joel,Eriksson Ek,1997-01-29,C,L,2019-20,62,8,21,29,0.47,7,102,7.84,22,58468.0,15:43,367,428,795,46.16,93,43,19,18,1,1,0,1,276.0,0:4,0,1,1,7411.0,1:59,1487500
8478495,Denis,Gurianov,1997-06-07,RW,L,2019-20,67,20,9,29,0.43,2,138,14.49,13,52392.0,13:1,0,0,0,0.0,72,19,26,28,-2,7,5,12,7611.0,1:53,0,0,0,8.0,0:0,894166
8478498,Jake,DeBrusk,1996-10-17,LW,L,2019-20,68,20,16,36,0.53,0,165,12.12,16,65456.0,16:2,9,18,27,33.33,37,16,26,23,3,7,3,10,10454.0,2:33,0,0,0,27.0,0:0,863333
8478500,Ivan,Provorov,1997-01-13,D,L,2019-20,72,13,24,37,0.51,14,151,8.61,28,107376.0,24:51,0,0,0,0.0,85,114,17,72,-55,7,9,16,13360.0,3:5,0,1,1,11903.0,2:45,6750000
8478502,Dennis,Gilbert,1996-10-30,D,L,2019-20,21,1,2,3,0.14,-8,12,8.33,38,19789.0,15:42,0,0,0,0.0,74,33,2,4,-2,0,0,0,118.0,0:5,0,0,0,1549.0,1:13,925000
8478506,Gabriel,Carlsson,1997-01-02,D,L,2019-20,6,0,0,0,0.0,-1,3,0.0,2,3916.0,10:52,0,0,0,0.0,5,0,0,3,-3,0,0,0,57.0,0:9,0,0,0,165.0,0:27,894166
8478507,John,Marino,1997-05-21,D,R,2019-20,56,6,20,26,0.46,17,61,9.84,20,68015.0,20:14,0,0,0,0.0,72,77,37,42,-5,1,3,4,2525.0,0:45,0,0,0,6814.0,2:1,925000
8478508,Yakov,Trenin,1997-01-13,C,L,2019-20,21,2,4,6,0.29,1,25,8.0,9,12266.0,9:44,3,1,4,75.0,46,9,7,3,4,0,0,0,27.0,0:1,0,0,0,0.0,0:0,730833
8478512,Austin,Czarnik,1992-12-12,C,R,2019-20,8,2,1,3,0.38,1,9,22.22,0,4890.0,10:11,2,4,6,33.33,1,2,6,2,4,1,0,1,585.0,1:13,0,0,0,0.0,0:0,1250000
8478519,Anthony,Cirelli,1997-07-15,C,L,2019-20,71,16,28,44,0.62,26,116,13.79,32,78322.0,18:23,446,502,948,47.05,99,50,55,26,29,1,4,5,4016.0,0:56,1,1,2,11927.0,2:47,728333
8478542,Evan,Rodrigues,1993-07-28,LW,R,2019-20,45,6,4,10,0.22,-8,75,8.0,14,30473.0,11:17,120,137,257,46.69,24,15,14,13,1,1,0,1,1264.0,0:28,0,0,0,2032.0,0:45,2000000
8478550,Artemi,Panarin,1991-10-30,LW,R,2019-20,69,32,63,95,1.38,36,209,15.31,20,85300.0,20:36,1,1,2,50.0,25,18,56,82,-26,7,17,24,15454.0,3:43,0,0,0,83.0,0:1,11642857
8478567,Dean,Kukan,1993-07-08,D,L,2019-20,33,1,4,5,0.15,-9,51,1.96,12,31627.0,15:58,0,0,0,0.0,24,28,7,14,-7,1,0,1,1765.0,0:53,0,0,0,1.0,0:0,725000
8478569,Noel,Acciari,1991-12-01,C,R,2019-20,66,20,7,27,0.41,2,108,18.52,21,63227.0,15:57,381,413,794,47.98,121,103,32,21,11,0,0,0,327.0,0:4,1,0,1,10050.0,2:32,1666667
8478585,Derek,Ryan,1986-12-29,C,R,2019-20,68,10,19,29,0.43,9,102,9.8,10,59354.0,14:32,383,349,732,52.32,12,34,34,26,8,1,3,4,3377.0,0:49,1,1,2,6804.0,1:40,3125000
8478831,Kevin,Stenlund,1996-09-20,C,R,2019-20,32,6,4,10,0.31,2,57,10.53,8,26845.0,13:58,52,77,129,40.31,19,22,6,9,-3,3,2,5,3716.0,1:56,0,0,0,38.0,0:1,864166
8478833,J.C.,Beaudin,1997-03-25,C,R,2019-20,22,0,1,1,0.05,-4,18,0.0,7,11389.0,8:37,62,56,118,52.54,51,11,1,2,-1,0,0,0,65.0,0:2,0,0,0,378.0,0:17,765000
8478838,Lukas,Vejdemo,1996-01-25,C,L,2019-20,7,1,0,1,0.14,0,7,14.29,0,3369.0,8:1,1,4,5,20.0,8,3,2,2,0,0,0,0,13.0,0:1,0,0,0,0.0,0:0,792500
8478839,Aleksi,Saarela,1997-01-07,C,L,2019-20,9,2,2,4,0.44,2,15,13.33,0,6614.0,12:14,6,11,17,35.29,1,3,6,3,3,0,1,1,169.0,0:18,0,0,0,0.0,0:0,753333
8478841,Colton,White,1997-05-03,D,L,2019-20,6,0,0,0,0.0,-2,2,0.0,4,5035.0,13:59,0,0,0,0.0,3,4,2,6,-4,0,0,0,0.0,0:0,0,0,0,308.0,0:51,728333
8478843,Denis,Malgin,1997-01-18,C,R,2019-20,44,4,8,12,0.27,-9,50,8.0,14,31655.0,11:59,65,98,163,39.88,35,16,26,17,9,1,0,1,2364.0,0:53,0,1,1,522.0,0:11,750000
8478846,Christian,Wolanin,1995-03-17,D,L,2019-20,3,0,0,0,0.0,1,4,0.0,0,3183.0,17:41,0,0,0,0.0,0,4,0,2,-2,0,0,0,220.0,1:13,0,0,0,13.0,0:4,900000
8478851,Alexandre,Carrier,1996-10-08,D,R,2019-20,3,0,0,0,0.0,2,4,0.0,2,1940.0,10:46,0,0,0,0.0,3,0,0,0,0,0,0,0,0.0,0:0,0,0,0,0.0,0:0,688333
8478856,Conor,Garland,1996-03-11,RW,R,2019-20,68,22,17,39,0.57,1,158,13.92,20,57744.0,14:9,4,7,11,36.36,26,20,30,27,3,4,6,10,8557.0,2:5,0,0,0,27.0,0:0,775000
8478857,Dmytro,Timashov,1996-10-01,LW,L,2019-20,44,4,5,9,0.2,1,37,10.81,16,22523.0,8:31,0,0,0,0.0,93,11,5,7,-2,0,0,0,152.0,0:3,0,0,0,73.0,0:1,694444
8478859,Niko,Mikkola,1996-04-27,D,L,2019-20,5,0,1,1,0.2,3,10,0.0,0,4309.0,14:21,0,0,0,0.0,5,3,0,1,-1,0,0,0,0.0,0:0,0,0,0,272.0,0:54,842500
8478866,Dominik,Simon,1994-08-08,C,L,2019-20,64,7,15,22,0.34,-9,102,6.86,12,55324.0,14:24,15,27,42,35.71,57,20,41,31,10,0,1,1,1845.0,0:28,0,0,0,883.0,0:13,750000
8478868,Christian,Jaros,1996-04-02,D,R,2019-20,13,0,3,3,0.23,-2,5,0.0,6,8202.0,10:30,0,0,0,0.0,14,12,1,5,-4,0,0,0,0.0,0:0,0,1,1,642.0,0:49,755000
8478870,Rudolfs,Balcers,1997-04-08,LW,L,2019-20,15,1,2,3,0.2,-2,23,4.35,0,10925.0,12:8,0,2,2,0.0,19,7,7,5,2,0,0,0,1520.0,1:41,0,0,0,0.0,0:0,759167
8478873,Troy,Terry,1997-09-10,RW,R,2019-20,47,4,11,15,0.32,-5,73,5.48,6,40942.0,14:31,3,5,8,37.5,3,9,31,19,12,0,2,2,5048.0,1:47,0,0,0,23.0,0:0,925000
8478874,Adam,Gaudette,1996-10-03,C,R,2019-20,59,12,21,33,0.56,-7,75,16.0,37,43838.0,12:23,187,267,454,41.19,29,20,23,15,8,4,8,12,5345.0,1:30,0,0,0,13.0,0:0,916667
8478881,Brett,Seney,1996-02-28,LW,L,2019-20,2,0,0,0,0.0,-1,1,0.0,0,1192.0,9:56,0,2,2,0.0,2,0,1,3,-2,0,0,0,0.0,0:0,0,0,0,0.0,0:0,757500
8478882,Vladislav,Gavrikov,1995-11-21,D,L,2019-20,69,5,13,18,0.26,1,81,6.17,18,78574.0,18:58,0,0,0,0.0,79,92,16,33,-17,0,0,0,243.0,0:3,0,0,0,6133.0,1:28,925000
8478891,Mason,Appleton,1996-01-15,C,R,2019-20,46,5,3,8,0.17,-9,55,9.09,20,30808.0,11:9,5,8,13,38.46,20,12,11,10,1,0,0,0,311.0,0:6,1,0,1,2575.0,0:55,741667
8478906,Markus,Nutivaara,1994-06-06,D,L,2019-20,37,3,6,9,0.24,2,47,6.38,4,35345.0,15:55,0,0,0,0.0,35,33,6,13,-7,0,1,1,686.0,0:18,0,0,0,73.0,0:1,2700000
8478911,Matt,Roy,1995-03-01,D,R,2019-20,70,4,14,18,0.26,16,112,3.57,10,76114.0,18:7,0,0,0,0.0,132,100,7,43,-36,0,1,1,171.0,0:2,0,0,0,5932.0,1:24,700000
8478915,Sami,Niku,1996-10-10,D,L,2019-20,17,0,5,5,0.29,-2,27,0.0,12,16482.0,16:9,0,0,0,0.0,16,19,2,11,-9,0,0,0,532.0,0:31,0,0,0,11.0,0:0,775000
8478949,Kole,Sherwood,1997-01-22,RW,R,2019-20,3,0,0,0,0.0,0,6,0.0,2,1195.0,6:38,0,1,1,0.0,10,1,2,0,2,0,0,0,0.0,0:0,0,0,0,0.0,0:0,694444
8478996,Adam,Brooks,1996-05-06,C,L,2019-20,7,0,3,3,0.43,1,2,0.0,0,3298.0,7:51,5,5,10,50.0,0,1,2,1,1,0,0,0,42.0,0:6,0,0,0,118.0,0:16,759167
8479026,Philippe,Myers,1997-01-25,D,R,2019-20,53,5,12,17,0.32,23,85,5.88,30,54579.0,17:9,0,0,0,0.0,87,46,22,37,-15,0,0,0,449.0,0:8,0,0,0,1192.0,0:22,678889
8479291,Kevin,Rooney,1993-05-21,C,L,2019-20,49,4,5,9,0.18,8,59,6.78,20,34488.0,11:43,175,197,372,47.04,64,32,17,13,4,0,0,0,74.0,0:1,2,1,3,6171.0,2:5,700000
8479293,Brandon,Tanev,1991-12-31,LW,L,2019-20,68,11,14,25,0.37,-1,95,11.58,16,60221.0,14:45,6,9,15,40.0,244,65,33,37,-4,0,1,1,379.0,0:5,2,1,3,8950.0,2:11,3500000
8479314,Matthew,Tkachuk,1997-12-11,LW,L,2019-20,69,23,38,61,0.88,-5,188,12.23,74,75799.0,18:18,0,4,4,0.0,122,22,40,86,-46,5,14,19,11736.0,2:50,0,0,0,15.0,0:0,7000000
8479315,Joey,Anderson,1998-06-19,RW,R,2019-20,18,4,2,6,0.33,1,21,19.05,2,14274.0,13:13,3,3,6,50.0,16,6,4,7,-3,0,0,0,73.0,0:4,0,0,0,2123.0,1:57,925000
8479316,Luke,Kunin,1997-12-04,C,R,2019-20,63,15,16,31,0.49,-10,128,11.72,55,58460.0,15:27,210,262,472,44.49,64,54,9,15,-6,0,2,2,3011.0,0:47,1,0,1,5236.0,1:23,925000
8479318,Auston,Matthews,1997-09-17,C,L,2019-20,70,47,33,80,1.14,19,290,16.21,8,88072.0,20:58,506,414,920,55.0,40,60,78,48,30,12,13,25,13424.0,3:11,0,0,0,149.0,0:2,11634000
8479320,Maxime,Lajoie,1997-11-05,D,L,2019-20,6,0,0,0,0.0,0,3,0.0,0,2814.0,7:49,0,0,0,0.0,2,3,0,0,0,0,0,0,39.0,0:6,0,0,0,0.0,0:0,710000
8479323,Adam,Fox,1998-02-17,D,R,2019-20,70,8,34,42,0.6,22,125,6.4,32,79398.0,18:54,0,0,0,0.0,35,92,57,61,-4,1,12,13,8326.0,1:58,0,0,0,544.0,0:7,925000
8479324,Ryan,Lindgren,1998-02-11,D,L,2019-20,60,1,13,14,0.23,16,47,2.13,47,59640.0,16:34,0,0,0,0.0,94,70,28,25,3,0,0,0,103.0,0:1,0,0,0,7772.0,2:9,925000
8479325,Charlie,McAvoy,1997-12-21,D,R,2019-20,70,6,28,34,0.49,23,110,5.45,45,96979.0,23:5,0,0,0,0.0,138,134,39,74,-35,1,1,2,5647.0,1:20,0,1,1,7659.0,1:49,4900000
8479328,Julien,Gauthier,1997-10-15,RW,R,2019-20,17,0,3,3,0.18,1,10,0.0,8,8446.0,8:16,1,2,3,33.33,15,7,3,7,-4,0,0,0,74.0,0:4,0,0,0,3.0,0:0,863333
8479333,Libor,Hajek,1998-02-04,D,L,2019-20,28,0,5,5,0.18,-4,23,0.0,12,26854.0,15:59,0,0,0,0.0,24,44,8,17,-9,0,0,0,161.0,0:5,0,0,0,1522.0,0:54,833333
8479335,Rasmus,Asplund,1997-12-03,C,L,2019-20,29,1,2,3,0.1,-4,36,2.78,6,18851.0,10:50,49,65,114,42.98,20,7,5,7,-2,0,0,0,56.0,0:1,0,1,1,3087.0,1:46,845000
8479336,Carl,Grundstrom,1997-12-01,RW,L,2019-20,13,0,4,4,0.31,2,16,0.0,8,9956.0,12:45,0,0,0,0.0,29,4,0,4,-4,0,0,0,341.0,0:26,0,0,0,0.0,0:0,925000
8479337,Alex,DeBrincat,1997-12-18,RW,R,2019-20,70,18,27,45,0.64,-10,207,8.7,15,73474.0,17:29,7,13,20,35.0,58,19,41,37,4,10,6,16,14599.0,3:28,0,0,0,54.0,0:0,778333
8479339,Patrik,Laine,1998-04-19,RW,R,2019-20,68,28,35,63,0.93,8,226,12.39,22,79193.0,19:24,10,17,27,37.04,97,35,41,57,-16,8,8,16,13164.0,3:13,0,0,0,10.0,0:0,6750000
8479343,Clayton,Keller,1998-07-29,C,L,2019-20,70,17,27,44,0.63,-6,184,9.24,28,68440.0,16:17,8,13,21,38.1,20,13,34,32,2,2,13,15,11328.0,2:41,0,0,0,83.0,0:1,885833
8479345,Jakob,Chychrun,1998-03-31,D,L,2019-20,63,12,14,26,0.41,4,149,8.05,38,84803.0,22:26,0,0,0,0.0,75,95,27,52,-25,5,3,8,8302.0,2:11,0,0,0,5687.0,1:30,4600000
8479346,Dillon,Dube,1998-07-20,C,L,2019-20,45,6,10,16,0.36,0,60,10.0,6,34273.0,12:41,0,2,2,0.0,59,13,17,16,1,1,1,2,1464.0,0:32,0,0,0,428.0,0:9,778333
8479347,Tyler,Benson,1998-03-15,LW,L,2019-20,7,0,1,1,0.14,-1,5,0.0,0,4359.0,10:22,1,0,1,100.0,3,1,2,3,-1,0,0,0,171.0,0:24,0,0,0,0.0,0:0,808333
8479348,Kale,Clague,1998-06-05,D,L,2019-20,4,0,0,0,0.0,-3,2,0.0,2,3494.0,14:33,0,0,0,0.0,1,4,0,1,-1,0,0,0,53.0,0:13,0,0,0,0.0,0:0,761666
8479351,Sam,Steel,1998-02-03,C,L,2019-20,65,6,16,22,0.34,-13,85,7.06,20,60624.0,15:32,369,365,734,50.27,24,25,25,37,-12,1,7,8,6776.0,1:44,0,0,0,1275.0,0:19,863333
8479353,Brett,Howden,1998-03-29,C,L,2019-20,70,9,10,19,0.27,-11,64,14.06,28,55199.0,13:8,251,270,521,48.18,69,67,25,25,0,1,1,2,1217.0,0:17,0,2,2,8439.0,2:0,863333
8479356,Kieffer,Bellows,1998-06-10,LW,L,2019-20,8,2,1,3,0.38,3,11,18.18,2,5112.0,10:39,0,0,0,0.0,12,4,2,5,-3,0,0,0,5.0,0:0,0,0,0,0.0,0:0,894166
8479358,Carsen,Twarynski,1997-11-24,LW,L,2019-20,15,1,0,1,0.07,-2,14,7.14,4,9609.0,10:40,0,2,2,0.0,40,8,6,0,6,0,0,0,31.0,0:2,0,0,0,230.0,0:15,775833
8479359,Beck,Malenstyn,1998-02-04,LW,L,2019-20,3,0,0,0,0.0,-1,4,0.0,0,1669.0,9:16,0,0,0,0.0,5,1,1,0,1,0,0,0,0.0,0:0,0,0,0,286.0,1:35,736666
8479364,Tim,Gettinger,1998-04-14,LW,L,2019-20,2,0,1,1,0.5,1,3,0.0,0,1006.0,8:23,0,2,2,0.0,5,1,0,0,0,0,0,0,17.0,0:8,0,0,0,54.0,0:27,730000
8479365,Trent,Frederic,1998-02-11,C,L,2019-20,2,0,0,0,0.0,-1,1,0.0,0,771.0,6:25,0,0,0,0.0,8,0,0,0,0,0,0,0,0.0,0:0,0,0,0,0.0,0:0,925000
8479366,Logan,Brown,1998-03-05,C,L,2019-20,23,1,7,8,0.35,0,23,4.35,4,16225.0,11:45,55,79,134,41.04,13,11,10,16,-6,1,2,3,2660.0,1:55,0,0,0,69.0,0:3,863333
8479368,Max,Jones,1998-02-17,LW,L,2019-20,59,8,4,12,0.2,-6,102,7.84,36,50505.0,14:16,11,16,27,40.74,82,18,19,32,-13,0,1,1,1739.0,0:29,1,0,1,2535.0,0:42,863333
8479369,Andrew,Peeke,1998-03-17,D,R,2019-20,22,1,2,3,0.14,1,23,4.35,4,18290.0,13:51,0,0,0,0.0,25,21,3,8,-5,0,0,0,0.0,0:0,0,0,0,321.0,0:14,916667
8479370,Tyson,Jost,1998-03-14,C,L,2019-20,68,8,15,23,0.34,11,116,6.9,22,51909.0,12:43,85,171,256,33.2,58,18,18,12,6,1,4,5,6809.0,1:40,0,0,0,1131.0,0:16,885833
8479371,Dante,Fabbro,1998-06-20,D,R,2019-20,64,5,6,11,0.17,-7,92,5.43,38,73057.0,19:1,0,0,0,0.0,54,85,23,39,-16,1,0,1,1373.0,0:21,0,0,0,1909.0,0:29,925000
8479372,Josh,Mahura,1998-05-05,D,L,2019-20,11,1,3,4,0.36,-3,11,9.09,2,10710.0,16:13,0,0,0,0.0,2,11,2,5,-3,0,0,0,1045.0,1:35,0,0,0,51.0,0:4,745000
8479376,Victor,Mete,1998-06-07,D,L,2019-20,51,4,7,11,0.22,5,57,7.02,20,48936.0,15:59,0,0,0,0.0,20,60,8,35,-27,0,1,1,200.0,0:3,0,0,0,1900.0,0:37,748333
8479379,Givani,Smith,1998-02-27,RW,L,2019-20,21,2,1,3,0.14,-2,22,9.09,9,12200.0,9:40,0,0,0,0.0,42,3,2,6,-4,0,0,0,1682.0,1:20,0,0,0,0.0,0:0,714166
8479381,Nick,Caamano,1998-09-07,RW,L,2019-20,12,1,1,2,0.17,2,13,7.69,4,7175.0,9:57,1,1,2,50.0,17,3,1,2,-1,0,0,0,9.0,0:0,0,0,0,113.0,0:9,738333
8479382,Connor,Bunnaman,1998-04-16,C,L,2019-20,23,1,1,2,0.09,7,20,5.0,4,13153.0,9:31,37,61,98,37.76,29,2,1,5,-4,0,0,0,55.0,0:2,0,0,0,38.0,0:1,736666
8479385,Jordan,Kyrou,1998-05-05,C,R,2019-20,29,4,5,9,0.31,1,40,10.0,8,18849.0,10:49,2,3,5,40.0,8,8,13,7,6,0,1,1,634.0,0:21,0,0,0,0.0,0:0,758333
8479388,Riley,Stillman,1998-03-09,D,L,2019-20,34,0,5,5,0.15,-3,39,0.0,14,39002.0,19:7,0,0,0,0.0,59,57,13,28,-15,0,0,0,90.0,0:2,0,0,0,4842.0,2:22,773333
8479393,Noah,Gregor,1998-07-28,C,L,2019-20,28,3,2,5,0.18,-5,33,9.09,8,16899.0,10:3,6,13,19,31.58,50,6,6,7,-1,1,1,2,588.0,0:21,0,0,0,0.0,0:0,768333
8479395,Dennis,Cholowski,1998-02-15,D,L,2019-20,36,2,6,8,0.22,-26,51,3.92,6,41518.0,19:13,0,0,0,0.0,15,35,4,21,-17,1,4,5,5751.0,2:39,0,0,0,485.0,0:13,894166
8479398,Samuel,Girard,1998-05-12,D,L,2019-20,73,4,32,36,0.49,1,100,4.0,19,93103.0,21:15,0,0,0,0.0,48,95,38,40,-2,1,13,14,10605.0,2:25,0,0,0,411.0,0:5,728333
8479400,Pierre-Luc,Dubois,1998-06-24,C,L,2019-20,70,18,31,49,0.7,-2,158,11.39,49,75314.0,17:55,359,446,805,44.6,85,50,27,46,-19,1,9,10,11221.0,2:40,0,0,0,428.0,0:6,894166
8479404,Henrik,Borgstrom,1997-08-06,C,L,2019-20,4,0,0,0,0.0,-2,3,0.0,2,2972.0,12:23,13,14,27,48.15,1,0,3,1,2,0,0,0,363.0,1:30,0,0,0,45.0,0:11,925000
8479407,Jesper,Bratt,1998-07-30,LW,L,2019-20,60,16,16,32,0.53,-6,101,15.84,6,50338.0,13:58,3,10,13,23.08,29,22,18,24,-6,1,5,6,7247.0,2:0,0,0,0,114.0,0:1,749167
8479410,Mikhail,Sergachev,1998-06-25,D,L,2019-20,73,10,24,34,0.47,13,124,8.06,60,89447.0,20:25,0,0,0,0.0,112,101,19,43,-24,5,8,13,8088.0,1:50,1,0,1,5105.0,1:9,894166
8479411,Vitaly,Abramov,1998-05-08,RW,L,2019-20,2,1,0,1,0.5,0,3,33.33,2,694.0,5:47,0,0,0,0.0,0,0,0,1,-1,0,0,0,0.0,0:0,0,0,0,0.0,0:0,730833
8479415,Michael,McLeod,1998-02-03,C,R,2019-20,12,0,2,2,0.17,4,11,0.0,4,7365.0,10:13,40,40,80,50.0,19,6,4,0,4,0,0,0,12.0,0:1,0,0,0,102.0,0:8,863333
8479423,Alexander,Nylander,1998-03-02,RW,R,2019-20,65,10,16,26,0.4,-2,94,10.64,10,47327.0,12:8,5,14,19,26.32,29,14,25,23,2,0,2,2,4544.0,1:9,0,0,0,0.0,0:0,863333
8479424,German,Rubtsov,1998-06-27,C,L,2019-20,4,0,0,0,0.0,-1,1,0.0,0,1633.0,6:48,6,8,14,42.86,4,4,1,1,0,0,0,0,0.0,0:0,0,0,0,0.0,0:0,894166
8479425,Filip,Hronek,1997-11-02,D,R,2019-20,65,9,22,31,0.48,-38,125,7.2,46,93194.0,23:53,0,0,0,0.0,105,74,18,76,-58,1,9,10,11227.0,2:52,0,0,0,11300.0,2:53,714166
8479442,Troy,Stecher,1994-04-07,D,R,2019-20,69,5,12,17,0.25,10,86,5.81,32,63539.0,15:20,0,0,0,0.0,69,70,16,25,-9,0,0,0,324.0,0:4,0,0,0,2268.0,0:32,2325000
8479458,Nikita,Zaitsev,1991-10-29,D,R,2019-20,58,1,11,12,0.21,-8,64,1.56,22,77092.0,22:9,0,0,0,0.0,108,121,20,44,-24,0,0,0,476.0,0:8,0,0,0,10429.0,2:59,4500000
8479465,Drake,Caggiula,1994-06-20,LW,L,2019-20,40,9,6,15,0.38,-3,56,16.07,32,28357.0,11:48,4,10,14,28.57,81,16,19,5,14,1,0,1,388.0,0:9,0,1,1,1445.0,0:36,1500000
8479466,Patrick,Russell,1993-01-04,RW,R,2019-20,45,0,5,5,0.11,-11,58,0.0,12,30681.0,11:21,2,2,4,50.0,64,25,9,13,-4,0,0,0,165.0,0:3,0,0,0,1918.0,0:42,700000
8479482,Michal,Kempny,1990-09-08,D,L,2019-20,61,3,16,19,0.31,20,79,3.8,26,68341.0,18:40,0,0,0,0.0,52,74,13,38,-25,0,0,0,339.0,0:5,0,0,0,5697.0,1:33,2500000
8479510,Egor,Korshkov,1996-07-10,RW,L,2019-20,1,1,0,1,1.0,1,1,100.0,0,608.0,10:8,0,0,0,0.0,1,0,1,0,1,0,0,0,0.0,0:0,0,0,0,0.0,0:0,925000
8479523,Lucas,Carlsson,1997-07-05,D,L,2019-20,6,0,1,1,0.17,3,3,0.0,0,5090.0,14:8,0,0,0,0.0,11,6,1,0,1,0,0,0,95.0,0:15,0,0,0,104.0,0:17,792500
8479526,Otto,Koivula,1998-09-01,LW,L,2019-20,12,0,0,0,0.0,0,4,0.0,2,5696.0,7:54,24,41,65,36.92,12,4,2,3,-1,0,0,0,0.0,0:0,0,0,0,72.0,0:6,786666
8479542,Brandon,Hagel,1998-08-27,LW,L,2019-20,1,0,0,0,0.0,0,4,0.0,0,708.0,11:48,0,0,0,0.0,1,1,1,0,1,0,0,0,0.0,0:0,0,0,0,0.0,0:0,880833
8479557,Calvin,Thurkauf,1997-06-27,C,L,2019-20,3,0,0,0,0.0,0,1,0.0,0,1486.0,8:15,2,0,2,100.0,5,0,0,0,0,0,0,0,0.0,0:0,0,0,0,0.0,0:0,714444
8479571,Joachim,Blichfeld,1998-07-17,RW,R,2019-20,3,0,0,0,0.0,-2,3,0.0,2,2299.0,12:46,0,0,0,0.0,3,4,2,0,2,0,0,0,43.0,0:14,0,0,0,0.0,0:0,736666
8479580,Dylan,Gambrell,1996-08-26,C,R,2019-20,50,5,6,11,0.22,-8,43,11.63,17,35853.0,11:57,170,200,370,45.95,40,29,11,17,-6,0,1,1,2008.0,0:40,0,0,0,2857.0,0:57,700000
8479587,Rhett,Gardner,1996-02-28,C,L,2019-20,8,0,0,0,0.0,0,8,0.0,2,4865.0,10:8,25,28,53,47.17,8,2,1,3,-2,0,0,0,14.0,0:1,0,0,0,671.0,1:23,925000
8479644,Matt,Luff,1997-05-05,RW,R,2019-20,18,1,4,5,0.28,-5,25,4.0,2,11202.0,10:22,0,3,3,0.0,16,5,4,4,0,0,0,0,132.0,0:7,0,0,0,0.0,0:0,677777
8479671,Mathieu,Olivier,1997-02-11,RW,R,2019-20,8,0,1,1,0.12,1,6,0.0,4,3622.0,7:32,0,0,0,0.0,17,1,0,3,-3,0,0,0,0.0,0:0,0,0,0,0.0,0:0,730000
8479675,Trevor,Moore,1995-03-31,C,L,2019-20,42,6,4,10,0.24,-4,60,10.0,6,32503.0,12:53,4,10,14,28.57,60,17,21,20,1,0,0,0,1765.0,0:42,0,1,1,3269.0,1:17,775000
8479734,Brennan,Menell,1997-05-24,D,R,2019-20,5,0,0,0,0.0,1,4,0.0,2,4197.0,13:59,0,0,0,0.0,2,4,2,0,2,0,0,0,330.0,1:6,0,0,0,1.0,0:0,716666
8479748,Gage,Quinney,1995-07-29,C,L,2019-20,3,0,1,1,0.33,-1,2,0.0,0,1748.0,9:42,8,9,17,47.06,2,0,0,0,0,0,0,0,0.0,0:0,0,0,0,0.0,0:0,715000
8479772,Zack,MacEwen,1996-07-08,C,R,2019-20,17,5,1,6,0.35,6,17,29.41,20,9809.0,9:37,1,1,2,50.0,41,5,4,8,-4,0,0,0,66.0,0:3,0,0,0,0.0,0:0,847500
8479933,Gerald,Mayhew,1992-12-31,C,L,2019-20,13,2,0,2,0.15,4,16,12.5,2,9008.0,11:32,3,3,6,50.0,11,6,4,2,2,0,0,0,1002.0,1:17,0,0,0,10.0,0:0,700000
8479944,Zach,Aston-Reese,1994-08-10,C,L,2019-20,57,6,7,13,0.23,6,98,6.12,28,49343.0,14:25,7,16,23,30.43,136,30,20,21,-1,0,0,0,1799.0,0:31,1,0,1,5443.0,1:35,1000000
8479977,Kailer,Yamamoto,1998-09-29,RW,R,2019-20,27,11,15,26,0.96,17,44,25.0,12,28164.0,17:23,1,0,1,100.0,45,13,19,10,9,2,0,2,1426.0,0:52,0,0,0,93.0,0:3,894166
8479980,Nicolas,Hague,1998-12-05,D,L,2019-20,38,1,10,11,0.29,1,54,1.85,32,36670.0,16:5,0,0,0,0.0,69,26,13,10,3,1,3,4,2084.0,0:54,0,0,0,57.0,0:1,791667
8479982,Conor,Timmins,1998-09-18,D,R,2019-20,2,0,0,0,0.0,2,1,0.0,0,1249.0,10:24,0,0,0,0.0,0,0,1,0,1,0,0,0,4.0,0:2,0,0,0,73.0,0:36,925000
8479983,Mario,Ferraro,1998-09-17,D,L,2019-20,61,2,9,11,0.18,-15,63,3.17,30,58148.0,15:53,0,0,0,0.0,120,58,15,20,-5,0,0,0,1129.0,0:18,0,1,1,2770.0,0:45,925000
8479985,Cale,Fleury,1998-11-19,D,R,2019-20,41,1,0,1,0.02,-4,45,2.22,6,35305.0,14:21,0,0,0,0.0,102,45,5,31,-26,0,0,0,29.0,0:0,0,0,0,1900.0,0:46,771666
8479987,Morgan,Geekie,1998-07-20,C,R,2019-20,2,3,1,4,2.0,3,4,75.0,2,1414.0,11:47,12,10,22,54.55,1,4,1,0,1,0,0,0,212.0,1:46,0,0,0,82.0,0:41,763333
8479994,Jaret,Anderson-Dolan,1999-09-12,C,L,2019-20,4,0,0,0,0.0,-1,2,0.0,0,2462.0,10:15,5,8,13,38.46,3,0,0,2,-2,0,0,0,49.0,0:12,0,0,0,0.0,0:0,747500
8479996,Cody,Glass,1999-04-01,C,R,2019-20,39,5,7,12,0.31,-6,51,9.8,6,31249.0,13:21,60,83,143,41.96,15,6,18,17,1,1,5,6,5210.0,2:13,0,0,0,61.0,0:1,863333
8479998,Mikey,Anderson,1999-05-25,D,L,2019-20,6,1,0,1,0.17,4,9,11.11,0,6532.0,18:8,0,0,0,0.0,10,10,0,2,-2,0,0,0,0.0,0:0,0,0,0,520.0,1:26,925000
8479999,Casey,Mittelstadt,1998-11-22,C,L,2019-20,31,4,5,9,0.29,-5,34,11.76,2,23734.0,12:45,86,99,185,46.49,11,8,6,9,-3,1,1,2,3310.0,1:46,0,0,0,10.0,0:0,925000
8480001,Urho,Vaakanainen,1999-01-01,D,L,2019-20,5,0,0,0,0.0,2,2,0.0,0,5056.0,16:51,0,0,0,0.0,8,3,1,3,-2,0,0,0,106.0,0:21,0,0,0,361.0,1:12,894167
8480002,Nico,Hischier,1999-01-04,C,L,2019-20,58,14,22,36,0.62,-16,123,11.38,12,62852.0,18:3,507,473,980,51.73,48,37,42,28,14,2,8,10,9356.0,2:41,1,1,2,3201.0,0:55,925000
8480003,Jesper,Boqvist,1998-10-30,C,L,2019-20,35,4,0,4,0.11,-11,41,9.76,8,22994.0,10:56,5,11,16,31.25,37,16,13,11,2,1,0,1,1682.0,0:48,0,0,0,22.0,0:0,925000
8480011,Klim,Kostin,1999-05-05,C,L,2019-20,4,1,0,1,0.25,1,5,20.0,0,2049.0,8:32,0,0,0,0.0,6,0,0,1,-1,0,0,0,0.0,0:0,0,0,0,0.0,0:0,863333
8480012,Elias,Pettersson,1998-11-12,C,L,2019-20,68,27,39,66,0.97,17,162,16.67,18,75607.0,18:31,59,82,141,41.84,63,42,36,33,3,8,15,23,15821.0,3:52,0,0,0,126.0,0:1,925000
8480014,Gabriel,Vilardi,1999-08-16,C,R,2019-20,10,3,4,7,0.7,0,19,15.79,4,7710.0,12:51,49,43,92,53.26,1,4,1,0,1,1,1,2,861.0,1:26,0,0,0,5.0,0:0,894167
8480018,Nick,Suzuki,1999-08-10,C,R,2019-20,71,13,28,41,0.58,-15,138,9.42,6,68116.0,15:59,305,354,659,46.28,64,32,31,37,-6,6,8,14,9251.0,2:10,0,0,0,1263.0,0:17,863333
8480021,Jack,Studnicka,1999-02-18,C,R,2019-20,3,0,1,1,0.33,2,6,0.0,2,2151.0,11:57,10,6,16,62.5,2,0,0,3,-3,0,0,0,281.0,1:33,0,0,0,0.0,0:0,769167
8480023,Robert,Thomas,1999-07-02,C,R,2019-20,68,11,32,43,0.63,9,90,12.22,20,59415.0,14:33,139,185,324,42.9,13,13,46,30,16,1,6,7,6047.0,1:28,0,0,0,52.0,0:0,894166
8480027,Jason,Robertson,1999-07-22,LW,L,2019-20,3,0,1,1,0.33,0,4,0.0,0,2218.0,12:19,0,0,0,0.0,1,0,1,0,1,0,1,1,219.0,1:13,0,0,0,0.0,0:0,795000
8480028,Morgan,Frost,1999-05-14,C,L,2019-20,20,2,5,7,0.35,-3,31,6.45,4,16420.0,13:41,44,49,93,47.31,4,4,10,6,4,0,0,0,2717.0,2:15,1,0,1,19.0,0:0,863333
8480031,Max,Comtois,1999-01-08,LW,L,2019-20,29,5,6,11,0.38,-4,32,15.62,24,24314.0,13:58,3,13,16,18.75,61,8,5,19,-14,2,1,3,3879.0,2:13,0,0,0,159.0,0:5,820000
8480035,Henri,Jokiharju,1999-06-17,D,R,2019-20,69,4,11,15,0.22,-6,78,5.13,32,71278.0,17:13,0,0,0,0.0,74,63,7,30,-23,1,1,2,777.0,0:11,0,0,0,4514.0,1:5,925000
8480036,Miro,Heiskanen,1999-07-18,D,L,2019-20,71,8,31,39,0.55,14,171,4.68,14,101171.0,23:44,0,0,0,0.0,42,85,46,81,-35,0,8,8,9977.0,2:20,0,0,0,8711.0,2:2,894166
8480039,Martin,Necas,1999-01-15,C,R,2019-20,64,16,20,36,0.56,-6,88,18.18,20,54401.0,14:10,13,35,48,27.08,65,19,23,36,-13,5,4,9,6925.0,1:48,0,0,0,106.0,0:1,863333
8480043,Timothy,Liljegren,1999-04-30,D,R,2019-20,11,0,1,1,0.09,-5,2,0.0,2,6794.0,10:17,0,0,0,0.0,8,10,0,6,-6,0,0,0,0.0,0:0,0,0,0,348.0,0:31,863333
8480064,Josh,Norris,1999-05-05,C,L,2019-20,3,0,0,0,0.0,2,9,0.0,0,3225.0,17:55,30,19,49,61.22,3,2,1,0,1,0,0,0,504.0,2:48,0,0,0,0.0,0:0,925000
8480068,Ryan,Poehling,1999-01-03,C,L,2019-20,27,1,1,2,0.07,-4,26,3.85,4,16753.0,10:20,3,12,15,20.0,38,10,7,8,-1,0,0,0,400.0,0:14,0,0,0,970.0,0:35,925000
8480069,Cale,Makar,1998-10-30,D,R,2019-20,60,13,38,51,0.85,15,129,10.08,12,75907.0,21:5,0,0,0,0.0,50,48,34,41,-7,5,15,20,13931.0,3:52,0,0,0,351.0,0:5,880833
8480072,Lias,Andersson,1998-10-13,C,L,2019-20,17,0,1,1,0.06,-8,13,0.0,4,9735.0,9:32,41,47,88,46.59,20,8,8,4,4,0,0,0,55.0,0:3,0,0,0,2040.0,2:0,894166
8480073,Erik,Brannstrom,1999-09-02,D,L,2019-20,31,0,4,4,0.13,-9,38,0.0,16,27607.0,14:50,0,0,0,0.0,15,36,5,20,-15,0,1,1,2761.0,1:29,0,0,0,331.0,0:10,863333
8480074,Alexandre,Texier,1999-09-13,C,L,2019-20,36,6,7,13,0.36,3,49,12.24,10,27536.0,12:44,23,40,63,36.51,20,7,16,12,4,0,1,1,1203.0,0:33,0,0,0,79.0,0:2,897500
8480078,Filip,Chytil,1999-09-05,C,L,2019-20,60,14,9,23,0.38,-7,114,12.28,10,53427.0,14:50,198,317,515,38.45,13,31,33,33,0,1,2,3,4610.0,1:16,0,0,0,99.0,0:1,894166
8480113,Alex,Iafallo,1993-12-21,C,L,2019-20,70,17,26,43,0.61,1,142,11.97,14,79496.0,18:55,11,12,23,47.83,49,47,18,11,7,6,3,9,10405.0,2:28,0,0,0,6083.0,1:26,2425000
8480144,David,Kampf,1995-01-12,C,L,2019-20,70,8,8,16,0.23,-11,90,8.89,8,57401.0,13:40,313,285,598,52.34,52,26,37,17,20,0,0,0,173.0,0:2,1,0,1,9099.0,2:9,1000000
8480145,Neal,Pionk,1995-07-29,D,R,2019-20,71,6,39,45,0.63,10,177,3.39,32,99582.0,23:22,0,0,0,0.0,165,78,31,62,-31,3,22,25,12463.0,2:55,0,0,0,3827.0,0:53,3000000
8480147,Oscar,Fantenberg,1991-10-07,D,L,2019-20,36,1,5,6,0.17,-10,45,2.22,6,34376.0,15:54,0,0,0,0.0,67,62,7,11,-4,0,1,1,71.0,0:1,0,0,0,2723.0,1:15,850000
8480157,Calle,Rosen,1994-02-02,D,L,2019-20,12,0,3,3,0.25,0,14,0.0,4,9775.0,13:34,0,0,0,0.0,3,7,2,8,-6,0,0,0,429.0,0:35,0,0,0,21.0,0:1,750000
8480160,Radim,Simek,1992-09-20,D,L,2019-20,48,2,7,9,0.19,-13,40,5.0,14,49478.0,17:10,0,0,0,0.0,91,60,20,36,-16,0,0,0,114.0,0:2,0,0,0,4863.0,1:41,675000
8480172,Jan,Rutta,1990-07-29,D,R,2019-20,34,1,6,7,0.21,6,44,2.27,14,31791.0,15:35,0,0,0,0.0,19,24,2,9,-7,0,0,0,82.0,0:2,0,0,0,3435.0,1:41,1300000
8480184,Gustav,Lindstrom,1998-10-20,D,R,2019-20,16,0,1,1,0.06,-6,9,0.0,14,15877.0,16:32,0,0,0,0.0,19,15,3,7,-4,0,1,1,694.0,0:43,0,0,0,1297.0,1:21,775833
8480185,Eetu,Luostarinen,1998-09-02,C,L,2019-20,8,0,1,1,0.12,-2,9,0.0,0,4791.0,9:58,33,30,63,52.38,9,2,2,1,1,0,0,0,8.0,0:1,0,0,0,0.0,0:0,897500
8480186,Alexander,Volkov,1997-08-02,RW,L,2019-20,9,0,1,1,0.11,-6,7,0.0,6,5541.0,10:15,1,3,4,25.0,10,2,4,2,2,0,0,0,0.0,0:0,0,0,0,0.0,0:0,864167
8480205,Emil,Bemstrom,1999-06-01,C,R,2019-20,56,10,10,20,0.36,-10,97,10.31,8,41223.0,12:16,4,9,13,30.77,52,17,10,16,-6,5,3,8,4533.0,1:20,0,0,0,5.0,0:0,925000
8480208,Drake,Batherson,1998-04-27,C,R,2019-20,23,3,7,10,0.43,-12,32,9.38,13,21477.0,15:33,4,3,7,57.14,51,11,5,5,0,1,5,6,3071.0,2:13,0,0,0,18.0,0:0,736666
8480247,Jonathan,Davidsson,1997-03-12,RW,R,2019-20,6,0,1,1,0.17,0,3,0.0,0,1988.0,5:31,0,0,0,0.0,5,1,0,0,0,0,0,0,0.0,0:0,0,0,0,0.0,0:0,768333
8480314,Max,Veronneau,1995-12-12,RW,R,2019-20,4,0,0,0,0.0,-2,3,0.0,0,2020.0,8:25,0,0,0,0.0,2,2,0,1,-1,0,0,0,49.0,0:12,0,0,0,0.0,0:0,925000
8480326,Sheldon,Dries,1994-04-23,C,L,2019-20,5,0,0,0,0.0,-2,2,0.0,0,2059.0,6:51,4,2,6,66.67,16,2,0,1,-1,0,0,0,0.0,0:0,0,0,0,0.0,0:0,735000
8480336,Sean,Walker,1994-11-13,D,R,2019-20,70,5,19,24,0.34,-12,127,3.94,26,79078.0,18:49,0,0,0,0.0,81,84,25,65,-40,0,5,5,3438.0,0:49,0,0,0,5122.0,1:13,745000
8480341,Adam,Johnson,1994-06-22,C,L,2019-20,7,1,1,2,0.29,-1,5,20.0,2,2812.0,6:41,0,0,0,0.0,4,3,1,1,0,0,0,0,0.0,0:0,0,0,0,13.0,0:1,700000
8480384,Alexander,True,1997-07-17,C,L,2019-20,12,0,4,4,0.33,1,12,0.0,2,7203.0,10:0,32,37,69,46.38,23,2,2,5,-3,0,0,0,185.0,0:15,0,0,0,67.0,0:5,763333
8480727,Zach,Whitecloud,1996-11-28,D,R,2019-20,19,1,2,3,0.16,3,11,9.09,4,16260.0,14:15,0,0,0,0.0,17,21,8,3,5,0,0,0,0.0,0:0,0,0,0,1627.0,1:25,925000
8480748,Kiefer,Sherwood,1995-03-31,RW,R,2019-20,10,0,1,1,0.1,-1,17,0.0,6,7996.0,13:19,3,1,4,75.0,24,4,4,7,-3,0,0,0,25.0,0:2,0,0,0,606.0,1:0,925000
8480769,Joel,L'Esperance,1995-08-18,RW,R,2019-20,3,1,0,1,0.33,0,2,50.0,2,1322.0,7:20,0,1,1,0.0,1,1,1,2,-1,0,0,0,204.0,1:8,0,0,0,25.0,0:8,722500
8480780,Lukas,Radil,1990-08-05,C,R,2019-20,14,0,0,0,0.0,-3,12,0.0,8,7895.0,9:23,1,3,4,25.0,16,2,4,4,0,0,0,0,37.0,0:2,0,0,0,0.0,0:0,700000
8480789,Oliver,Wahlstrom,2000-06-13,RW,R,2019-20,9,0,0,0,0.0,-2,9,0.0,4,5556.0,10:17,0,3,3,0.0,10,4,1,5,-4,0,0,0,510.0,0:56,0,0,0,0.0,0:0,925000
8480796,Martin,Fehervary,1999-10-06,D,L,2019-20,7,0,1,1,0.14,-2,7,0.0,6,6665.0,15:52,0,0,0,0.0,21,3,2,3,-1,0,0,0,33.0,0:4,0,0,0,289.0,0:41,805833
8480797,Joel,Farabee,2000-02-25,LW,L,2019-20,54,9,14,23,0.43,7,85,10.59,39,45577.0,14:4,3,8,11,27.27,31,18,22,27,-5,1,1,2,4532.0,1:23,0,0,0,849.0,0:15,925000
8480800,Quinn,Hughes,1999-10-14,D,L,2019-20,68,8,45,53,0.78,-10,126,6.35,22,89289.0,21:53,0,0,0,0.0,7,46,35,60,-25,3,22,25,15554.0,3:48,0,0,0,188.0,0:2,916667
8480801,Brady,Tkachuk,1999-09-16,LW,L,2019-20,71,21,23,44,0.62,-14,259,8.11,106,80660.0,18:56,144,168,312,46.15,303,43,35,40,-5,2,6,8,12466.0,2:55,0,0,0,202.0,0:2,925000
8480806,Isac,Lundestrom,1999-11-06,C,L,2019-20,15,0,4,4,0.27,-2,10,0.0,0,12519.0,13:54,65,74,139,46.76,5,8,4,2,2,0,1,1,1426.0,1:35,0,0,0,227.0,0:15,925000
8480814,Nicolas,Beaudin,1999-10-07,D,L,2019-20,1,0,0,0,0.0,1,2,0.0,0,1021.0,17:1,0,0,0,0.0,2,2,0,1,-1,0,0,0,0.0,0:0,0,0,0,0.0,0:0,894167
8480821,Filip,Zadina,1999-11-27,RW,L,2019-20,28,8,7,15,0.54,-13,60,13.33,2,25491.0,15:10,1,0,1,100.0,11,10,12,17,-5,4,3,7,4250.0,2:31,0,0,0,20.0,0:0,894167
8480822,Martin,Kaut,1999-10-02,RW,R,2019-20,9,2,1,3,0.33,-1,13,15.38,2,5474.0,10:8,1,0,1,100.0,9,0,2,0,2,1,0,1,415.0,0:46,0,0,0,0.0,0:0,894167
8480829,Jesperi,Kotkaniemi,2000-07-06,C,L,2019-20,36,6,2,8,0.22,-11,55,10.91,23,28066.0,12:59,125,167,292,42.81,51,16,14,21,-7,1,1,2,3726.0,1:43,0,0,0,9.0,0:0,925000
8480830,Andrei,Svechnikov,2000-03-26,RW,L,2019-20,68,24,37,61,0.9,9,183,13.11,54,68291.0,16:44,0,1,1,0.0,116,27,29,66,-37,6,14,20,12065.0,2:57,0,0,0,66.0,0:0,925000
8480839,Rasmus,Dahlin,2000-04-13,D,L,2019-20,59,4,36,40,0.68,-7,90,4.44,38,68306.0,19:17,0,0,0,0.0,72,51,16,43,-27,2,17,19,11890.0,3:21,0,0,0,344.0,0:5,925000
8480849,Barrett,Hayton,2000-06-09,C,L,2019-20,20,1,3,4,0.2,2,27,3.7,14,13371.0,11:8,23,38,61,37.7,14,3,8,4,4,0,0,0,365.0,0:18,0,0,0,5.0,0:0,894167
8480853,Liam,Foudy,2000-02-04,C,L,2019-20,2,0,1,1,0.5,1,3,0.0,0,1706.0,14:13,0,0,0,0.0,3,0,1,0,1,0,0,0,0.0,0:0,0,0,0,0.0,0:0,894167
8480865,Noah,Dobson,2000-01-07,D,R,2019-20,34,1,6,7,0.21,-1,37,2.7,8,27085.0,13:16,0,0,0,0.0,25,31,8,24,-16,0,1,1,1827.0,0:53,0,0,0,117.0,0:3,894167
8480871,Adam,Boqvist,2000-08-15,D,R,2019-20,41,4,9,13,0.32,-3,50,8.0,6,39907.0,16:13,0,0,0,0.0,33,43,10,26,-16,0,2,2,5339.0,2:10,0,0,0,41.0,0:1,894167
8480873,Rasmus,Sandin,2000-03-07,D,L,2019-20,28,1,7,8,0.29,-7,22,4.55,10,24049.0,14:18,0,0,0,0.0,33,22,2,15,-13,0,2,2,1243.0,0:44,0,0,0,449.0,0:16,894167
8480901,Karson,Kuhlman,1995-09-26,C,R,2019-20,27,1,5,6,0.22,2,50,2.0,13,20318.0,12:32,1,5,6,16.67,41,8,3,5,-2,1,0,1,138.0,0:5,0,0,0,999.0,0:37,750000
8480913,Jordan,Gross,1995-05-09,D,R,2019-20,2,0,1,1,0.5,2,3,0.0,0,1941.0,16:10,0,0,0,0.0,0,1,1,2,-1,0,0,0,0.0,0:0,0,0,0,64.0,0:32,925000
8480935,Lawrence,Pilut,1995-12-30,D,L,2019-20,13,0,0,0,0.0,-4,6,0.0,4,12668.0,16:14,0,0,0,0.0,10,19,2,4,-2,0,0,0,39.0,0:3,0,0,0,1168.0,1:29,925000
8480940,Joel,Persson,1994-03-04,D,R,2019-20,13,0,2,2,0.15,-1,17,0.0,2,11944.0,15:18,0,0,0,0.0,6,10,2,8,-6,0,0,0,218.0,0:16,0,0,0,34.0,0:2,1000000
8480944,Par,Lindholm,1991-10-05,C,L,2019-20,40,3,3,6,0.15,6,35,8.57,4,26987.0,11:14,132,156,288,45.83,23,26,14,13,1,0,0,0,10.0,0:0,0,0,0,4118.0,1:42,850000
8480945,Juuso,Riikola,1993-11-09,D,L,2019-20,36,1,6,7,0.19,3,38,2.63,6,29993.0,13:53,0,0,0,0.0,74,24,8,16,-8,0,2,2,2506.0,1:9,0,0,0,161.0,0:4,850000
8480946,Dominik,Kahun,1995-07-02,C,L,2019-20,56,12,19,31,0.55,8,87,13.79,8,44633.0,13:17,29,31,60,48.33,5,22,18,9,9,1,1,2,3535.0,1:3,0,0,0,28.0,0:0,925000
8480950,Ilya,Lyubushkin,1994-04-06,D,R,2019-20,51,0,4,4,0.08,4,41,0.0,18,43426.0,14:11,0,0,0,0.0,151,53,13,20,-7,0,0,0,67.0,0:1,0,0,0,451.0,0:8,874125
8480965,Antti,Suomela,1994-03-17,C,L,2019-20,20,1,6,7,0.35,4,18,5.56,4,11626.0,9:41,51,42,93,54.84,27,5,6,4,2,0,0,0,57.0,0:2,0,0,0,326.0,0:16,700000
8481019,David,Gustafsson,2000-04-11,C,L,2019-20,22,1,0,1,0.05,-2,4,25.0,0,8108.0,6:8,33,30,63,52.38,5,6,0,1,-1,0,0,0,11.0,0:0,0,0,0,60.0,0:2,817500
8481105,Otto,Leskinen,1997-02-06,D,L,2019-20,5,0,0,0,0.0,0,2,0.0,0,3088.0,10:17,0,0,0,0.0,13,1,1,5,-4,0,0,0,0.0,0:0,0,0,0,0.0,0:0,925000
8481186,Logan,O'Connor,1996-08-14,RW,R,2019-20,16,2,0,2,0.12,0,15,13.33,2,8093.0,8:25,0,1,1,0.0,20,8,5,0,5,0,0,0,84.0,0:5,0,0,0,278.0,0:17,925000
8481433,Taro,Hirose,1996-06-30,LW,L,2019-20,26,2,5,7,0.27,-12,21,9.52,6,19585.0,12:33,0,5,5,0.0,13,16,6,20,-14,0,5,5,3883.0,2:29,0,0,0,74.0,0:2,925000
8481477,Nico,Sturm,1995-05-03,C,L,2019-20,6,0,2,2,0.33,2,2,0.0,0,4282.0,11:53,26,23,49,53.06,6,5,1,1,0,0,0,0,1.0,0:0,0,0,0,179.0,0:29,874125
8481481,Blake,Lizotte,1997-12-13,C,L,2019-20,65,6,17,23,0.35,-4,87,6.9,20,54444.0,13:57,312,310,622,50.16,42,22,22,21,1,2,1,3,3998.0,1:1,2,1,3,4314.0,1:6,925000
8481515,Danil,Yurtaykin,1997-07-01,LW,R,2019-20,4,0,0,0,0.0,-1,2,0.0,0,3120.0,13:0,0,0,0,0.0,3,2,2,0,2,0,0,0,256.0,1:4,0,0,0,2.0,0:0,925000
8481516,Joel,Kellman,1994-05-25,C,L,2019-20,31,3,4,7,0.23,-1,31,9.68,4,21537.0,11:34,112,126,238,47.06,28,18,8,8,0,0,0,0,62.0,0:2,0,1,1,1633.0,0:52,925000
8481523,Kirby,Dach,2001-01-21,C,R,2019-20,64,8,15,23,0.36,-1,101,7.92,24,54780.0,14:15,75,147,222,33.78,33,23,38,16,22,0,3,3,6025.0,1:34,0,0,0,136.0,0:2,925000
8481554,Kaapo,Kakko,2001-02-13,RW,L,2019-20,66,10,13,23,0.35,-26,109,9.17,14,56544.0,14:16,2,4,6,33.33,20,11,35,21,14,2,11,13,8821.0,2:13,0,0,0,74.0,0:1,925000
8481559,Jack,Hughes,2001-05-14,C,L,2019-20,61,7,14,21,0.34,-26,123,5.69,10,58067.0,15:51,167,295,462,36.15,12,21,42,53,-11,4,5,9,11622.0,3:10,0,0,0,66.0,0:1,925000
8481572,Ville,Heinola,2001-03-02,D,L,2019-20,8,1,4,5,0.62,3,10,10.0,4,8670.0,18:3,0,0,0,0.0,3,5,3,15,-12,0,1,1,430.0,0:53,0,0,0,37.0,0:4,925000
8481624,Ilya,Mikheyev,1994-10-10,RW,L,2019-20,39,8,15,23,0.59,7,98,8.16,4,36448.0,15:34,3,1,4,75.0,26,13,24,14,10,0,0,0,183.0,0:4,1,0,1,4503.0,1:55,925000
8481630,Alexander,Yelesin,1996-02-07,D,R,2019-20,4,0,0,0,0.0,0,2,0.0,0,2998.0,12:29,0,0,0,0.0,13,0,0,2,-2,0,0,0,0.0,0:0,0,0,0,0.0,0:0,925000
8481637,Anton,Wedin,1993-03-01,LW,L,2019-20,4,0,0,0,0.0,1,2,0.0,4,2177.0,9:4,0,0,0,0.0,5,1,1,0,1,0,0,0,0.0,0:0,0,0,0,0.0,0:0,925000
8481638,Joakim,Nygard,1993-01-08,LW,L,2019-20,33,3,6,9,0.27,0,39,7.69,8,21164.0,10:41,3,3,6,50.0,18,8,14,10,4,1,0,1,984.0,0:29,0,0,0,23.0,0:0,925000
8481640,Lean,Bergmann,1998-10-04,C,L,2019-20,12,0,1,1,0.08,-6,11,0.0,4,5953.0,8:16,0,2,2,0.0,29,5,3,0,3,0,0,0,21.0,0:1,0,0,0,47.0,0:3,836667
8481641,Joel,Kiviranta,1996-03-23,LW,L,2019-20,12,1,0,1,0.08,-1,15,6.67,4,7418.0,10:18,0,0,0,0.0,17,4,5,3,2,0,0,0,10.0,0:0,0,0,0,67.0,0:5,925000
8481642,Andrei,Chibisov,1993-02-26,RW,L,2019-20,2,0,0,0,0.0,0,1,0.0,0,894.0,7:27,0,0,0,0.0,1,1,0,0,0,0,0,0,0.0,0:0,0,0,0,0.0,0:0,792500
8481649,Joona,Luoto,1997-09-26,LW,L,2019-20,16,0,0,0,0.0,-3,9,0.0,2,6326.0,6:35,0,0,0,0.0,10,8,3,5,-2,0,0,0,2.0,0:0,0,0,0,70.0,0:4,741667
8481650,Jakob,Lilja,1993-07-23,LW,L,2019-20,37,2,3,5,0.14,5,23,8.7,2,21968.0,9:53,2,2,4,50.0,18,25,9,8,1,0,0,0,66.0,0:1,0,0,0,205.0,0:5,842500
8481813,Gaetan,Haas,1992-01-31,C,R,2019-20,58,5,5,10,0.17,-1,54,9.26,6,33749.0,9:41,172,236,408,42.16,58,28,22,22,0,0,1,1,1197.0,0:20,0,0,0,265.0,0:4,925000
